的	白勹丶󰁶
一	一一〇〇
是	日一󰁾󰁧
在	丨土󰀌
不	丆卜󰀦
了	了乛亅
有	月󰀘
和	禾口󰀝
人	人人人人
这	文辶󰀦
中	口丨󰀵
大	大大大大
上	󰀥一󰀌
为	丶丿𠃌丶
个	人丨󰀬
过	寸辶󰀦
国	囗王丶󰀦
我	丿扌󰅅丶
以	󰁐丶人󰁶
地	土也󰁀
他	亻也󰁀
要	覀女󰀘
来	一米󰀦
们	亻门󰁀
时	日寸󰁶
到	一厶土刂
生	丿主󰀌
用	月丨󰀵
作	亻𠂉丨二
就	亠口小丶
出	凵山󰀵
于	一󰀛󰀵
会	人二厶󰁧
对	又寸󰁶
分	八刀󰁣
成	厂𠃌󰅅丶
年	󰅎丨十󰀵
可	丁口󰀌
同	冂一口󰀌
主	丶王󰀌
也	也𠃌丨乚
发	ㄥ丿又丶
工	工工工工
说	讠丷口儿
子	子子子子
下	一卜󰀦
能	厶月匕匕
动	二厶力ノ
行	彳一丁󰀢
产	立丿󰀏
而	丆冂〢󰀬
多	夕夕󰁧
后	⺁一口󰀌
方	方丶一丿
面	丆冂〢三
种	禾口丨󰀢
学	󰀧冖子󰀘
著	艹土丿日
着	䒑󰀠目󰀘
得	彳日一寸
定	宀一󰁾󰁧
法	氵土厶󰁶
民	󰁃󰁐弋󰁫
所	⺁󰁃斤󰀢
经	纟ス工󰀝
十	十一丨
三	三一一一
之	之之之之
进	二󰀯辶󰀵
家	宀一󰀓󰁧
等	⺮土寸󰁧
部	立口阝󰀢
里	日土󰀌
都	土丿日阝
自	丿目󰀌
二	二一一
如	女口󰀝
理	王日土󰀝
起	土󰁾己󰁫
力	力𠃌丿
长	丿七󰂃󰀦
化	亻ヒ󰁀
现	王ㄇ󰁜󰁀
小	小亅丿丶
度	广廿又󰀦
实	宀󰁦大󰁧
点	󰀥口灬󰁧
高	亠口冂口
还	丆卜辶󰀦
当	⺌彐󰀘
电	日乚󰁫
加	力口󰀝
两	一冂人人
从	人人󰁶
去	土厶󰁧
物	牜勹󰁤ノ
把	扌巴󰁀
本	木一󰀌
好	女子󰀝
水	水水水水
制	󰅎冂丨刂
体	亻木一󰀝
开	一廾󰀵
业	󰅊一󰀌
重	丿一日土
使	亻一口乂
天	一大󰀦
然	󰁝大丶灬
些	止匕二󰀘
量	日一日土
前	䒑月刂󰀬
四	四丨󰁈一
那	𠃌󰀠阝󰀢
外	夕卜󰁶
事	一口󰁬亅
它	宀匕󰀅
名	夕口󰀘
合	人一口󰀘
因	囗大󰀦
应	广󰀧一󰀌
由	由丨󰁈一
其	艹三八󰁧
日	日日日日
性	忄丿主󰀝
社	礻󰁶土󰀝
义	丶乂󰀦
全	人王󰀘
样	木䒑󰀟󰀢
政	一止夂󰁶
表	主󰀔󰁧
机	木几󰁀
关	䒑大󰁧
新	立木斤󰀢
平	一丷十󰀵
各	夂口󰀘
相	木目󰀝
间	门日󰀌
心	心丶󰁒丶
正	一止󰀌
与	一ㄅ一󰀌
西	西一丨一
形	一廾彡ノ
反	⺁又󰀦
看	目󰀘
明	日月󰀝
又	又又又又
么	丿厶󰁧
内	冂人󰀦
你	亻⺈小󰁶
但	亻日一󰀝
利	禾刂󰀢
道	䒑丿目辶
原	厂白小󰀦
没	氵几又󰁶
第	⺮弓丨丿
比	󰁴匕󰁀
命	人一口卩
数	米女夂󰁶
只	口八󰁧
线	纟二󰅅丶
向	丿冂口󰀌
问	门口󰀌
意	立日心󰁧
站	立󰀥口󰀝
此	止匕󰁀
或	戈口󰀞󰀌
条	夂木󰁧
无	二󰁜󰁫
公	八厶󰁧
质	⺁十贝󰀦
结	纟士口󰀝
解	⺈月丨󰀟
情	忄主月󰀝
建	󰁬󰀟廴󰀵
月	月月月月
想	木目心󰁧
很	彳彐󰀖󰁶
变	亠󰁗又󰁧
者	土丿日󰀘
代	亻弋
已	已已已已
立	立立立立
系	丿ㄠ小󰁧
军	冖车󰀬
最	日耳又󰁧
并	䒑廾󰀬
提	扌日一󰁾
党	⺌冖口儿
题	日一󰁾贝
气	󰅎⺄󰀅
五	五一丨一
展	尸󰁺󰀖󰀦
象	⺈口󰀓󰁧
文	文丶一󰂃
通	󰁻月丨辶
总	丷口心󰁧
果	日木󰀦
次	冫⺈人󰁶
员	口贝󰁧
革	廿口十󰀬
活	氵丿古󰀝
程	禾口王󰀝
常	⺌冖口丨
头	󰁦大󰀦
位	亻立󰀝
老	土丿匕󰀅
直	十󰀣󰀘
入	丿󰂃󰀦
特	牜土寸󰁶
品	口口口󰀘
件	亻丿󰀟󰀢
山	山山山山
见	ㄇ󰁜󰀅
路	口止夂口
求	一氺丶󰀦
管	⺮宀丨󰁃
及	乃󰂃󰀦
级	纟乃󰂃󰁶
少	小丿󰀏
基	艹三八土
别	口力刂󰀢
设	讠几又󰁶
式	󰀁工丶󰀦
资	冫⺈人贝
知	𠂉大口󰀝
组	纟󰀐一󰀝
几	几丿󰁊
手	手丿一亅
论	讠人匕󰁀
统	纟亠厶儿
接	扌立女󰀝
农	冖󰀔󰀦
被	衤󰁧󰅌又
边	力辶󰀏
指	扌匕日󰀝
将	丬夕寸󰁶
料	米󰁦十󰀢
九	九丿󰁊
决	冫ユ人󰁶
先	丿土儿󰀅
根	木彐󰀖󰁶
期	艹三八月
计	讠十󰀢
强	弓口虫󰁶
干	干一一丨
战	󰀥口戈󰁶
回	囗口󰀌
放	方夂󰁶
她	女也󰁀
给	纟人一口
任	亻丿士󰀝
运	二厶辶󰀦
做	亻古夂󰁶
必	心丿󰀏
流	氵亠厶󰀸
区	匚乂󰀦
取	耳又󰁶
门	门丶丨𠃌
处	夂卜󰀦
据	扌尸古󰀝
南	十冂䒑十
则	贝刂󰀢
队	阝人󰁶
图	囗夂󰁦󰀦
北	丬匕󰁀
百	丆日󰀘
光	⺌一儿󰀅
治	氵厶口󰀝
东	󰀂小󰀦
保	亻口木󰁶
志	士心󰁧
较	车亠八乂
领	人丶󰁻贝
海	氵𠂉母󰁶
口	口口口口
七	七一乚
导	巳寸󰁧
调	讠󰀼土口
即	彐厶卩󰀢
什	亻十󰀢
造	丿土口辶
金	金金金金
吃	口𠂉乙󰁀
规	二人ㄇ󰁜
争	⺈󰁬亅󰀬
思	田心󰁧
世	廿󰄃󰁫
共	󰁺八󰁧
六	亠八󰁧
认	讠人󰁶
交	亠八乂󰁧
受	爫冖又󰁧
阶	阝人󰀯󰀢
色	⺈巴󰀅
联	耳䒑大󰁶
极	木乃󰂃󰁶
美	丷王大󰁧
济	氵文󰀯󰀢
更	一日乂󰀦
打	扌丁󰀢
改	󰁁夂󰁶
再	一冂土󰀌
增	土丷󰀺日
收	󰁐丨夂󰁶
清	氵主月󰀝
切	七刀ノ
真	十󰀣八󰁧
教	土丿孑夂
场	土ㄋ󰁤ノ
权	木又󰁶
安	宀女󰀘
万	一󰁡󰀏
术	木丶󰀦
证	讠一止󰀝
身	丿󰀽三丿
务	夂力󰁣
走	土󰁾󰁧
带	一〣冖丨
斗	󰁦十󰀵
角	⺈月丨󰀬
单	丷󰅐󰀬
花	艹亻ヒ󰀅
目	目目目目
完	宀二儿󰀅
声	士󰁅󰁣
热	扌九丶灬
报	扌卩又󰁶
八	八丿󰂃
白	白白白白
才	󰀛丿󰀏
具	󰀣八󰁧
至	一厶土󰀘
张	弓丿七󰂃
马	󰀊一󰀌
每	𠂉母󰁧
话	讠丿古󰀝
达	大辶󰀦
转	车二󰁓丶
议	讠丶乂󰁶
科	禾󰁦十󰀢
器	口口大口
示	二小󰁧
确	石⺈月丨
许	讠𠂉十󰀢
今	人丶乛󰀅
例	亻一夕刂
集	亻󰁷木󰁧
信	亻言󰀝
记	讠己󰁀
积	禾口八󰁶
群	󰁬丿口󰀟
步	止󰀤󰁣
整	一口󰅇止
广	广丶一丿
风	几乂󰀦
传	亻二󰁓丶
界	田人󰀯󰀬
华	亻ヒ十󰀬
且	󰀐一󰀌
元	二儿󰀅
离	亠乂凵厶
压	厂土丶󰀦
研	石一廾󰀢
究	宀八九󰀅
况	冫口儿󰁀
书	󰁈𠃌丨丶
拉	扌立󰀝
类	米大󰁧
节	艹ㄗ󰀬
采	爫木󰁧
观	又ㄇ󰁜󰁀
越	土󰁾一丶
众	人人人󰁧
持	扌土寸󰁶
叫	口󰁐丨󰀢
油	氵由󰀝
速	一口󰅇辶
织	纟口八󰁶
林	木木󰁶
段	亻三几又
难	又亻󰁷󰀝
需	󰀙丆冂〢
非	丨三丨三
复	𠂉日夂󰁧
儿	儿丿乚
律	彳󰁬󰀟󰀢
布	冂丨󰀬
际	阝二小󰁶
连	车辶󰀵
算	⺮目廾󰀬
深	氵冖八木
容	宀八人口
千	丿十󰀵
近	斤辶󰀵
周	󰀼土口󰀌
影	日亠口彡
断	米󰄃斤󰀢
己	己󰁈一乚
办	力八󰀦
须	彡丆贝󰁶
商	亠丷冂口
石	石一丿一
青	主月󰀘
米	米丶丿󰂃
便	亻一日乂
感	厂一口心
省	小丿目󰀘
支	十又󰁧
何	亻丁口󰀝
团	囗󰀛丿󰀏
验	󰀊󰀞人一
半	丷󰀟󰀵
往	彳丶王󰀝
约	纟勹丶󰁶
太	大丶󰀦
克	古儿󰀅
劳	艹冖力󰁣
历	厂力󰀏
备	夂田󰀘
列	一夕刂󰀢
低	亻󰁚󰀁丶
委	禾女󰀘
市	亠冂丨󰀬
史	口乂󰀦
响	口丿冂口
准	冫亻󰁷󰀝
精	米主月󰀝
习	𠃌冫󰀌
消	氵⺌月󰀝
写	冖一ㄅ一
候	亻丨ユ大
土	土土土土
称	禾⺈小󰁶
技	扌十又󰁶
空	宀八工󰀘
府	广亻寸󰀦
亲	立木󰁧
毛	丿二乚󰁫
温	氵日皿󰀝
率	亠ㄠ󰀪十
院	阝宀二儿
划	戈刂󰀢
装	丬士亠󰀔
存	丨子󰀌
眼	目彐󰀖󰁶
快	忄ユ人󰁶
标	木二小󰁶
值	亻十󰀣󰀝
族	方𠂉𠂉大
王	王王王王
查	木日一󰀘
江	氵工󰀝
斯	艹三八斤
素	主ㄠ小󰁧
却	土厶卩󰀢
除	阝人一木
号	口一ㄅ󰀅
住	亻丶王󰀝
格	木夂口󰀝
参	厶大彡󰁣
满	氵艹一人
始	女厶口󰀝
般	丿󰁪几又
包	勹巳󰁫
识	讠口八󰁶
专	二󰁓丶󰀦
京	亠口小󰁧
照	日刀口灬
车	车一ㄥ丨
按	扌宀女󰀝
选	丿土儿辶
火	火火火火
易	日勹󰁤󰁣
厂	厂一丿
听	口斤󰀢
该	讠亠ㄥ人
红	纟工󰀝
属	尸丿口丶
维	纟亻󰁷󰀝
县	󰀐一厶󰁧
严	一󰅊厂󰁣
派	氵⺁󰀕󰁶
局	尸𠃌口󰀌
讲	讠二󰀯󰀢
呢	口尸匕󰁀
继	纟米󰄃󰁀
首	䒑丿目󰀘
片	丿丨一󰁈
构	木勹厶󰁶
女	女女女女
德	彳十罒心
死	一夕匕󰁫
效	亠八乂夂
谈	讠火火󰁶
失	󰅎人󰀦
神	礻󰁶日丨
望	亠󰁐月王
价	亻人󰀯󰀢
铁	钅󰅎人󰁶
酸	西一厶夂
底	广󰁚󰀁丶
黄	󰁺由八󰁧
随	阝月辶
苏	艹力八󰁧
引	弓丨󰀢
推	扌亻󰁷󰀝
艺	艹乙󰀅
尔	⺈小󰁧
官	宀丨󰁃󰁃
适	丿古辶󰀌
批	扌󰁴匕󰁀
英	艹ㄇ大󰁧
告	丿土口󰀘
席	广廿冂丨
举	󰀧一八󰀟
李	木子󰀘
师	リ一冂丨
势	扌九丶力
细	纟田󰀝
帮	三丿阝丨
显	日󰅊一󰀘
项	工丆贝󰁶
状	丬大丶󰁶
字	宀子󰀘
育	亠厶月󰀘
层	尸二厶󰀦
破	石󰅌又󰁶
落	艹氵夂口
怎	𠂉丨二心
营	艹冖口口
远	二儿辶󰁫
士	士一丨一
台	厶口󰀘
企	人止󰀘
爱	爫冖又
言	言言言言
河	氵丁口󰀝
配	西一己󰁀
围	囗二𠃌丨
型	一廾刂土
服	月卩又󰁶
朝	十日十月
轻	车ス工󰀝
紧	〢又ㄠ小
武	二止󰁒丶
仅	亻又󰁶
另	口力󰁣
章	立日十󰀬
亚	一󰅊一󰀌
视	礻󰁶ㄇ󰁜
封	土土寸󰁶
密	宀心丿山
注	氵丶王󰀝
材	木󰀛丿ノ
案	宀女木󰁧
供	亻󰁺八󰁶
止	止丨一一
木	木木木木
续	纟十乛大
早	日十󰀬
防	阝方ノ
护	扌丶尸ノ
判	丷󰀠刂󰀢
态	大丶心󰁧
司	𠃌一口󰀌
固	囗古󰀌
似	亻󰁐丶人
罪	罒丨三三
黑	󰀹土灬󰁧
充	亠厶儿󰀅
兴	󰀧一八󰁧
某	艹二木󰁧
树	木又寸󰁶
击	󰀟凵󰀬
致	一厶土夂
圆	囗口贝󰀦
液	氵亠亻丶
音	立日󰀘
坚	〢又土󰀘
足	口󰁾󰁧
负	⺈贝󰁧
害	宀三丨口
含	人丶乛口
余	人一木󰁧
夫	二人󰀦
排	扌丨三三
费	弓󰀯贝󰁧
源	氵厂白小
觉	󰀧冖ㄇ󰁜
范	艹氵⺋󰀅
左	工󰀘
够	勹口夕夕
差	䒑󰀠工󰀘
城	土厂𠃌丶
春	三人日󰀘
食	人丶彐󰀖
兵	󰅍一八󰁧
施	方𠂉也󰁀
富	宀一口田
均	土勹冫󰀝
置	罒十󰀣󰀘
减	冫厂一丶
故	古夂󰁶
虽	口虫󰁧
曾	丷󰀺日󰀘
占	󰀥口󰀘
送	䒑大辶󰀦
笑	⺮丿大󰁧
试	讠󰀁工丶
职	耳口八󰁶
氧	󰅎⺄䒑󰀟
阳	阝日󰀝
汉	氵又󰁶
留	󰁚丶刀田
跟	口止彐󰀖
修	亻丨夂彡
巴	巴󰁈丨乚
创	人⺋刂󰀢
助	󰀐󰀞力ノ
未	二󰅇󰀦
犯	犭ノ⺋󰁀
初	衤󰁧刀ノ
功	工力ノ
抗	扌亠几󰁀
田	田田田田
坏	土丆卜󰁶
降	阝夂󰀂丨
古	古一丨一
尽	尸󰂃󰁦󰁧
互	一󰅂一󰀌
财	贝󰀛丿ノ
溶	氵宀八口
病	疒一冂人
叶	口十󰀢
投	扌几又󰁶
策	⺮一冂󰅇
责	主贝󰁧
波	氵󰅌又󰁶
令	人丶󰁻󰁧
独	犭ノ虫󰁶
考	土丿一ㄅ
右	口󰀘
请	讠主月󰀝
球	王一氺丶
让	讠󰀥一󰀝
副	一口田刂
双	又又󰁶
检	木人一一
宜	宀󰀐一󰀘
杂	九木󰁧
钱	钅二󰅅丶
述	木丶辶󰀦
限	阝彐󰀖󰁶
简	⺮门日󰀘
找	扌戈󰁶
冲	冫口丨󰀢
端	立山丆〢
输	车人一刂
倒	亻一厶刂
养	䒑二人󰀯
敌	丿古夂󰁶
阿	阝丁口󰀝
超	土󰁾刀口
换	扌⺈ㄇ大
州	丶丿丶丨
胜	月丿主󰀝
帝	亠丷冖丨
依	亻亠󰀔󰁶
坐	人人土󰀌
纪	纟己󰁀
突	宀八大丶
念	人丶乛心
客	宀夂口󰀘
绝	纟⺈巴󰁀
升	丿廾󰀵
陈	阝󰀂小󰁶
略	田夂口󰀝
益	䒑八皿󰀘
否	丆卜口󰀘
罗	罒夕󰁧
仍	亻乃ノ
吸	口乃󰂃󰁶
苦	艹古󰀘
错	钅󰁺日󰀝
承	了三󰀩󰀦
友	又󰁧
草	艹日十󰀬
夜	亠亻夂丶
微	彳山一夂
优	亻乚丶
画	一田凵󰀬
础	石凵山󰀢
协	十力八󰁶
良	丶彐󰀖󰀦
射	丿󰀽三寸
曲	ㄇ󰁺󰀌
洋	氵䒑󰀟󰀢
村	木寸󰁶
矿	石广ノ
终	纟夂󰁦󰁶
轮	车人匕󰁀
块	土ユ人󰁶
环	王丆卜󰁶
析	木斤󰀢
径	彳ス工󰀝
哪	口𠃌󰀠阝
烈	一夕刂灬
校	木亠八乂
板	木⺁又󰁶
云	二厶󰁧
诉	讠斤丶󰁶
既	彐厶󰀂󰁜
迅	⺄十辶󰀵
刻	亠ㄥ丿刂
靠	丿土口三
察	宀󰁯二小
逐	一󰀓辶󰀦
央	ㄇ大󰀦
待	彳土寸󰁶
母	母󰄃𠃌丶
境	土立日儿
激	氵白方夂
渤	氵十冖力
模	木艹日大
控	扌宀八工
卫	ㄗ一󰀌
久	ク󰂃󰀦
印	󰁚一卩󰀢
房	丶尸方󰀏
停	亻亠口丁
甚	艹三八󰄃
皮	󰅌又󰀦
洲	氵丶丿丨
搞	扌亠口口
息	丿目心󰁧
移	禾夕夕󰁶
旧	丨日󰀝
拿	人一口手
若	艹口󰀘
顶	丁丆贝󰁶
短	𠂉大一䒑
湖	氵古月󰀝
括	扌丿古󰀝
挥	扌冖车󰀢
侵	亻彐冖又
甲	甲丨󰁈丨
游	氵方𠂉子
语	讠五口󰀝
冷	冫人丶󰁻
普	䒑󰅊一日
银	钅彐󰀖󰁶
乐	丿󰄃小󰀦
医	匚𠂉大󰀦
烧	火弋丿儿
刘	文刂󰀢
吗	口󰀊一󰀝
针	钅十󰀢
纸	纟󰁚弋󰁀
粉	米八刀ノ
散	󰁺月夂󰁶
急	⺈彐心󰁧
预	󰁻乛亅贝
扩	扌广ノ
愿	厂白小心
核	木亠ㄥ人
吧	口巴󰁀
龙	ヒ丶󰀦
误	讠口一大
欢	又⺈人󰁶
孩	孑亠ㄥ人
盐	土卜皿󰀘
善	䒑󰀟䒑口
雨	雨一丨丶
货	亻ヒ贝󰁧
讨	讠寸󰁶
测	氵贝刂󰀢
丝	󰁲󰁲一󰀘
室	宀一厶土
混	氵日󰁴匕
弹	弓丷󰅐󰀢
乎	丿丷󰀛󰀵
鲜	󰁢󰀞䒑󰀟
晚	日⺈口󰁜
乱	丿古乚󰁀
沙	氵小丿ノ
序	广󰁻乛亅
缺	󰅎山ユ人
获	艹犭ノ丶
读	讠十乛大
鲁	󰁢一日󰀘
载	土车󰅅丶
渐	氵车斤󰀢
父	八乂󰁧
啊	口阝丁口
演	氵宀一八
刚	冂乂刂󰀢
守	宀寸󰁧
宁	宀丁󰀬
杀	乂木󰁧
谓	讠田月󰀝
刑	一廾刂󰀢
附	阝亻寸󰁶
担	扌日一󰀝
贵	口丨一贝
班	王丶丿王
稳	禾⺈彐心
钢	钅冂乂󰁶
迫	白辶󰀌
答	⺮人一口
距	口止匚󰁃
药	艹纟勹丶
假	亻󰁃丨又
毫	亠口冖乚
兰	丷三󰀘
喜	士口䒑口
练	纟󰀂𠃌八
乙	乙乙〇〇
酒	氵西一󰀝
盾	⺁十目󰀌
困	囗木󰀦
买	乛󰁦大󰁧
福	礻󰁶一田
征	彳一止󰀝
阻	阝󰀐一󰀝
损	扌口贝󰁶
介	人󰀯󰀬
剂	文󰀯刂󰀢
穿	宀八󰀂丿
钟	钅口丨󰀢
顺	川丆贝󰁶
飞	⺄󰁦󰀦
丰	三丨󰀵
怕	忄白󰀝
祖	礻󰁶󰀐一
矛	󰁻乛亅丿
执	扌九丶󰁶
星	日丿主󰀘
谁	讠亻󰁷󰀝
血	丿皿󰀌
背	丬匕月󰀘
掌	⺌冖口手
脱	月丷口儿
希	乂冂丨
评	讠一丷十
沉	氵冖几󰁀
概	木彐厶󰁜
跑	口止勹巳
熟	亠口孑灬
伤	亻𠂉力ノ
衣	亠󰀔󰁧
械	木戈廾󰀢
烟	火囗大󰁶
审	宀日丨󰀬
扬	扌ㄋ󰁤ノ
翻	丿米田羽
秋	禾火󰁶
露	󰀙口止口
慢	忄日罒又
静	主月⺈亅
免	⺈口󰁜󰀅
促	亻口󰁾󰁶
践	口止二丶
脚	月土厶卩
妈	女󰀊一󰀝
补	衤󰁧卜󰁶
薄	艹氵一寸
牛	丿󰀟󰀵
句	勹口󰀌
握	扌尸一土
编	纟丶尸艹
庆	广大󰀦
亮	亠口冖几
笔	⺮丿二乚
居	尸古󰀌
味	口二󰅇󰁶
映	日ㄇ大󰁶
斤	斤丿丿丨
培	土立口󰀝
松	木八厶󰁶
乡	󰁲丿󰀏
诗	讠土寸󰁶
异	巳廾󰀬
孔	孑乚󰁀
顾	厂⺋丆贝
呼	口丿丷󰀛
香	禾日󰀘
菜	艹爫木󰁧
威	厂一女丶
尼	尸匕󰁫
抓	扌⺁丨󰂃
攻	工夂󰁶
奇	大丁口󰀘
倍	亻立口󰀝
临	〢𠂉丶一
掉	扌󰀥日十
岁	山夕󰁧
脸	月人一一
剧	尸古刂󰀢
哥	丁口丁口
延	丿止廴󰀌
末	一木󰀦
销	钅⺌月󰀝
皇	白王󰀘
永	丶𠃌󰀩󰀦
汽	氵󰅎⺄󰁀
景	日亠口小
娘	女丶彐󰀖
伟	亻二𠃌丨
齐	文󰀯󰀬
陆	阝󰀟凵󰀢
赵	土󰁾乂󰀦
雷	󰀙田󰀘
危	⺈厂⺋󰀅
胡	古月󰀝
聚	耳又乑󰁧
硫	石亠厶󰀸
束	一口󰅇󰀦
轴	车由󰀝
套	大󰀍厶󰁧
座	广人人土
粮	米丶彐󰀖
灯	火丁󰀢
课	讠日木󰁶
绍	纟刀口󰀝
杨	木ㄋ󰁤ノ
怀	忄丆卜󰁶
饭	⺈󰁐⺁又
赶	土󰁾干󰀵
缩	纟宀亻日
额	宀夂口贝
孙	孑小󰁶
棉	木白冂丨
鼓	士口䒑又
宽	宀艹ㄇ󰁜
绿	纟󰁭氺󰁶
川	川丿丨丨
夺	大寸󰁧
归	リ彐󰀝
灭	一火󰀦
煤	火艹二木
宗	宀二小󰁧
衡	彳󰁢大丁
卷	䒑大⺋󰀅
盟	日月皿󰀘
弱	弓冫弓冫
竟	立日儿󰀅
镇	钅十󰀣八
途	人一木辶
厚	厂日子󰀌
触	⺈月丨虫
措	扌󰁺日󰀝
藏	艹厂󰄃丶
玉	王丶󰀦
哈	口人一口
零	󰀙人丶󰁻
枪	木人⺋󰁀
灵	彐火󰁧
险	阝人一一
款	士二小人
召	刀口󰀘
遍	丶尸冂辶
呀	口󰀂亅丿
敢	󰁈耳夂󰁶
恶	一󰅊一心
借	亻󰁺日󰀝
歌	丁口丁人
脑	月亠乂凵
泽	氵又󰀟󰀢
染	氵九木󰁧
庭	广丿士廴
唱	口日日󰀝
训	讠川󰀢
堂	⺌冖口土
域	土戈口󰀞
植	木十󰀣󰀝
欧	匚乂⺈人
宪	宀丿土儿
裂	一夕刂󰀔
努	女又力󰁣
彻	彳七刀ノ
探	扌冖八木
沿	氵几口󰀝
户	丶尸󰀏
振	扌厂二󰀖
粒	米立󰀝
频	止󰀤丆贝
督	󰀥一小目
袁	土口󰀔󰁧
垂	丿十󰁺一
纯	纟一凵乚
纳	纟冂人󰁶
折	扌斤󰀢
操	扌口口木
暗	日立日󰀝
耐	丆冂〢寸
份	亻八刀ノ
录	󰁭氺󰁧
卖	十乛󰁦大
退	彐󰀖辶󰀦
遇	日冂丨辶
茶	艹人木󰁧
润	氵门王󰀝
肉	冂人人󰀦
康	广󰁬氺󰀦
唯	口亻󰁷󰀝
浓	氵冖󰀔󰁶
胞	月勹巳󰁀
符	⺮亻寸󰁧
雪	󰀙彐󰀘
磁	石䒑ㄠㄠ
献	十冂䒑丶
船	丿󰁪几口
忙	忄亠󰄃󰁀
追	亻󰁃󰁃辶
伊	亻󰁬丿ノ
税	禾丷口儿
私	禾厶󰁶
篇	⺮丶尸艹
盘	丿󰁪皿󰀘
夏	丆目夂󰁧
卡	󰀥一卜󰁧
盖	丷王皿󰀘
丁	丁一亅
季	禾子󰀘
迎	󰁚卩辶󰀵
予	󰁻乛亅󰀬
架	力口木󰁧
阴	阝月󰀝
刀	刀𠃌丿
阵	阝车󰀢
瓦	一󰁐󰁊丶
野	日土󰁻亅
盛	厂𠃌󰅅皿
氢	󰅎⺄ス工
削	⺌月刂󰀢
伸	亻日丨󰀢
索	十冖ㄠ小
旗	方𠂉艹八
忽	勹󰁤心󰁧
访	讠方ノ
累	田ㄠ小󰁧
燃	火󰁝大灬
虑	󰅋七心󰀦
迹	亠󰁖辶󰀦
亦	亠󰁖󰁧
典	ㄇ󰁺八󰁧
晶	日日日󰀘
雄	厶亻󰁷
泛	氵丿之󰁶
谋	讠艹二木
托	扌丿七󰁀
透	禾乃辶󰀏
横	木󰁺由八
屋	尸一厶土
朱	󰅎󰅇󰀦
惊	忄亠口小
奋	大田󰀘
替	二人二日
痛	疒󰁻月丨
裁	土亠󰀔丶
抽	扌由󰀝
楚	木木乛󰁾
避	尸口立辶
硬	石一日乂
寨	宀󰀀八木
床	广木󰀦
旁	亠丷冖方
遗	口丨一辶
弟	丷弓丨丿
洗	氵丿土儿
幅	冂丨一田
毒	主母󰁧
顿	一凵󰁐贝
尚	⺌冂口󰀘
塞	宀󰀀八土
暴	日󰁺八氺
谢	讠丿󰀽寸
宝	宀王丶󰁧
圈	囗䒑大⺋
招	扌刀口󰀝
彩	爫木彡ノ
闻	门耳󰀌
胶	月亠八乂
残	一夕二丶
遭	一ㄇ󰁺辶
爷	八乂ㄗ󰀬
斜	人一木十
警	艹勹口言
揭	扌日勹󰄃
鱼	󰁢一󰀘
释	丿米又󰀟
倾	亻󰁴丆贝
潮	氵十日月
贯	󰅂十贝󰁧
偏	亻丶尸艹
摇	扌爫󰅎山
监	〢𠂉丶皿
购	贝勹厶󰁶
徐	彳人一木
付	亻寸󰁶
灰	火󰁧
园	囗二儿󰁫
摆	扌罒土厶
殊	一夕󰅎󰅇
蒸	艹了󰀩灬
碎	石亠人十
糖	米广󰁬口
词	讠𠃌一口
耗	三󰅇丿乚
赞	丿土儿贝
炮	火勹巳󰁀
吴	口一大󰁧
愈	人一月心
堆	土亻󰁷󰀝
骨	󰀾月󰀘
凯	山󰁁几󰁀
午	𠂉十󰀬
桥	木丿大󰀯
巨	匚󰁃󰀌
救	一氺丶夂
荣	艹冖木󰁧
纷	纟八刀ノ
秦	三人禾󰁧
订	讠丁󰀢
旋	方𠂉乛󰁾
割	宀三丨刂
侧	亻贝刂󰀢
纤	纟丿十󰀢
凡	几丶󰀦
亡	亠󰄃󰁫
杆	木干󰀢
弦	弓亠ㄠ󰁶
馆	⺈󰁐宀󰁃
恩	囗大心󰁧
宋	宀木󰁧
妇	女彐󰀝
吹	口⺈人󰁶
男	田力󰁣
版	丿丨一又
禁	木木二小
繁	𠂉母夂小
滑	氵󰀾月󰀝
败	贝夂󰁶
捕	扌一月丶
择	扌又󰀟󰀢
唐	广󰁬丨口
播	扌丿米田
爸	八乂巴󰀅
泥	氵尸匕󰁀
跳	口止儿󰀪
君	󰁬丿口󰀌
湾	氵亠󰁗弓
碳	石山火
综	纟宀二小
废	广ㄥ丿丶
庄	广土󰀌
吨	口一凵乚
库	广车󰀵
睛	目主月󰀝
楼	木米女󰀝
麻	广木木󰀦
涉	氵止󰀤ノ
尺	尸󰂃󰀦
剥	󰁭氺刂󰀢
伙	亻火󰁶
麦	主夂󰁧
坦	土日一󰀝
嘴	口止匕丨
鸡	又勹丶一
耳	耳一丨一
荷	艹亻丁口
赛	宀󰀀八贝
肥	月巴󰁀
岸	山厂干󰀬
谷	八人口󰀘
扎	扌乚󰁀
铜	钅冂一口
街	彳土土丁
店	广󰀥口󰀌
冬	夂󰁦󰁧
炉	火丶尸ノ
姑	女古󰀝
恢	忄火󰁶
彪	󰅋七几彡
惯	忄󰅂十贝
朗	丶彐厶月
秀	禾乃󰁣
勇	󰁻月丨力
驻	󰀊󰀞丶王
贺	力口贝󰁧
肯	止月󰀘
舞	󰅎󰀷一丨
蒙	艹冖二󰀓
昌	日日󰀘
粗	米󰀐一󰀝
抵	扌󰁚󰀁丶
贸	󰁚丶刀贝
亿	亻乙󰁀
俄	亻丿扌丶
键	钅󰁬󰀟廴
您	亻⺈小心
旅	方𠂉󰀕󰁶
登	癶一口䒑
壁	尸口立土
乘	禾丬匕󰁫
井	二󰀯󰀵
闪	门人󰀦
湿	氵日󰅊一
缓	纟爫一又
洪	氵󰁺八󰁶
秘	禾心丿ノ
芳	艹方󰁣
汗	氵干󰀢
闭	门󰀛丿󰀏
卜	卜丨丶
毕	󰁴匕十󰀬
莫	艹日大󰁧
津	氵󰁬󰀟󰀢
挂	扌土土󰀝
逃	儿󰀪辶󰀦
磨	广木木石
蛋	乛󰁾虫󰁧
股	月几又󰁶
黎	禾勹丿氺
塔	土艹人口
塑	䒑凵丿土
贡	工贝󰁧
港	氵󰁺八巳
腐	广亻寸人
筑	⺮工几丶
冰	冫水󰁶
净	冫⺈󰁬亅
健	亻󰁬󰀟廴
殖	一夕十󰀣
婚	女󰁚弋日
奴	女又󰁶
插	扌丿十臼
辩	立讠十
纺	纟方ノ
刺	一冂󰅇刂
啦	口扌立󰀝
勒	廿口十力
援	扌爫一又
像	亻⺈口󰀓
仪	亻丶乂󰁶
萨	艹阝立丿
徒	彳土󰁾󰁶
弄	王廾󰀬
浪	氵丶彐󰀖
陷	阝⺈臼󰀝
汇	氵匚󰁀
函	了󰀪凵󰀵
休	亻木󰁶
炼	火󰀂𠃌八
舍	人干口󰀘
坡	土󰅌又󰁶
岛	勹丶ㄅ山
猪	犭ノ土日
郭	亠口孑阝
隔	阝一口丨
氯	󰅎⺄󰁭氺
忘	亠󰄃心󰁧
尖	小大󰁧
伏	亻大丶󰁶
浮	氵爫子󰀝
虚	󰅋七󰅊一
朋	月月󰀝
授	扌爫冖又
玻	王󰅌又󰁶
睡	目丿十一
障	阝立日十
辛	立十󰀬
碱	石厂一丶
贫	八刀贝󰁧
岩	山石󰀘
泪	氵目󰀝
臣	匚丨󰁃丨
疑	匕𠂉大󰁾
滚	氵亠八󰀔
壮	丬士󰀝
梁	氵刀八木
荡	艹氵ㄋ󰁤
启	丶尸口󰀌
瑞	王山丆〢
穷	宀八力󰁣
甘	艹二󰀌
箱	⺮木目󰀘
童	立日土󰀘
淡	氵火火󰁶
峰	山夂三丨
纲	纟冂乂󰁶
牙	󰀂亅丿󰀏
怪	忄又土󰀝
佛	亻弓󰀯󰀢
脂	月匕日󰀝
炸	火𠂉丨二
幸	土䒑十󰀬
截	土亻󰁷丶
牧	牜夂󰁶
售	亻󰁷口󰀘
蓝	艹〢𠂉皿
镜	钅立日儿
震	󰀙厂二󰀖
罢	罒土厶󰁧
锅	钅口冂人
绕	纟弋丿儿
软	车⺈人󰁶
拥	扌月丨󰀢
尊	丷西一寸
豆	一口䒑󰀘
礼	礻󰁶乚󰁀
剩	禾丬匕刂
擦	扌宀󰁯小
耕	三󰅇二󰀯
颜	立丿彡贝
泰	三人氺󰁧
菌	艹囗禾󰁧
绩	纟主贝󰁶
勤	廿口主力
竹	𠂉丨𠂉亅
拖	扌𠂉也󰁀
尤	乚丶󰀦
伍	亻五󰀝
匀	勹冫󰀌
锋	钅夂三丨
爆	火日󰁺氺
刊	干刂󰀢
姓	女丿主󰀝
仿	亻方ノ
尾	尸丿二乚
脉	月丶𠃌󰀩
违	二𠃌丨辶
欲	八人口人
筒	⺮冂一口
洞	氵冂一口
璃	王亠乂厶
墨	󰀹土灬土
默	󰀹土灬丶
邦	三丿阝󰀢
稍	禾⺌月󰀝
丽	一冂丶丶
珠	王󰅎󰅇󰁶
梅	木𠂉母󰁶
喝	口日勹󰄃
币	丿冂丨󰀵
窗	宀八丿夕
氏	󰁚弋󰁫
潜	氵二人日
抱	扌勹巳󰁀
森	木木木󰁧
袖	衤󰁧由󰀝
喊	口厂一丶
毁	臼工几又
艰	又彐󰀖󰁶
挑	扌儿󰀪󰁶
焦	亻󰁷灬󰁧
灾	宀火󰁧
泡	氵勹巳󰁀
摩	广木木手
夹	一丷大󰀦
枝	木十又󰁶
埃	土厶𠂉大
呈	口王󰀘
咱	口丿目󰀝
描	扌艹田󰀝
池	氵也󰁀
姐	女󰀐一󰀝
寒	宀󰀀八󰁦
宫	宀口口󰀘
戴	土田󰁺丶
赤	土󰁖󰁧
腰	月覀女󰀝
寸	寸一亅丶
敬	艹勹口夂
懂	忄艹丿土
忆	忄乙󰁀
洁	氵士口󰀝
丹	󰀼亠󰀌
渡	氵广廿又
跃	口止丿大
贝	贝丨󰁈丶
碰	石䒑󰅊一
凝	冫匕𠂉󰁾
诸	讠土丿日
励	厂一󰁡力
幕	艹日大丨
柱	木丶王󰀝
奖	丬夕大󰁧
缘	纟󰅂一󰀓
奶	女乃ノ
智	𠂉大口日
污	氵二ㄅ󰁀
奔	大十廾󰀬
扫	扌彐󰀝
隶	󰁬氺󰀦
网	冂乂乂󰀦
饱	⺈󰁐勹巳
魏	禾女白厶
肃	󰁬󰅏󰀯󰀵
轨	车九󰁀
虎	󰅋七几󰁫
杜	木土󰀝
隐	阝⺈彐心
兄	口儿󰀅
廷	丿士廴󰀌
鉴	〢𠂉丶金
寻	彐寸󰁧
袋	亻󰀁丶󰀔
申	日丨󰀵
隆	阝夂一主
诚	讠厂𠃌丶
遵	丷西一辶
票	覀二小󰁧
梦	木木夕󰁧
哲	扌斤口󰀘
纱	纟小丿ノ
亩	亠田󰀘
猛	犭ノ子皿
兼	䒑󰁬󰁗󰁧
埔	土一月丶
珍	王人彡ノ
抢	扌人⺋󰁀
趣	土󰁾耳又
厘	厂日土󰀌
允	厶儿󰀅
博	十一月寸
鬼	白󰁜厶󰀦
荒	艹亠󰄃󰀸
铺	钅一月丶
伦	亻人匕󰁀
汤	氵ㄋ󰁤ノ
恰	忄人一口
拔	扌又丶
恐	工几丶心
弯	亠󰁗弓󰀅
晓	日弋丿儿
圣	又土󰀘
颗	日木丆贝
奏	三人一大
妹	女二󰅇󰁶
忠	口丨心󰁧
循	彳⺁十目
沟	氵勹厶󰁶
航	丿󰁪亠几
柴	止匕木󰁧
碍	石日一寸
舟	丿󰁪󰀦
寄	宀大丁口
钻	钅󰀥口󰀝
抬	扌厶口󰀝
郑	䒑大阝󰀢
稀	禾乂丨
页	丆贝󰁧
喷	口十艹贝
摸	扌艹日大
炭	山火󰁧
巧	工一ㄅ󰁀
柯	木丁口󰀝
贴	贝󰀥口󰀝
桌	󰀥日木󰁧
劲	ス工力ノ
腾	月䒑大一
妻	一󰁬丨女
铸	钅三丿寸
锐	钅丷口儿
陶	阝勹󰅎山
弃	亠厶廾󰀬
赫	土󰁖土󰁖
乏	丿之󰁧
阔	门氵丿古
紫	止匕ㄠ小
牌	丿丨一十
挤	扌文󰀯󰀢
迷	米辶󰀦
闹	门亠冂丨
罚	罒讠刂󰀬
拍	扌白󰀝
码	石󰀊一󰀝
偶	亻日冂丶
祥	礻󰁶䒑󰀟
届	尸由󰀌
邻	人丶󰁻阝
暂	车斤日󰀘
膜	月艹日大
乌	勹ㄅ一󰀌
磷	石米夕丨
胆	月日一󰀝
撤	扌亠厶夂
戏	又戈󰁶
辉	⺌一儿车
讯	讠⺄十󰀢
仁	亻二󰀝
巩	工几丶󰁶
碧	王白石󰀘
瓜	⺁厶󰂃󰀦
忍	刀丶心󰁧
签	⺮人一一
邓	又阝󰀢
吉	士口󰀘
储	亻讠土日
桂	木土土󰀝
递	丷弓丨辶
疗	疒了󰀵
宾	宀󰅍一八
滴	氵亠丷古
柬	一󰀹󰅇󰀦
绳	纟口日乚
扰	扌乚丶
洛	氵夂口󰀝
腿	月彐󰀖辶
详	讠䒑󰀟󰀢
虫	虫丨󰁈丶
牲	牜丿主󰀝
悲	丨三丨心
呆	口木󰁧
齿	止人凵󰀬
狂	犭ノ王󰀝
柳	木󰁚丿卩
暖	日爫一又
竞	立口儿󰀅
链	钅车辶󰁶
催	亻山亻󰁷
仲	亻口丨󰀢
烂	火丷三󰀝
醒	西一日主
挖	扌宀八乙
纹	纟文󰁶
哭	口口大丶
畜	亠ㄠ田󰀘
玩	王二儿󰁀
籍	⺮三󰅇日
浅	氵二󰅅丶
缝	纟夂三辶
怒	女又心󰁧
貌	豸白儿󰁀
悉	丿米心󰁧
乃	乃ㄋ丿
踏	口止水日
柔	󰁻乛亅木
享	亠口子󰀘
赏	⺌冖口贝
冒	曰目󰀘
圭	土土󰀘
浆	丬夕水󰁧
晨	日厂二󰀖
彼	彳󰅌又󰁶
呵	口丁口󰀝
肩	丶尸月󰀌
爬	⺁丨󰂃巴
皆	󰁴匕白󰀘
氨	󰅎⺄宀女
纵	纟人人󰁶
租	禾󰀐一󰀝
尘	小土󰀘
巡	巛辶󰁫
绪	纟土丿日
瓶	䒑廾一丶
帽	冂丨曰目
泉	白水󰁧
幼	ㄠ力ノ
稿	禾亠口口
钠	钅冂人󰁶
冠	冖二儿寸
弧	弓⺁厶󰂃
趋	土󰁾⺈彐
渔	氵󰁢一󰀝
役	彳几又󰁶
伴	亻丷󰀟󰀢
辟	尸口立十
抚	扌二󰁜󰁀
伐	亻戈󰁶
凭	亻丿士几
纠	纟󰁐丨󰀢
敏	𠂉母夂󰁶
霸	󰀙廿口月
铝	钅口口󰀝
凤	几又󰀦
羊	䒑󰀟󰀬
婆	氵󰅌又女
袭	ヒ丶󰀔
祝	礻󰁶口儿
牢	宀丿󰀟󰀬
浙	氵扌斤󰀢
锁	钅⺌贝󰁶
译	讠又󰀟󰀢
糊	米古月󰀝
胸	月勹乂凵
壳	士冖几󰀅
胁	月力八󰁶
爹	八乂夕夕
愤	忄十艹贝
涂	氵人一木
疆	弓土一一
辈	丨三丨车
迟	尸󰂃辶󰀦
龄	止人凵󰁻
奥	丿ㄇ米大
逆	䒑凵丿辶
填	土十󰀣八
寿	三丿寸󰁧
轧	车乚󰁀
旦	日一󰀘
恨	忄彐󰀖󰁶
融	一口冂虫
署	罒土丿日
搬	扌丿󰁪又
秩	禾󰅎人󰁶
铅	钅几口󰀝
盆	八刀皿󰀘
鸣	口勹丶一
杯	木丆卜󰁶
灌	氵艹口󰁷
阀	门亻戈󰀦
串	口口丨󰀵
豪	亠口冖󰀓
患	口口丨心
挺	扌丿士廴
沈	氵冖󰁜󰁀
掩	扌大日乚
乳	爫孑乚󰁀
鸟	勹丶ㄅ一
韩	十日十丨
贮	贝宀一󰀝
添	氵一大⺗
扣	扌口󰀝
逼	一口田辶
悬	󰀐一厶心
岭	山人丶󰁻
宇	宀一󰀛󰀬
臂	尸口立月
烯	火乂丨
凉	冫亠口小
朵	几木󰁧
侦	亻󰀥贝󰁶
秒	禾小丿ノ
稻	禾爫臼󰀝
番	丿米田󰀘
眉	󰁅目󰀌
驱	󰀊󰀞匚乂
螺	虫田ㄠ小
氮	󰅎⺄火火
丈	󰂃󰀦
漫	氵日罒又
筹	⺮三丿寸
琴	王王人乛
厅	厂丁󰀵
雾	󰀙夂力󰁣
陕	阝一丷大
辽	了辶󰀵
巯	ス工亠󰀸
绘	纟人二厶
梯	木丷弓丿
鞋	廿口十土
拟	扌󰁐丶人
孤	孑⺁厶󰂃
拜	三十󰀢
僚	亻大丷小
辑	车口耳󰀝
倡	亻日日󰀝
丙	一冂人󰀦
仰	亻󰁚卩󰀢
惜	忄󰁺日󰀝
斥	斤丶󰀦
扶	扌二人󰁶
漏	氵尸雨󰁶
俗	亻八人口
苗	艹田󰀘
姆	女母󰁶
辅	车一月丶
拒	扌匚󰁃󰀝
偿	亻⺌冖厶
碗	石宀夕⺋
锡	钅日勹󰁤
返	⺁又辶󰀦
狗	犭ノ勹口
鸿	氵工勹一
辞	丿古立十
埋	土日土󰀝
芽	艹󰀂亅丿
矩	𠂉大匚󰁃
岗	山冂乂󰁧
燥	火口口木
崇	山宀二小
庙	广由󰀌
咬	口亠八乂
赋	贝二止丶
奉	三人󰀟󰀬
厉	厂一󰁡󰀏
桃	木儿󰀪󰁶
孟	子皿󰀘
摄	扌耳又又
阅	门丷口儿
涌	氵󰁻月丨
啥	口人干口
妙	女小丿ノ
勾	勹厶󰀦
讼	讠八厶󰁶
橡	木⺈口󰀓
蚀	⺈󰁐虫󰁶
蜡	虫󰁺日󰀝
抛	扌九力ノ
狠	犭ノ彐󰀖
熙	匚丨口灬
扭	扌󰁈丨二
拨	扌ㄥ丿丶
蒋	艹丬夕寸
框	木匚王󰀝
冻	冫󰀂小󰁶
亏	二ㄅ󰁫
嫩	女一口夂
叙	人一木又
剪	䒑月刂刀
曼	日罒又󰁧
叛	丷󰀠⺁又
杰	木灬󰁧
劝	又力ノ
叔	󰀥一小又
熔	火宀八口
饮	⺈󰁐⺈人
仔	亻子󰀝
骗	󰀊󰀞丶艹
撞	扌立日土
桑	又又又木
屈	尸凵山󰀵
棒	木三人󰀟
赖	一口󰅇贝
刷	尸冂丨刂
估	亻古󰀝
淀	氵宀一󰁾
吏	一口乂󰀦
笼	⺮ヒ丶
簧	⺮󰁺由八
扇	丶尸羽󰀌
谱	讠䒑󰅊日
酷	西一丿口
衰	亠口一󰀔
棚	木月月󰀝
壤	土亠口󰀔
苯	艹木一󰀘
伪	亻丶丿丶
轰	车又又󰁧
侨	亻丿大󰀯
牵	大冖丿󰀟
鼻	丿目田󰀯
叹	口又󰁶
骂	口口󰀊一
骤	󰀊󰀞耳乑
丧	十䒑󰀖󰁧
旺	日王󰀝
哩	口日土󰀝
隙	阝小日小
曹	一ㄇ󰁺日
疾	疒𠂉大󰀦
吐	口土󰀝
册	󰀼󰀼一󰀌
覆	覀彳𠂉夂
晋	一󰅊一日
扑	扌卜󰁶
御	彳󰅎止卩
搜	扌臼丨又
仗	亻󰂃󰁶
昨	日𠂉丨二
舒	人干口亅
株	木󰅎󰅇󰁶
嘛	口广木木
欣	斤⺈人󰁶
胀	月丿七󰂃
砂	石小丿ノ
腔	月宀八工
偷	亻人一刂
络	纟夂口󰀝
顽	二儿丆贝
涨	氵弓丿󰂃
甜	丿古艹二
吊	口冂丨󰀬
盗	冫⺈人皿
杭	木亠几󰁀
尸	尸󰁈一丿
捉	扌口󰁾󰁶
毅	立󰀓几又
迈	一󰁡辶󰀏
脏	月广土󰀝
狱	犭ノ讠丶
搭	扌艹人口
飘	覀二小乂
炎	火火󰁧
瘦	疒臼丨又
浸	氵彐冖又
硅	石土土󰀝
跨	口止大ㄅ
浇	氵弋丿儿
粘	米󰀥口󰀝
雅	󰀂亅丿󰁷
昆	日󰁴匕󰀅
槽	木一ㄇ日
漆	氵木人氺
抑	扌󰁚卩󰀢
悄	忄⺌月󰀝
蓄	艹亠ㄠ田
锦	钅白冂丨
歪	丆卜一止
贷	亻󰀁丶贝
烦	火丆贝󰁶
撒	扌󰁺月夂
沸	氵弓󰀯󰀢
闲	门木󰀦
亭	亠口冖丁
肚	月土󰀝
掘	扌尸凵山
邀	白方夂辶
郎	丶彐厶阝
浩	氵丿土口
燕	廿口丬灬
漂	氵覀二小
惩	彳一止心
妥	爫女󰀘
傅	亻一月寸
牺	牜西󰀝
贪	人丶乛贝
迁	丿十辶󰀵
渠	氵匚󰁃木
丢	丿土厶󰁧
鸭	甲勹丶一
绒	纟戈ノ
钉	钅丁󰀢
滩	氵又亻󰁷
帐	冂丨丿󰂃
硝	石⺌月󰀝
耀	⺌一儿󰁷
膨	月士口彡
邮	由阝󰀢
贤	〢又贝󰁧
誉	󰀧一八言
瓷	冫⺈人丶
欺	艹三八人
丛	人人一󰀘
抹	扌一木󰁶
忧	忄乚丶
陪	阝立口󰀝
吾	五口󰀘
劣	小丿力󰁣
惠	一日丨心
钾	钅甲󰀢
焰	火⺈臼󰀝
徽	彳山一夂
堡	亻口木土
凶	乂凵󰀵
摘	扌亠丷古
闷	门心󰀦
脆	月⺈厂⺋
姚	女儿󰀪󰁶
雕	󰀼土口󰁷
陵	阝土八夂
董	艹丿一土
诺	讠艹口
泵	石水󰁧
赴	土󰁾卜󰀦
剑	人一󰀧刂
腊	月󰁺日󰀝
窝	宀八口人
卢	󰀥尸󰁣
锻	钅亻三又
罐	󰅎山艹󰁷
览	〢𠂉丶󰁜
宴	宀日女󰀘
昏	󰁚弋日󰀘
溪	氵爫ㄠ大
疯	疒几乂󰀦
逮	󰁬氺辶󰀦
裕	衤󰁧八口
盈	乃又皿󰀘
勘	艹三八力
缴	纟白方夂
穆	禾白小彡
幻	ㄠ𠃌󰁀
锥	钅亻󰁷󰀝
坑	土亠几󰁀
宿	宀亻丆日
泼	氵ㄥ丿丶
湘	氵木目󰀝
垄	ヒ丶土
饰	⺈󰁐𠂉丨
驶	󰀊󰀞口乂
煮	土丿日灬
刮	丿古刂󰀢
砍	石⺈人󰁶
疏	乛止亠󰀸
旱	日干󰀬
慌	忄艹亠󰀸
渗	氵厶大彡
戈	戈一󰁒丶
汪	氵王󰀝
悟	忄五口󰀝
昂	日󰁚卩󰀬
桶	木󰁻月丨
颇	󰅌又丆贝
骑	󰀊󰀞大口
佳	亻土土󰀝
霍	󰀙亻󰁷󰀘
旨	匕日󰀘
芯	艹心󰁧
畅	日丨ㄋ󰁤
旬	勹日󰀌
摊	扌又亻󰁷
墙	土十䒑口
敲	亠口冂又
蔬	艹乛止󰀸
痕	疒彐󰀖󰀦
惨	忄厶大彡
钙	钅一󰀥ㄅ
尝	⺌冖二厶
棱	木土八夂
辨	立丶十
箭	⺮䒑月刂
躺	丿󰀽三口
苍	艹人⺋󰀅
莱	艹一米󰁧
债	亻主贝󰁶
吞	一大口󰀘
坝	土贝󰁶
卿	󰁚丿彐卩
挡	扌⺌彐󰀝
柏	木白󰀝
萧	艹󰁬󰅏󰀯
颠	十󰀣八贝
霉	󰀙𠂉母󰁧
谊	讠宀󰀐一
妨	女方ノ
黏	禾人氺口
漠	氵艹日大
辆	车一冂人
郊	亠八乂阝
俩	亻一冂人
彭	士口䒑彡
夕	夕丿乛丶
凌	冫土八夂
宏	宀厶󰁧
逻	罒夕辶󰀦
淮	氵亻󰁷󰀝
饥	⺈󰁐几󰁀
熊	厶月匕灬
绅	纟日丨󰀢
霞	󰀙󰁃丨又
冶	冫厶口󰀝
垫	扌九丶土
蓬	艹夂三辶
冯	冫󰀊一󰀝
喂	口田一󰀖
瞧	目亻󰁷灬
玄	亠ㄠ󰁧
岂	山己󰀅
叠	又又又一
葡	艹勹一丶
哀	亠口󰀔󰁧
仙	亻山󰀢
吓	口一卜󰁶
棋	木艹三八
滨	氵宀󰅍八
丘	󰅍一󰀌
佩	亻几一丨
寺	土寸󰁧
犹	犭ノ丶
禄	礻󰁶󰁭氺
驰	󰀊󰀞也󰁀
莲	艹车辶󰁧
匹	匚儿󰁫
徙	彳止󰁾󰁶
诬	讠工人人
拾	扌人一口
枯	木古󰀝
浑	氵冖车󰀢
颂	八厶丆贝
驳	󰀊󰀞乂乂
慰	尸二小心
诱	讠禾乃ノ
勿	勹󰁤󰀏
邰	厶口阝󰀢
歇	日勹人人
阁	门夂口󰀌
嘉	士口䒑口
沫	氵一木󰁶
拳	䒑大手󰀬
饼	⺈󰁐䒑廾
戚	厂󰀥一丶
皱	⺈彐󰅌又
掠	扌亠口小
塘	土广󰁬口
仇	亻九󰁀
锭	钅宀一󰁾
竭	立日勹󰄃
娃	女土土󰀝
冤	冖⺈口丶
凸	丨一丨一
拆	扌斤丶󰁶
曰	日丨󰁈一
掀	扌斤⺈人
朴	木卜󰁶
摧	扌山亻󰁷
溜	氵󰁚丶田
卸	󰅎止卩󰀢
堵	土土丿日
筛	⺮リ一丨
疲	疒󰅌又󰀦
栽	土木󰅅丶
胎	月厶口󰀝
腹	月𠂉日夂
驾	力口󰀊一
纬	纟二𠃌丨
扯	扌止󰀝
颁	八刀丆贝
饿	⺈󰁐丿丶
悠	亻丨夂心
祸	礻󰁶口人
慧	三丨三心
舰	丿󰁪ㄇ󰁜
姿	冫⺈人女
恋	亠󰁗心󰁧
遂	䒑󰀓辶󰀦
卧	匚丨󰁃卜
怨	夕⺋心󰁧
醉	西一亠十
廉	广䒑󰁬󰁗
遣	口丨一辶
狭	犭ノ一大
菲	艹丨三三
犁	禾刂丿󰀟
侯	亻ユ𠂉大
羽	羽𠃌丶󰀞
姻	女囗大󰁶
抖	扌󰁦十󰀢
契	三丨刀大
萄	艹勹󰅎山
阐	门丷󰅐󰀵
盲	亠󰄃目󰀘
躲	丿󰀽三木
韦	二𠃌丨󰀵
谐	讠󰁴匕白
兆	儿󰀪󰀦
舌	丿古󰀌
佐	亻工󰀝
屏	尸䒑廾󰀵
妄	亠󰄃女󰀘
肠	月ㄋ󰁤ノ
酵	西一土子
墓	艹日大土
恒	忄一日一
缸	󰅎山工󰀝
柄	木一冂人
敦	亠口孑夂
慎	忄十󰀣八
堤	土日一󰁾
逝	扌斤辶󰀵
贼	贝戈ノ
辖	车宀三口
魂	二厶白厶
押	扌甲󰀢
栏	木丷三󰀝
祟	凵山二小
肖	⺌月󰀘
茅	艹󰁻乛丿
捷	扌一󰁬󰁾
捞	扌艹冖力
艳	三丨⺈巴
蜂	虫夂三丨
逢	夂三丨辶
罩	罒󰀥日十
档	木⺌彐󰀝
兽	丷田一口
辱	厂二󰀖寸
搅	扌󰀧冖󰁜
臭	丿目大丶
蔽	艹丷冂夂
铃	钅人丶󰁻
乔	丿大󰀯󰀬
雇	丶尸亻󰁷
挽	扌⺈口󰁜
芬	艹八刀󰁣
砌	石七刀ノ
拌	扌丷󰀟󰀢
翠	羽亠人十
醇	西一亠子
弥	弓⺈小󰁶
嫂	女臼丨又
粹	米亠人十
披	扌󰅌又󰁶
狼	犭ノ丶󰀖
窄	宀八𠂉二
柜	木匚󰁃󰀝
淋	氵木木󰁶
晴	日主月󰀝
拘	扌勹口󰀝
寂	宀󰀥一又
滋	氵䒑ㄠㄠ
鸦	󰀂亅丿一
誓	扌斤言󰀘
咸	厂一口丶
茫	艹氵亠󰄃
凑	冫三人大
芝	艹之󰁧
餐	󰀥夕又󰀖
账	贝丿七󰂃
幽	山ㄠㄠ󰀦
殿	尸󰁺八又
盒	人一口皿
篡	⺮目大厶
萌	艹日月󰀘
挣	扌⺈󰁬亅
畏	田一󰀖󰁧
遥	爫󰅎山辶
颤	亠囗口贝
酬	西一丶丨
奸	女干󰀢
厌	厂大丶󰀦
洒	氵西󰀝
垦	彐󰀖土󰀘
赔	贝立口󰀝
挨	扌厶𠂉大
抄	扌小丿ノ
缔	纟亠丷丨
峡	山一丷大
芦	艹丶尸󰁣
倘	亻⺌冂口
坯	土丆卜一
履	尸彳𠂉夂
巾	冂丨󰀵
宙	宀由󰀘
劫	土厶力ノ
酿	西一丶󰀖
矣	厶𠂉大󰁧
闯	门󰀊一󰀌
晃	日⺌一儿
帜	冂丨口八
捐	扌口月󰀝
矮	𠂉大禾女
澳	氵丿ㄇ大
愁	禾火心󰁧
窃	宀八七刀
烘	火󰁺八󰁶
昭	日刀口󰀝
奈	大二小󰁧
滥	氵〢𠂉皿
戒	戈廾󰀵
丑	󰁈丨二󰀌
蔡	艹󰁯二小
遮	广廿灬辶
肺	月一冂丨
喀	口宀夂口
膀	月亠丷方
夸	大二ㄅ󰀅
馏	⺈󰁐󰁚田
俱	亻󰀣八󰁶
澄	氵癶一䒑
窑	宀八󰅎山
稼	禾宀一󰀓
仆	亻卜󰁶
壶	士冖󰅊一
蔑	艹罒厂丶
裤	衤󰁧广车
渣	氵木日一
姜	丷王女󰀘
媳	女丿目心
爽	大乂乂乂
岌	山乃󰂃󰁧
绵	纟白冂丨
纶	纟人匕󰁀
饶	⺈󰁐弋儿
竖	〢又立󰀘
椅	木大丁口
捧	扌三人󰀟
吕	口口󰀘
纽	纟󰁈丨二
拚	扌厶廾󰀢
殷	⺁彐𠃌又
鼠	臼󰁐󰁦󰁒
卑	白丿十󰀬
涛	氵三丿寸
郁	月阝󰀢
汁	氵十󰀢
闽	门虫󰀦
焊	火日干󰀢
孝	土丿子󰀘
颈	ス工丆贝
茂	艹厂󰅅丶
舆	󰀗车一八
唤	口⺈ㄇ大
肌	月几󰁀
址	土止󰀝
掏	扌勹󰅎山
伞	人丷十󰀬
鞭	廿口十乂
缚	纟一󰀐寸
撑	扌⺌冖手
杠	木工󰀝
鼎	目󰁕丆󰁈
谴	讠口丨辶
涤	氵夂木󰁶
询	讠勹日󰀝
哨	口⺌月󰀝
帅	リ冂丨󰀢
宅	宀丿七󰀅
堪	土艹三󰄃
韧	二𠃌丨丶
拦	扌丷三󰀝
眠	目󰁃󰁐弋
麟	广󰁃〢丨
碑	石白丿十
缠	纟广日土
巷	󰁺八巳󰀅
趁	土󰁾人彡
秧	禾ㄇ大󰁶
猜	犭ノ主月
欠	⺈人󰁧
坛	土二厶󰁶
茎	艹ス工󰀘
晒	日西󰀝
榜	木亠丷方
炳	火一冂人
挫	扌人人土
跌	口止󰅎人
糟	米一ㄇ日
攀	木乂乂手
酯	西一匕日
慨	忄彐厶󰁜
携	扌亻󰁷乃
鄂	口口二阝
氛	󰅎⺄八刀
霜	󰀙木目󰀘
棍	木日󰁴匕
锤	钅丿十一
沾	氵󰀥口󰀝
侍	亻土寸󰁶
斑	王文王󰀝
豫	󰁻乛亅󰀓
辊	车日󰁴匕
崩	山月月󰀘
萍	艹氵一十
儒	亻󰀙丆〢
蓉	艹宀八口
谬	讠羽人彡
惟	忄亻󰁷󰀝
浊	氵虫󰁶
吵	口小丿ノ
揉	扌󰁻乛木
蛮	亠󰁗虫󰁧
瞬	目爫冖丨
叉	又丶󰀦
缆	纟〢𠂉󰁜
荐	艹丨子
哎	口艹乂󰁶
溉	氵彐厶󰁜
悦	忄丷口儿
朽	木一ㄅ󰁀
赠	贝丷󰀺日
郡	󰁬丿口阝
踪	口止宀小
泄	氵廿󰄃󰁀
疼	疒夂󰁦󰀦
剖	立口刂󰀢
苹	艹一丷十
锌	钅立十󰀢
耶	耳阝󰀢
妃	女己󰁀
迪	由辶󰀌
孳	䒑ㄠㄠ子
睁	目⺈󰁬亅
亥	亠ㄥ丿人
弊	丷冂󰅏廾
匠	匚斤󰀵
桐	木冂一口
嫌	女䒑󰁬󰁗
岳	󰅍一山󰀬
乾	十日十乙
酚	西一八刀
穴	宀八󰁧
嫁	女宀一󰀓
烤	火土丿ㄅ
玲	王人丶󰁻
捣	扌勹丶山
甫	一月丨丶
邵	刀口阝󰀢
潭	氵覀日十
慕	艹日大⺗
炒	火小丿ノ
浒	氵讠𠂉十
畴	田三丿寸
匪	匚丨三三
撕	扌艹三斤
嚷	口亠口󰀔
溢	氵䒑八皿
顷	󰁴丆贝󰁶
聪	耳丷口心
翁	八厶羽󰀘
沃	氵丿大󰁶
谦	讠䒑󰁬󰁗
晰	日木斤󰀢
甸	勹田󰀌
歧	止十又󰁶
诊	讠人彡ノ
祁	礻󰁶阝󰀢
咨	冫⺈人口
潘	氵丿米田
谭	讠覀日十
礁	石亻󰁷灬
弓	弓󰁈一ㄅ
屠	尸土丿日
酶	西一𠂉母
枢	木匚乂󰁶
吟	口人丶乛
喉	口亻ユ大
浴	氵八人口
颖	匕禾丆贝
症	疒一止󰀌
衬	衤󰁧寸󰁶
溃	氵口丨贝
崖	山厂土土
勉	⺈口󰁜力
卓	󰀥日十󰀬
琼	王亠口小
迭	󰅎人辶󰀦
婴	贝贝女󰀘
沪	氵丶尸ノ
氟	󰅎⺄弓󰀯
绞	纟亠八乂
挪	扌𠃌󰀠阝
辣	立一󰅇
仑	人匕󰀅
庞	广ヒ丶
诞	讠丿止廴
吁	口一󰀛󰀢
醋	西一󰁺日
浦	氵一月丶
菱	艹土八夂
耻	耳止󰀝
俘	亻爫子󰀝
谣	讠爫󰅎山
篮	⺮〢𠂉皿
廊	广丶彐阝
惧	忄󰀣八󰁶
蹲	口止丷寸
盼	目八刀ノ
赐	贝日勹󰁤
挠	扌弋丿儿
陡	阝土󰁾󰁶
棵	木日木󰁶
翅	十又羽󰀌
峻	山厶八夂
俺	亻大日乚
厨	厂一口寸
翔	䒑󰀠羽󰀝
赢	亠󰄃口丶
愚	日冂丨心
拓	扌石󰀝
惑	戈口󰀞心
绸	纟󰀼土口
杏	木口󰀘
咽	口囗大󰁶
扮	扌八刀ノ
蒲	艹氵一丶
绣	纟禾乃ノ
唉	口厶𠂉大
梳	木亠厶󰀸
逸	⺈口󰁜辶
菊	艹勹米󰁧
艾	艹乂󰁧
铲	钅立丿ノ
膏	亠口冖月
羞	䒑󰀠󰁈二
葛	艹日勹󰄃
骄	󰀊󰀞丿󰀯
悼	忄󰀥日十
庸	广󰁬月丨
蒂	艹亠丷丨
宰	宀立十󰀬
渴	氵日勹󰄃
肆	󰀍厶󰁬󰀟
魔	广木木厶
榨	木宀八二
蔗	艹广廿灬
秆	禾干󰀢
鹏	月月勹一
灶	火土󰀝
肤	月二人󰁶
怜	忄人丶󰁻
捻	扌人丶心
俊	亻厶八夂
恼	忄亠乂凵
滞	氵一〣丨
凹	丨󰁎󰀽一
倚	亻大丁口
祭	󰁯二小󰁧
葬	艹一夕廾
拢	扌ヒ丶
慈	䒑ㄠㄠ心
砸	石匚冂丨
衍	彳氵一丁
嗓	口又又木
凿	󰅊一䒑凵
唇	厂二󰀖口
尿	尸水󰀦
衫	衤󰁧彡ノ
衔	彳钅一丁
拐	扌口力ノ
脾	月白丿十
锯	钅尸古󰀝
傲	亻主󰁡夂
萝	艹罒夕󰁧
猎	犭ノ󰁺日
夷	一弓人󰀦
贞	󰀥贝󰁧
昙	日二厶󰁧
罕	冖八干󰀬
厦	厂丆目夂
愉	忄人一刂
扔	扌乃ノ
邪	󰀂亅丿阝
坊	土方ノ
媒	女艹二木
脊	󰀪人月󰀘
蕴	艹纟日皿
呖	口厂力ノ
芒	艹亠󰄃󰀅
烫	氵ㄋ󰁤火
恳	彐󰀖心󰁧
哇	口土土󰀝
蛇	虫宀匕󰁀
诏	讠刀口󰀝
昼	尸󰂃日一
铭	钅夕口󰀝
镁	钅丷王大
帕	冂丨白󰀝
冈	冂乂󰀦
胖	月丷󰀟󰀢
刨	勹巳刂󰀢
枚	木夂󰁶
寓	宀日冂丶
荫	艹阝月󰀘
辰	厂二󰀖󰀦
贩	贝⺁又󰁶
娓	女尸丿乚
猫	犭ノ艹田
笛	⺮由󰀘
盯	目丁󰀢
锈	钅禾乃ノ
贾	覀贝󰁧
藤	艹月䒑氺
楔	木三丨大
衷	亠口丨󰀔
僵	亻一田一
斩	车斤󰀢
扁	丶尸冂艹
谕	讠人一刂
淑	氵󰀥一又
厢	厂木目󰀌
甩	月乚󰁫
蚕	一大虫󰁧
禽	人亠乂厶
匆	勹󰁤丶󰀦
捏	扌日土󰀝
瞎	目宀三口
忌	己心󰁧
孕	乃子󰀘
荆	艹一廾刂
俭	亻人一一
肝	月干󰀢
钦	钅⺈人󰁶
缅	纟丆冂三
熄	火丿目心
屑	尸⺌月󰀌
裸	衤󰁧日木
葱	艹勹󰁤心
垒	厶厶厶土
铀	钅由󰀝
淘	氵勹󰅎山
摔	扌亠ㄠ十
暑	日土丿日
哼	口亠口了
勋	口贝力ノ
悔	忄𠂉母󰁶
钞	钅小丿ノ
垮	土大二ㄅ
婶	女宀日丨
嘱	口尸丿丶
鹿	广󰁃〢匕
胺	月宀女󰀝
捆	扌囗木󰁶
谅	讠亠口小
艘	丿󰁪臼又
梭	木厶八夂
梨	禾刂木󰁧
奠	丷西一大
玛	王󰀊一󰀝
栅	木󰀼󰀼一
帘	宀八冂丨
哑	口一󰅊一
皂	白七󰀅
哦	口丿扌丶
烷	火宀二儿
喇	口一口刂
恭	󰁺八⺗󰁧
扛	扌工󰀝
苛	艹丁口󰀘
秤	禾一丷十
屡	尸米女󰀌
耿	耳火󰁶
喘	口山丆〢
愧	忄白󰁜厶
爪	⺁丨󰂃󰀦
叭	口八󰁶
逊	孑小辶󰀦
诈	讠𠂉丨二
俯	亻广亻寸
椭	木阝月
搏	扌一月寸
谨	讠廿口主
拄	扌丶王󰀝
烃	火ス工󰀝
吻	口勹󰁤ノ
绑	纟三丿阝
骚	󰀊󰀞又虫
刹	乂木刂󰀢
熬	主󰁡夂灬
胚	月丆卜一
雀	小亻󰁷󰀘
屯	一凵乚󰁫
拴	扌人王󰀝
拱	扌󰁺八󰁶
舶	丿󰁪白󰀝
裹	亠日木󰀔
矢	𠂉大󰁧
寡	宀丆󰀐刀
栋	木󰀂小󰁶
粤	丿囗米ㄅ
碘	石ㄇ󰁺八
栖	木西󰀝
酱	丬夕西一
肪	月方ノ
薯	艹罒土日
囊	一口丨󰀔
弗	弓󰀯󰀵
惕	忄日勹󰁤
艇	丿󰁪丿廴
肿	月口丨󰀢
汛	氵⺄十󰀢
粱	氵刀八米
敞	⺌冂口夂
冀	丬匕田八
氓	亠󰄃󰁃弋
蜜	宀心丿虫
辐	车一口田
钩	钅勹厶󰁶
哗	口亻ヒ十
廓	广亠口阝
贱	贝二󰅅丶
聘	耳由一ㄅ
舅	臼田力󰁣
滔	氵爫臼󰀝
忉	忄刀ノ
炕	火亠几󰁀
瞪	目癶一䒑
狮	犭ノリ丨
咳	口亠ㄥ人
啡	口丨三三
葫	艹古月󰀘
喻	口人一刂
樱	木贝贝女
龟	⺈日乚󰀅
锰	钅子皿󰀝
擅	扌亠囗一
灿	火山󰀢
谎	讠艹亠󰀸
坎	土⺈人󰁶
卤	󰀥囗乂󰁧
褐	衤󰁧日󰄃
藩	艹氵丿田
毯	丿二乚火
戊	厂󰅅丶󰀦
闸	门甲󰀵
渊	氵丿米丨
譬	尸口立言
胳	月夂口󰀝
斋	文丆冂〢
梢	木⺌月󰀝
崭	山车斤󰀬
扒	扌八󰁶
凄	冫一󰁬女
坪	土一丷十
泳	氵丶𠃌󰀩
忿	八刀心󰁧
宦	宀匚丨丨
枣	一ㄇ󰅇󰁦
狡	犭ノ亠乂
鹰	广亻亻一
笨	⺮木一󰀘
痒	疒䒑󰀟󰀵
傍	亻亠丷方
烹	亠口了灬
怖	忄冂丨
匈	勹乂凵󰀵
塌	土日羽󰀝
咖	口力口󰀝
莽	艹大丶廾
尉	尸二小寸
钝	钅一凵乚
粪	米󰁺八󰁧
迄	𠂉乙辶󰁫
坟	土文󰁶
胃	田月󰀘
郝	土󰁖阝󰀢
寥	宀羽人彡
嘿	口󰀹土灬
兔	⺈口󰁜丶
虹	虫工󰀝
涅	氵日土󰀝
拼	扌䒑廾󰀢
笋	⺮󰁬丿󰁣
镶	钅亠口󰀔
嵌	山艹二人
秉	丿一󰁬󰅇
掺	扌厶大彡
敷	一󰀐丨夂
煽	火丶尸羽
氰	󰅎⺄主月
倦	亻䒑大⺋
聊	耳󰁚丿卩
踩	口止爫木
寇	宀二儿又
哟	口纟勹丶
糕	米丷王灬
筋	⺮月力󰁣
刃	刀丶󰀦
辫	立纟十
跪	口止⺈⺋
穗	禾一日心
扼	扌厂⺋󰁀
庐	广丶尸󰀏
梗	木一日乂
屿	山一ㄅ一
虏	󰅋七力󰀏
沥	氵厂力ノ
憾	忄厂一心
歼	一夕丿十
烛	火虫󰁶
诵	讠󰁻月丨
煌	火白王󰀝
釉	丿米由󰀝
枕	木冖󰁜󰁀
姨	女一弓人
劈	尸口立刀
卵	󰁚丶丿丶
彦	立丿彡󰀏
砖	石二󰁓丶
醛	西一艹王
枉	木王󰀝
肢	月十又󰁶
蹄	口止亠丨
兜	白󰁚󰁃儿
茨	艹冫⺈人
贬	贝丿之󰁶
钊	钅刂󰀢
佣	亻月丨󰀢
汝	氵女󰀝
淆	氵乂月
昔	󰁺日󰀘
讽	讠几乂󰁶
侮	亻𠂉母󰁶
稠	禾󰀼土口
翼	羽田󰁺八
椒	木󰀥一又
钳	钅艹二󰀝
咋	口𠂉丨二
傻	亻丿囗夂
痼	疒囗古󰀌
炊	火⺈人󰁶
庵	广大日乚
帆	冂丨几丶
魄	白白󰁜厶
咯	口夂口󰀝
耽	耳冖󰁜󰁀
贿	贝月󰀝
鳞	󰁢󰀞米丨
丸	九丶󰀦
姬	女匚丨丨
匙	日一󰁾匕
盥	󰀗水皿󰀘
岐	山十又󰁶
仓	人⺋󰀅
翰	十日十羽
哄	口󰁺八󰁶
旷	日广ノ
爵	爫罒彐寸
猴	犭ノ亻大
趟	土󰁾⺌口
瑰	王白󰁜厶
诡	讠⺈厂⺋
踢	口止日󰁤
淹	氵大日乚
沛	氵一冂丨
晕	日冖车󰀬
揽	扌〢𠂉󰁜
桩	木广土󰀝
涵	氵了󰀪凵
僧	亻丷󰀺日
鹤	冖亻󰁷一
裙	衤󰁧󰁬口
畔	田丷󰀟󰀢
耍	丆冂〢女
灼	火勹丶󰁶
滇	氵十󰀣八
沦	氵人匕󰁀
汰	氵大丶󰁶
颊	一丷大贝
膝	月木人氺
懒	忄一口贝
兑	丷口儿󰀅
耙	三󰅇巴󰁀
蹈	口止爫臼
吼	口孑乚󰁀
蕉	艹亻󰁷灬
嗣	口冂艹口
焉	一止一灬
焕	火⺈ㄇ大
汹	氵乂凵󰀢
渥	氵尸一土
辜	古立十󰀬
癌	疒口口山
萎	艹禾女󰀘
钧	钅勹冫󰀝
陌	阝丆日󰀝
煞	⺈彐夂灬
焚	木木火󰁧
佑	亻口󰀝
嘲	口十日月
聂	耳又又󰁧
歉	䒑󰁬󰁗人
骆	󰀊󰀞夂口
屁	尸󰁴匕󰁫
桔	木士口󰀝
惶	忄白王󰀝
衙	彳五口丁
腻	月弋二丶
宠	宀ヒ丶
盏	二󰅅丶皿
袍	衤󰁧勹巳
鞲	廿口十土
捍	扌日干󰀢
锄	钅󰀐󰀞力
惹	艹口心
膛	月⺌冖土
馈	⺈󰁐口贝
蛭	虫一厶土
膊	月一󰀐寸
窜	宀八口丨
娇	女丿大󰀯
乞	𠂉乙󰀅
嚼	口爫罒寸
鄙	口十囗阝
猖	犭ノ日日
绥	纟爫女󰀝
亟	了口又一
抒	扌󰁻乛亅
筐	⺮匚王󰀘
泣	氵立󰀝
篷	⺮夂三辶
拂	扌弓󰀯󰀢
赃	贝广土󰀝
铵	钅宀女󰀝
镀	钅广廿又
钓	钅勹丶󰁶
眷	䒑大目󰀘
兹	䒑ㄠㄠ󰁧
躯	丿󰀽三乂
禹	丿口冂丶
咕	口古󰀝
拣	扌󰀂𠃌八
赚	贝䒑󰁬󰁗
瓣	立⺁十
躁	口止口木
耸	人人耳󰀘
咒	口口几󰀅
箪	⺮丷󰅐󰀬
庚	广󰁬人󰀦
嘻	口士口口
缕	纟米女󰀝
稚	禾亻󰁷󰀝
糙	米丿土辶
挝	扌寸辶󰁶
扳	扌⺁又󰁶
孢	孑勹巳󰁀
酌	西一勹丶
隋	阝工月
哒	口大辶󰁶
勃	十冖孑力
腥	月日丿主
籽	米子󰀝
尧	弋丿一儿
暮	艹日大日
襄	亠口口󰀔
勺	勹丶󰀦
乍	𠂉丨二󰀘
溅	氵贝二丶
溴	氵丿目丶
琳	王木木󰁶
澜	氵门一󰅇
豹	豸勹丶󰁶
唧	口彐厶卩
苟	艹勹口󰀘
拇	扌母󰁶
叮	口丁󰀢
咐	口亻寸󰁶
陛	阝󰁴匕土
瀑	氵日󰁺氺
竿	⺮干󰀬
拧	扌宀丁󰀢
珊	王󰀼󰀼一
皖	白宀二儿
韵	立日勹冫
琐	王⺌贝󰁶
隘	阝䒑八皿
靖	立主月󰀝
邢	一廾阝󰀢
玫	王夂󰁶
撇	扌丷冂夂
僻	亻尸口十
薪	艹立木斤
噪	口口口木
毙	󰁴匕一匕
茄	艹力口󰀘
蜀	罒勹虫󰁧
煎	䒑月刂灬
棕	木宀二小
雁	厂亻亻󰁷
彰	立日十彡
逗	一口䒑辶
絮	女口ㄠ小
淤	氵方人󰁦
崔	山亻󰁷󰀘
荔	艹力力力
矫	𠂉大丿󰀯
赌	贝土丿日
宣	宀一日一
邹	⺈彐阝󰀢
饷	⺈󰁐丿口
褂	衤󰁧土卜
杉	木彡ノ
喧	口宀一一
赣	立日十贝
躬	丿󰀽三弓
痴	疒𠂉大口
撮	扌日耳又
懈	忄⺈月󰀟
凳	癶一口几
沼	氵刀口󰀝
檐	木⺈厂言
瞿	目目亻󰁷
卒	亠人人十
撰	扌巳巳八
睹	目土丿日
憎	忄丷󰀺日
璋	王立日十
韶	立日刀口
募	艹日大力
栓	木人王󰀝
逾	人一月辶
魁	白󰁜厶十
岚	山几乂󰁧
喃	口十冂十
吱	口十又󰁶
鲍	󰁢󰀞勹巳
袜	衤󰁧一木
簇	⺮方𠂉大
琪	王艹三八
魑	白󰁜厶厶
蒜	艹二小小
疙	疒𠂉乙󰁫
寅	宀一由八
禾	禾禾禾禾
鞑	廿口十辶
佃	亻田󰀝
揪	扌禾火󰁶
嗯	口囗大心
粥	弓米弓󰁀
肴	乂月󰀘
泻	氵冖一一
巢	巛日木󰁧
宛	宀夕⺋󰀅
襟	衤󰁧木小
莉	艹禾刂󰀬
鞍	廿口十女
裳	⺌冖口󰀔
奕	亠󰁖大󰁧
赎	贝十乛大
鳙	󰁢󰀞广丨
郓	冖车阝󰀢
雯	󰀙文󰁧
蠢	三人日虫
巍	山禾女厶
侄	亻一厶土
酮	西一冂口
汞	工水󰁧
挟	扌一丷大
唆	口厶八夂
庶	广廿灬󰀦
瞅	目禾火󰁶
硷	石人一一
瞒	目艹一人
眯	目米󰁶
榴	木󰁚丶田
奢	大土丿日
岔	八刀山󰀬
嘘	口󰅋七一
槐	木白󰁜厶
坠	阝人土󰀘
瑟	王王心丿
雹	󰀙勹巳󰀅
缉	纟口耳󰀝
虐	󰅋七匚一
慷	忄广󰁬氺
涧	氵门日󰀝
丞	了󰀩一󰀘
陋	阝一冂󰄃
炽	火口八󰁶
烁	火丿󰄃小
嚣	口口丆口
薛	艹亻󰁃十
邑	口巴󰀅
謇	宀󰀀八言
镰	钅广䒑󰁗
熏	丿一󰀹灬
钥	钅月󰀝
麓	木木广匕
淫	氵爫丿士
剿	巛日木刂
晤	日五口󰀝
驯	󰀊󰀞川󰀢
斧	八乂斤󰀬
畸	田大丁口
媚	女󰁅目󰀝
剔	日勹󰁤刂
铬	钅夂口󰀝
羡	丷王冫人
腺	月白水󰁶
宵	宀⺌月󰀘
蜕	虫丷口儿
姊	女丿ㄅ丿
笙	⺮丿主󰀘
墩	土亠口夂
驴	󰀊󰀞丶尸
喳	口木日一
蔚	艹尸二寸
闺	门土土󰀌
窥	宀八二󰁜
烙	火夂口󰀝
涯	氵厂土土
噢	口丿ㄇ大
蚊	虫文󰁶
黔	󰀹土灬乛
橙	木癶一䒑
歹	一夕󰀦
渍	氵主贝󰁶
魅	白󰁜厶󰅇
碌	石󰁭氺󰁶
睦	目土八土
囚	囗人󰀦
溯	氵䒑凵月
窒	宀八一土
栗	覀木󰁧
芜	艹二󰁜󰀅
厄	厂⺋󰁫
搁	扌门夂口
髓	󰀾月辶
糠	米广󰁬氺
伎	亻十又󰁶
锣	钅罒夕󰁶
桉	木宀女󰀝
楠	木十冂十
骡	󰀊󰀞田小
躅	口止罒虫
镑	钅亠丷方
寞	宀艹日大
腕	月宀夕⺋
狄	犭ノ火󰁶
祺	礻󰁶艹八
嗅	口丿目丶
彝	󰅂一米廾
娥	女丿扌丶
俞	人一月刂
汀	氵丁󰀢
惰	忄工月
殳	几又󰁧
荧	艹冖火󰁧
犬	大丶󰀦
赦	土󰁖夂󰁶
嘎	口丆目戈
骏	󰀊󰀞厶夂
酥	西一禾󰁶
棺	木宀丨󰁃
涩	氵刀丶止
孰	亠口孑丶
蝇	虫口日乚
堕	阝月土
轿	车丿大󰀯
泌	氵心丿ノ
孜	孑夂󰁶
昧	日二󰅇󰁶
迂	一󰀛辶󰀵
妖	女丿大󰁶
牡	牜土󰀝
缀	纟又又又
庇	广󰁴匕󰁫
雍	亠󰁲丿󰁷
笺	⺮二󰅅丶
妆	丬女󰀝
栩	木羽󰀝
聋	ヒ丶耳
涕	氵丷弓丿
蝶	虫廿󰄃木
稽	禾乚日
斌	文二止丶
耦	三󰅇日丶
怯	忄土厶󰁶
咏	口丶𠃌󰀩
磺	石󰁺由八
禀	亠囗口小
枫	木几乂󰁶
伺	亻𠃌一口
釜	八乂干䒑
楞	木罒方ノ
蕊	艹心心心
眨	目丿之󰁶
戋	二󰅅丶󰀦
咀	口󰀐一󰀝
敛	人一󰀧夂
帖	冂丨󰀥口
呐	口冂人󰁶
娶	耳又女󰀘
酰	西一丿儿
饵	⺈󰁐耳󰀝
嗜	口土丿日
谜	讠米辶󰁶
秃	禾几󰀅
挚	扌九丶手
锢	钅囗古󰀝
逞	口王辶󰀌
攫	扌目目又
楷	木󰁴匕白
旭	九日󰀌
楣	木󰁅目󰀝
藻	艹氵口木
蘖	艹亻󰁃木
娱	女口一大
酝	西一二厶
虱	⺄丿虫󰀦
茵	艹囗大󰁧
豁	宀三丨口
跋	口止丶
坤	土日丨󰀢
绢	纟口月󰀝
乒	󰅍一丿󰁣
搓	扌䒑󰀠工
讶	讠󰀂亅丿
绷	纟月月󰀝
钮	钅󰁈丨二
陀	阝宀匕󰁀
戥	日丿主戈
窖	宀八丿口
渭	氵田月󰀝
瞻	目⺈厂言
竺	⺮二󰀘
柿	木亠冂丨
熹	士口䒑灬
谒	讠日勹󰄃
梆	木三丿阝
脯	月一月丶
崎	山大丁口
饺	⺈󰁐亠乂
唾	口丿十一
赳	土󰁾󰁐丨
轩	车干󰀢
埠	土亻󰁃十
呜	口勹ㄅ一
丫	丷丨󰀵
纫	纟刀丶󰁶
滤	氵󰅋七心
哉	土口󰅅丶
棘	一冂󰅇󰅇
晌	日丿冂口
臧	厂󰄃丆丶
缎	纟亻三又
雌	止󰁴亻󰁷
诃	讠丁口󰀝
虾	虫一卜󰁶
诧	讠宀丿七
靶	廿口十巴
峭	山⺌月󰀝
棠	⺌冖口木
戳	羽亻󰁷戈
阜	亻󰁃󰁃十
衅	丿皿丷󰀟
硕	石丆贝󰁶
杖	木󰂃󰁶
嵩	山亠口口
莎	艹氵小丿
奎	大土土󰀘
祯	礻󰁶󰀥贝
霖	󰀙木木󰁧
鸵	勹丶ㄅ匕
霄	󰀙⺌月󰀘
啸	口󰁬󰅏󰀯
氡	󰅎⺄夂󰁦
氦	󰅎⺄亠人
箩	⺮罒夕󰁧
琢	王一󰀓丶
唔	口五口󰀝
腈	月主月󰀝
袄	衤󰁧丿大
吭	口亠几󰁀
寝	宀丬彐又
紊	文ㄠ小󰁧
簿	⺮氵一寸
凰	几白王󰀌
阮	阝二儿󰁀
愣	忄罒方ノ
猾	犭ノ󰀾月
鞠	廿口十米
删	󰀼󰀼一刂
铧	钅亻ヒ十
屉	尸廿󰄃󰁫
磕	石土厶皿
褪	衤󰁧彐辶
咧	口一夕刂
鱿	󰁢󰀞丶
碾	石尸󰁺󰀖
渎	氵十乛大
殆	一夕厶口
淌	氵⺌冂口
漓	氵亠乂厶
恫	忄冂一口
搪	扌广󰁬口
啼	口亠丷丨
戎	戈󰀏
驼	󰀊󰀞宀匕
瑾	王廿口主
沧	氵人⺋󰁀
傀	亻白󰁜厶
磅	石亠丷方
诀	讠ユ人󰁶
琅	王丶彐󰀖
翘	弋丿一羽
湛	氵艹三󰄃
翩	丶尸冂羽
狐	犭ノ⺁󰂃
侠	亻一丷大
垢	土⺁一口
抨	扌一丷十
婿	女乛󰁾月
哺	口一月丶
逶	禾女辶󰀌
讳	讠二𠃌丨
筷	⺮忄ユ人
闵	门文󰀦
谤	讠亠丷方
侣	亻口口󰀝
券	䒑大刀󰁣
幢	冂丨立土
殃	一夕ㄇ大
苓	艹人丶󰁻
澈	氵亠厶夂
豌	一口䒑⺋
噶	口艹日󰄃
琦	王大丁口
洼	氵土土󰀝
洽	氵人一口
沁	氵心󰁶
乓	󰅍一丶󰁧
朔	䒑凵丿月
绚	纟勹日󰀝
婷	女亠口丁
羟	䒑󰀠ス工
彤	󰀼亠彡ノ
泮	氵丷󰀟󰀢
硼	石月月󰀝
吆	口ㄠ󰁶
怔	忄一止󰀝
儡	亻田田田
茸	艹耳󰀘
茧	艹虫󰁧
椰	木耳阝󰀢
莸	艹犭ノ丶
乖	丿十丬匕
窍	宀八工ㄅ
桦	木亻ヒ十
笃	⺮󰀊一󰀘
呕	口匚乂󰁶
眺	目儿󰀪󰁶
榆	木人一刂
裘	一氺丶󰀔
沂	氵斤󰀢
诛	讠󰅎󰅇󰁶
谆	讠亠口子
瘫	疒又亻󰁷
觅	爫ㄇ󰁜󰀅
舜	爫冖夕丨
踽	口止丿丶
皿	皿丨󰁈一
奄	大日乚󰀅
岖	山匚乂󰁶
鳌	主󰁡夂一
妓	女十又󰁶
蒴	艹䒑凵月
薇	艹彳山夂
炯	火冂口󰀝
尹	󰁬丿󰀏
樟	木立日十
渺	氵目小丿
袱	衤󰁧亻丶
竣	立厶八夂
邱	󰅍󰀞阝󰀢
胥	乛󰁾月󰀘
粟	覀米󰁧
镍	钅丿目木
嗽	口一口人
疫	疒几又󰀦
禺	日冂丨丶
憩	丿古丿心
鹅	丿扌󰅅一
啃	口止月󰀝
眶	目匚王󰀝
涝	氵艹冖力
钡	钅贝󰁶
掂	扌广󰀥口
澡	氵口口木
阎	门⺈臼󰀌
葵	艹癶一大
戬	一󰅊一戈
骇	󰀊󰀞亠人
潺	氵尸子子
泊	氵白󰀝
鲋	󰁢󰀞亻寸
绮	纟大丁口
侈	亻夕夕󰁶
亨	亠口了󰀬
徘	彳丨三三
叩	口卩󰀢
迤	𠂉也辶󰁫
槛	木〢𠂉皿
祈	礻󰁶斤󰀢
蘸	艹西一灬
猩	犭ノ日主
飚	几乂火火
湃	氵三十
湍	氵山丆〢
廿	廿一丨一
脖	月十冖子
婉	女宀夕⺋
靴	廿口十ヒ
叽	口几󰁀
颓	禾几丆贝
臻	一厶土禾
嗨	口氵𠂉母
戌	厂一󰅅丶
芋	艹一󰀛󰀬
恣	冫⺈人心
彬	木木彡ノ
椿	木三人日
绰	纟󰀥日十
晾	日亠口小
谥	讠䒑八皿
羲	丷王禾丶
逛	犭ノ王辶
妮	女尸匕󰁀
嘶	口艹三斤
硒	石西󰀝
驿	󰀊󰀞又󰀟
垛	土几木󰁶
惭	忄车斤󰀢
捂	扌五口󰀝
詹	⺈厂八言
褥	衤󰁧厂寸
壑	󰀥冖一土
蟹	⺈月丨虫
馒	⺈󰁐日又
蕾	艹󰀙田󰀘
蔓	艹日罒又
荪	艹孑小󰁧
腮	月田心󰁶
趾	口止止󰀝
滦	氵亠󰁗木
嗬	口艹亻口
痹	疒田一󰀯
碉	石󰀼土口
芹	艹斤󰀬
恃	忄土寸󰁶
秽	禾山夕󰁶
樊	木乂乂大
殴	匚乂几又
訾	止匕言󰀘
札	木乚󰁀
诅	讠󰀐一󰀝
孚	爫子󰀘
蝴	虫古月󰀝
匿	匚艹口
杲	日木󰁧
枷	木力口󰀝
厥	厂䒑凵人
噔	口癶一䒑
恍	忄⺌一儿
廖	广羽人彡
啤	口白丿十
羿	羽廾󰀬
汾	氵八刀ノ
撼	扌厂一心
帷	冂丨亻󰁷
佼	亻亠八乂
厕	厂贝刂󰀵
巫	工人人󰀦
碟	石廿󰄃木
胧	月ヒ丶
曙	日罒土日
辘	车广󰁃匕
斟	艹三八十
揣	扌山丆〢
踱	口止广又
诽	讠丨三三
烽	火夂三丨
娟	女口月󰀝
拈	扌󰀥口󰀝
冉	冂土󰀌
祀	礻󰁶巳󰁀
祠	礻󰁶𠃌口
狈	犭ノ贝󰁶
蹦	口止山月
濒	氵止󰀤贝
砧	石󰀥口󰀝
峙	山土寸󰁶
谏	讠一󰀹󰅇
恕	女口心󰁧
苑	艹夕⺋󰀅
笈	⺮乃󰂃󰁧
凋	冫󰀼土口
圜	囗罒一󰀔
筝	⺮⺈󰁬亅
夭	丿大󰀦
辄	车耳乚󰁀
饯	⺈󰁐二丶
揩	扌󰁴匕白
篱	⺮亠乂厶
嫉	女疒𠂉大
壕	土亠口󰀓
瑚	王古月󰀝
攘	扌亠口󰀔
芡	艹⺈人󰁧
尴	乚〢皿
熠	火羽白󰀝
淳	氵亠口子
痢	疒禾刂󰀵
咚	口夂󰁦󰁶
泗	氵四󰀝
榕	木宀八口
撬	扌丿二乚
檀	木亠囗一
苇	艹二𠃌丨
冥	冖日亠八
嬉	女士口口
靡	广木木三
擒	扌人亠厶
苞	艹勹巳󰀅
蚂	虫󰀊一󰀝
甄	覀土一丶
窟	宀八尸山
蛛	虫󰅎󰅇󰁶
娣	女丷弓丿
瘩	疒艹人口
驮	󰀊󰀞大󰁶
琉	王亠厶󰀸
暇	日󰁃丨又
橱	木厂一寸
菩	艹立口󰀘
嘈	口一ㄇ日
禅	礻󰁶丷󰅐
恝	三丨刀心
鲤	󰁢󰀞日土
呻	口日丨󰀢
龚	ヒ丶八
兢	古儿古儿
幌	冂丨日儿
牟	厶丿󰀟󰀬
匣	匚甲󰀵
酏	西一也󰁀
卉	十廾󰀬
萱	艹宀一一
凛	冫亠囗小
忱	忄冖󰁜󰁀
拷	扌土丿ㄅ
拯	扌了󰀩一
哔	口󰁴匕十
悍	忄日干󰀢
毋	󰅂󰀌
砉	三丨石󰀘
锉	钅人人土
幂	冖日大丨
虞	󰅋七口大
崽	山田心󰁧
砾	石丿󰄃小
垣	土一日一
娴	女门木󰁶
瑛	王艹ㄇ大
捶	扌丿十一
肾	〢又月󰀘
殡	一夕宀八
羁	罒廿口一
蛤	虫人一口
獗	犭ノ厂人
汲	氵乃󰂃󰁶
垠	土彐󰀖󰁶
迸	䒑廾辶󰀵
绊	纟丷󰀟󰀢
钵	钅木一󰀝
飙	大丶大乂
搂	扌米女󰀝
冕	曰⺈口󰁜
蠕	虫󰀙丆〢
肘	月寸󰁶
拙	扌凵山󰀢
捎	扌⺌月󰀝
饲	⺈󰁐𠃌口
钨	钅勹ㄅ一
绽	纟宀一󰁾
觐	廿口主󰁜
赂	贝夂口󰀝
蚁	虫丶乂󰁶
肱	月厶󰁶
嗡	口八厶羽
栈	木二󰅅丶
忡	忄口丨󰀢
裔	亠󰀔冂口
迥	冂口辶󰀌
朦	月艹冖󰀓
浚	氵厶八夂
肇	丶尸夂󰀟
萋	艹一󰁬女
尬	乚人󰀯
髯	󰀍厶彡土
弘	弓厶󰁶
戮	羽人彡戈
汕	氵山󰀢
倔	亻尸凵山
拭	扌󰀁工丶
鹃	口月勹一
婪	木木女󰀘
墟	土󰅋七一
嗦	口十冖小
嘀	口亠丷古
骥	󰀊󰀞丬八
吩	口八刀ノ
簸	⺮艹三又
藉	艹三󰅇日
潼	氵立日土
膳	月䒑󰀟口
谚	讠立丿彡
肋	月力ノ
阙	门䒑凵人
汶	氵文󰁶
踞	口止尸古
圾	土乃󰂃󰁶
讥	讠几󰁀
菠	艹氵󰅌又
疮	疒人⺋󰁫
箕	⺮艹三八
屎	尸米󰀦
璧	尸口立丶
霎	󰀙立女󰀘
晦	日𠂉母󰁶
颐	匚丨口贝
慑	忄耳又又
肽	月大丶󰁶
翊	立羽󰀝
堰	土匚日女
蛙	虫土土󰀝
蚜	虫󰀂亅丿
娜	女𠃌󰀠阝
炔	火ユ人󰁶
垃	土立󰀝
钼	钅目󰀝
刁	𠃌󰀞󰀌
鸽	人一口一
梧	木五口󰀝
殉	一夕勹日
憋	丷冂󰅏心
婢	女白丿十
妒	女丶尸ノ
窘	宀八󰁬口
泾	氵ス工󰀝
漪	氵犭ノ口
筵	⺮丿止廴
搀	扌⺈口󰁦
矾	石几丶󰁶
柑	木艹二󰀝
撩	扌大丷小
劾	亠ㄥ丿力
嫣	女一止灬
咪	口米󰁶
焘	三丿寸灬
雉	𠂉大亻󰁷
遏	日勹人辶
蔷	艹十䒑口
胭	月囗大󰁶
炬	火匚󰁃󰀝
粕	米白󰀝
弋	弋一󰁒丶
璇	王方𠂉󰁾
颅	󰀥尸丆贝
觜	止匕⺈丨
磋	石䒑󰀠工
馅	⺈󰁐⺈臼
踌	口止三寸
澎	氵士口彡
蛹	虫󰁻月丨
伫	亻宀一󰀝
奚	爫ㄠ大󰁧
岑	山人丶乛
缭	纟大丷小
谟	讠艹日大
髡	󰀍厶彡儿
伯	亻白󰀝
瞄	目艹田󰀝
钛	钅大丶󰁶
陇	阝ヒ丶
轲	车丁口󰀝
羧	䒑󰀠厶夂
疤	疒巴󰁫
苔	艹厶口󰀘
嘟	口土丿阝
铰	钅亠八乂
卣	󰀥冂󰁃一
惺	忄日丿主
讷	讠冂人󰁶
辗	车尸󰁺󰀖
茉	艹一木󰁧
徭	彳爫󰅎山
妾	立女󰀘
隧	阝䒑󰀓辶
弈	亠󰁖廾󰀬
惋	忄宀夕⺋
荃	艹人王󰀘
褶	衤󰁧羽白
蜿	虫宀夕⺋
痪	疒⺈ㄇ大
哮	口土丿子
呃	口厂⺋󰁀
怡	忄厶口󰀝
遁	⺁十目辶
悸	忄禾子󰀝
俟	亻厶𠂉大
锂	钅日土󰀝
蚵	虫丁口󰀝
祷	礻󰁶三寸
芭	艹巴󰀅
犀	尸氺丿󰀟
恤	忄丿皿󰀝
沣	氵三丨󰀢
窦	宀八十大
篝	⺮󰀀冂土
埂	土一日乂
巅	山十󰀣贝
蔼	艹讠日󰄃
轵	车口八󰁶
钴	钅古󰀝
帚	彐冖冂丨
蕃	艹丿米田
斛	⺈月丨十
耘	三󰅇二厶
嬷	女广木厶
甥	丿主田力
荸	艹十冖子
酋	丷西一󰀘
叨	口刀ノ
猿	犭ノ土󰀔
馨	士󰁅几日
铐	钅土丿ㄅ
瑶	王爫󰅎山
祆	礻󰁶一大
锑	钅丷弓丿
蜗	虫口冂人
刭	ス工刂󰀢
葆	艹亻口木
弼	弓丆日弓
缤	纟宀󰅍八
瘠	疒󰀪人月
曳	日󰅅󰀏
屹	山𠂉乙󰁀
戍	厂丶󰅅丶
茁	艹凵山󰀬
毓	𠂉母亠󰀸
楦	木宀一一
锲	钅三丨大
谍	讠廿󰄃木
燎	火大丷小
捅	扌󰁻月丨
苷	艹艹二󰀘
茴	艹囗口󰀘
蛟	虫亠八乂
臆	月立日心
匕	匕丿乚
徊	彳囗口󰀝
毗	田󰁴匕󰁀
淇	氵艹三八
檄	木白方夂
懋	木󰁻乛心
荀	艹勹日󰀘
噜	口󰁢一日
梓	木立十󰀢
贽	扌九丶贝
蠡	󰅂一󰀓虫
漱	氵一口人
迦	力口辶󰀌
懊	忄丿ㄇ大
愕	忄口口ㄅ
帛	白冂丨󰀬
咙	口ヒ丶
渝	氵人一刂
卅	一川󰀵
啪	口扌白󰀝
炙	󰁝火󰁧
睾	丿罒土十
诋	讠󰁚󰀁丶
桢	木󰀥贝󰁶
贻	贝厶口󰀝
褙	衤󰁧丬月
鲂	󰁢󰀞方ノ
碲	石亠丷丨
菇	艹女古󰀘
俏	亻⺌月󰀝
闰	门王󰀌
萃	艹亠人十
嗳	口爫冖又
嫡	女亠丷古
劓	丿目田刂
俾	亻白丿十
菡	艹了󰀪凵
惴	忄山丆〢
遽	󰅋七一辶
锚	钅艹田󰀝
伽	亻力口󰀝
坳	土ㄠ力ノ
渲	氵宀一一
铛	钅⺌彐󰀝
囤	囗一凵乚
涸	氵囗古󰀝
潇	氵艹󰁬󰀯
晖	日冖车󰀢
吠	口大丶󰁶
莹	艹冖王丶
灏	氵日亠贝
捡	扌人一一
磊	石石石󰀘
糜	广木木米
掇	扌又又又
擎	艹勹口手
戟	十日十戈
黯	󰀹土灬日
哆	口夕夕󰁶
醚	西一米辶
箍	⺮扌匚丨
嗒	口艹人口
悒	忄口巴󰁀
锹	钅禾火󰁶
袒	衤󰁧日一
踊	口止󰁻丨
啧	口主贝󰁶
砝	石土厶󰁶
呛	口人⺋󰁀
躇	口止艹日
吮	口厶儿󰁀
眩	目亠ㄠ󰁶
檬	木艹冖󰀓
铣	钅丿土儿
茗	艹夕口󰀘
腑	月广亻寸
绫	纟土八夂
褒	亠亻口󰀔
畿	ㄠㄠ戈田
倪	亻臼儿󰁀
铮	钅⺈󰁬亅
矽	石夕󰁶
踉	口止丶󰀖
筏	⺮亻戈󰁧
剃	丷弓丨刂
坂	土⺁又󰁶
蜇	扌斤虫󰁧
髦	󰀍厶彡乚
绎	纟又󰀟󰀢
隅	阝日冂丶
攒	扌丿土贝
甭	丆卜月丨
孽	艹亻󰁃子
蜒	虫丿止廴
狩	犭ノ宀寸
虔	󰅋七文󰀦
嘹	口大丷小
辎	车巛田󰀝
卯	󰁚丿卩󰀢
祚	礻󰁶𠂉二
翟	羽亻󰁷󰀘
瞥	丷冂󰅏目
芸	艹二厶󰁧
沐	氵木󰁶
黍	禾人氺󰁧
赘	主󰁡夂贝
匝	匚冂丨󰀵
皑	白山己󰁀
瘪	疒丿目匕
憨	乛耳夂心
咆	口勹巳󰁀
驭	󰀊󰀞又󰁶
蒿	艹亠口口
蝈	虫囗王丶
刽	人二厶刂
骸	󰀾月亠人
唠	口艹冖力
黩	󰀹土灬大
舀	爫臼󰀘
黝	󰀹土灬力
瘟	疒日皿󰀌
瑙	王巛丿乂
咔	口󰀥一卜
鬓	󰀍厶彡八
斡	十日十十
诣	讠匕日󰀝
怠	厶口心󰁧
撵	扌二人车
濂	氵广䒑󰁗
妞	女󰁈丨二
眈	目冖󰁜󰁀
匡	匚王󰀌
啮	口止人凵
泞	氵宀丁󰀢
肄	匕𠂉大󰀟
钜	钅匚󰁃󰀝
锏	钅门日󰀝
仕	亻士󰀝
荼	艹人一木
桧	木人二厶
矗	十󰀣十󰀣
唬	口󰅋七几
伶	亻人丶󰁻
萤	艹冖虫󰁧
仝	人工󰀘
懦	忄󰀙丆〢
怅	忄丿七󰂃
盔	火皿󰀘
芙	艹二人󰁧
舐	丿古󰁚弋
蹂	口止󰁻木
惦	忄广󰀥口
匾	匚丶尸艹
霹	󰀙尸口十
腋	月亠亻丶
阡	阝丿十󰀢
瓢	覀二小󰂃
羹	丷王灬大
掐	扌⺈臼󰀝
佯	亻䒑󰀟󰀢
盅	口丨皿󰀘
恸	忄二厶力
骼	󰀾月夂口
盎	ㄇ大皿󰀘
壬	丿士󰀌
侉	亻大二ㄅ
噗	口󰅊一人
猥	犭ノ田󰀖
芥	艹人󰀯󰀬
帧	冂丨󰀥贝
赍	十人人贝
溺	氵弓冫冫
砰	石一丷十
诙	讠火󰁶
逍	⺌月辶󰀌
笠	⺮立󰀘
酉	西一󰀌
沅	氵二儿󰁀
榄	木〢𠂉󰁜
瓯	匚乂一丶
髫	󰀍厶彡口
阑	门一󰀹󰅇
橄	木乛耳夂
焓	火人丶口
蘑	艹广木石
柠	木宀丁󰀢
炻	火石󰀝
铂	钅白󰀝
淞	氵木八厶
瀚	氵十日羽
氩	󰅎⺄一一
觥	⺈月丨儿
脓	月冖󰀔󰁶
缮	纟䒑󰀟口
舔	丿古一⺗
阉	门大日乚
拽	扌日󰅅ノ
憧	忄立日土
钲	钅一止󰀝
肮	月亠几󰁀
恬	忄丿古󰀝
蟆	虫艹日大
疵	疒止匕󰁫
篓	⺮米女󰀘
漾	氵丷王󰀩
纂	⺮目大小
箐	⺮主月󰀘
跺	口止几木
裴	丨三丨󰀔
挞	扌大辶󰁶
憬	忄日亠小
亢	亠几󰀅
懿	士冖一心
侥	亻弋丿儿
噬	口⺮工人
峒	山冂一口
饪	⺈󰁐丿士
荚	艹一丷大
藕	艹三󰅇丶
韭	丨三丨一
镣	钅大丷小
恿	󰁻月丨心
兀	一儿󰁫
噫	口立日心
恺	忄山己󰁀
寰	宀罒一󰀔
幺	ㄠㄠㄠㄠ
霆	󰀙丿士廴
碴	石木日一
藐	艹豸白儿
酣	西一艹二
榷	木冖亻󰁷
弁	厶廾󰀬
翡	丨三丨羽
桅	木⺈厂⺋
掷	扌䒑大阝
诒	讠厶口󰀝
璞	王󰅊一人
瘀	疒方人󰁦
擂	扌󰀙田󰀝
窿	宀八阝主
鳃	󰁢󰀞田心
掖	扌亠亻丶
觊	山󰁁ㄇ󰁜
箔	⺮氵白󰀘
睫	目一󰁬󰁾
冗	冖几󰀅
崛	山尸凵山
熨	尸二小火
睬	目爫木󰁶
镐	钅亠口口
堑	车斤土󰀘
亘	一日一󰀘
卦	土土卜󰁶
踯	口止䒑阝
佬	亻土丿匕
撂	扌田夂口
嗵	口󰁻月辶
贳	廿󰄃贝󰁧
煊	火宀一一
铎	钅又󰀟󰀢
痞	疒丆卜口
酗	西一乂凵
稷	禾田八夂
甬	󰁻月丨󰀬
捺	扌大二小
咄	口凵山󰀢
漩	氵方𠂉󰁾
晏	日宀女󰀘
氚	󰅎⺄川󰀬
瘤	疒󰁚丶田
砚	石ㄇ󰁜󰁀
赭	土󰁖土日
鹊	󰁺日勹一
阪	阝⺁又󰁶
绛	纟夂󰀂丨
诲	讠𠂉母󰁶
匍	勹一月丶
喽	口米女󰀝
砩	石弓󰀯󰀢
簦	⺮癶一䒑
臃	月亠󰁲󰁷
佘	人二小󰁧
诨	讠冖车󰀢
粽	米宀二小
蓟	艹󰁢󰀞刂
郦	一冂丶阝
漉	氵广󰁃匕
橘	木󰁻乛口
粼	米夕󰀂巜
惫	夂田心󰁧
淄	氵巛田󰀝
瑜	王人一刂
咎	夂卜口󰀘
搔	扌又丶虫
弛	弓也󰁀
涣	氵⺈ㄇ大
痰	疒火火󰀦
浏	氵文刂󰀢
溥	氵一月寸
鸨	匕十勹一
酐	西一干󰀢
郛	爫孑阝󰀢
塾	亠口孑土
踵	口止丿土
狞	犭ノ宀丁
陂	阝󰅌又󰁶
蓿	艹宀亻日
麝	广󰁃〢寸
瞩	目尸丿丶
邳	丆卜󰀞阝
淅	氵木斤󰀢
驸	󰀊󰀞亻寸
晟	日厂𠃌丶
聆	耳人丶󰁻
悯	忄门文󰁶
偾	亻十艹贝
拮	扌士口󰀝
癣	疒󰁢󰀞󰀟
暹	日亻󰁷辶
胫	月ス工󰀝
榔	木丶彐阝
酪	西一夂口
俐	亻禾刂󰀢
纭	纟二厶󰁶
轭	车厂⺋󰁀
耄	土丿匕乚
漕	氵一ㄇ日
锷	钅口口ㄅ
鳔	󰁢󰀞覀小
笆	⺮巴󰀅
狸	犭ノ日土
墅	日土󰁻土
巳	巳󰁈一乚
唁	口言󰀝
蓦	艹日大一
蒺	艹疒𠂉大
蔸	艹白󰁚儿
饬	⺈󰁐𠂉力
暨	彐厶󰀂一
瘁	疒亠人十
灸	ク󰂃火󰁧
缨	纟贝贝女
剡	火火刂󰀢
杈	木又丶󰁶
椎	木亻󰁷󰀝
刍	⺈彐󰀘
嵊	山禾丬匕
衢	彳目目丁
镯	钅罒勹虫
坞	土勹ㄅ一
缢	纟䒑八皿
氘	󰅎⺄󰀯󰀬
炖	火一凵乚
坷	土丁口󰀝
姥	女土丿匕
摹	艹日大手
霓	󰀙臼儿󰀅
抡	扌人匕󰁀
旖	方𠂉大口
砺	石厂一󰁡
翎	人丶󰁻羽
麂	广󰁃〢几
轹	车丿󰄃小
蹑	口止耳又
萦	艹冖ㄠ小
馍	⺈󰁐艹大
缰	纟一田一
鸠	九勹丶一
蟒	虫艹大廾
糯	米󰀙丆〢
趴	口止八󰁶
峪	山八人口
猬	犭ノ田月
娄	米女󰀘
芊	艹丿十󰀬
杞	木己󰁀
燧	火䒑󰀓辶
霏	󰀙丨三三
蚌	虫三丨󰀢
讹	讠亻ヒ󰁀
怂	人人心󰁧
夔	䒑丿目夂
奂	⺈ㄇ大󰁧
徨	彳白王󰀝
阏	门方人󰁦
彗	三丨三彐
耆	土丿匕日
曦	日丷王丶
迢	刀口辶󰀌
俨	亻一󰅊厂
惘	忄冂䒑󰄃
姗	女󰀼󰀼一
峨	山丿扌丶
皋	白大十󰀬
鬃	󰀍厶彡小
谛	讠亠丷丨
燮	言火火又
寐	宀󰄃丨󰅇
涫	氵宀丨󰁃
栉	木艹ㄗ󰀢
靼	廿口十一
叼	口𠃌󰀞󰀝
篙	⺮亠口口
蝗	虫白王󰀝
掳	扌󰅋七力
菁	艹主月󰀘
榻	木日羽󰀝
滕	月䒑大氺
皎	白亠八乂
蚓	虫弓丨󰀢
蝉	虫丷󰅐󰀢
挎	扌大二ㄅ
脐	月文󰀯󰀢
偕	亻󰁴匕白
兮	八一ㄅ󰀅
杷	木巴󰁀
袅	勹丶ㄅ󰀔
黜	󰀹土灬山
黥	󰀹土灬小
瘾	疒阝⺈心
蓑	艹亠口󰀔
厮	厂艹三斤
苄	艹亠卜󰁧
拗	扌ㄠ力ノ
挢	扌丿大󰀯
哽	口一日乂
嘁	口厂󰀥丶
狍	犭ノ勹巳
饽	⺈󰁐十子
昶	丶𠃌󰀩日
镓	钅宀一󰀓
沽	氵古󰀝
驹	󰀊󰀞勹口
潍	氵纟亻󰁷
捋	扌爫寸󰁶
哧	口土󰁖󰁶
淙	氵宀二小
枇	木󰁴匕󰁀
懑	氵艹一心
靳	廿口十斤
囡	囗女󰀌
蜚	丨三丨虫
瞟	目覀二小
噎	口士冖䒑
烨	火亻ヒ十
覃	覀日十󰀬
蚣	虫八厶󰁶
鲢	󰁢󰀞车辶
羌	䒑二󰁜󰀅
茹	艹女口󰀘
赡	贝⺈厂言
锨	钅斤⺈人
讪	讠山󰀢
枸	木勹口󰀝
貉	豸夂口󰀝
辙	车亠厶夂
咝	口󰁲󰁲一
坍	土󰀼亠󰀝
扈	丶尸口巴
焙	火立口󰀝
蛾	虫丿扌丶
鲸	󰁢󰀞亠小
倌	亻宀丨󰁃
秫	禾木丶󰁶
癞	疒一口贝
钒	钅几丶󰁶
馁	⺈󰁐爫女
瓮	八厶一丶
擀	扌十日干
瞌	目土厶皿
笞	⺮厶口󰀘
舵	丿󰁪宀匕
咦	口一弓人
夯	大力󰁣
儆	亻艹勹夂
屐	尸彳十又
犊	牜十乛大
琶	王王巴󰀅
栀	木⺁一⺋
箫	⺮󰁬󰅏󰀯
觞	⺈月丨󰁤
骋	󰀊󰀞由ㄅ
擞	扌米女夂
炫	火亠ㄠ󰁶
惮	忄丷󰅐󰀢
涟	氵车辶󰁶
峦	亠󰁗山󰀬
磐	丿󰁪几石
腆	月ㄇ󰁺八
俸	亻三人󰀟
溧	氵覀木󰁶
鸥	匚乂勹一
攸	亻丨夂󰁶
悚	忄一口󰅇
韬	二𠃌丨臼
於	方人󰁦󰁶
衽	衤󰁧丿士
褚	衤󰁧土日
鲫	󰁢󰀞彐卩
琵	王王󰁴匕
砷	石日丨󰀢
亵	亠扌九󰀔
怦	忄一丷十
湄	氵󰁅目󰀝
铆	钅󰁚丿卩
镊	钅耳又又
莺	艹冖勹一
揍	扌三人大
膺	广亻亻月
邃	宀八䒑辶
筠	⺮土勹冫
雳	󰀙厂力󰁣
郴	木木阝󰀢
嬴	亠󰄃口丶
颀	斤丆贝󰁶
遐	󰁃丨二辶
鲥	󰁢󰀞日寸
鼾	丿目田干
氖	󰅎⺄乃󰁣
揖	扌口耳󰀝
鄱	丿米田阝
蘩	艹𠂉母小
缪	纟羽人彡
蜷	虫䒑大⺋
靛	主月宀󰁾
蝙	虫丶尸艹
豺	豸󰀛丿ノ
桓	木一日一
惚	忄勹󰁤心
悻	忄土䒑十
娼	女日日󰀝
滁	氵阝人木
涎	氵丿止廴
咛	口宀丁󰀢
唢	口⺌贝󰁶
媛	女爫一又
馥	禾日𠂉夂
厩	厂彐厶󰁜
佚	亻󰅎人󰁶
圪	土𠂉乙󰁀
翦	䒑月刂羽
倩	亻主月󰀝
冽	冫一夕刂
嗤	口凵丨虫
敕	一口󰅇夂
牍	丿丨一大
嵇	禾乚山
阂	门亠ㄥ人
镭	钅󰀙田󰀝
荥	艹冖水󰁧
咫	尸󰂃口八
纨	纟九丶󰁶
掰	八刀手
沱	氵宀匕󰁀
榈	木门口口
槟	木宀󰅍八
抿	扌󰁃󰁐弋
锗	钅土丿日
侃	亻口󰀸󰁀
呗	口贝󰁶
蜈	虫口一大
疚	疒ク󰂃󰀦
抠	扌匚乂󰁶
芍	艹勹丶󰁧
蜘	虫𠂉大口
赝	厂亻亻贝
祗	礻󰁶󰁚丶
禧	礻󰁶士口
皓	白丿土口
醴	西一ㄇ䒑
鞅	廿口十大
黛	亻󰀁丶灬
桀	夕󰀂丨木
钎	钅丿十󰀢
涞	氵一米󰁶
娑	氵小丿女
膘	月覀二小
蛊	虫皿󰀘
摒	扌尸䒑廾
忸	忄󰁈丨二
纣	纟寸󰁶
篾	⺮罒厂丶
馋	⺈󰁐⺈󰁦
痊	疒人王󰀌
嗟	口䒑󰀠工
涓	氵口月󰀝
挹	扌口巴󰁀
枭	勹丶ㄅ木
箅	⺮田一󰀯
吝	文口󰀘
蝎	虫日勹󰄃
郾	匚日女阝
泠	氵人丶󰁻
孥	女又子󰀘
焱	火火火󰁧
铨	钅人王󰀝
霰	󰀙󰁺月夂
鼹	臼󰁐󰁦女
圃	囗一月丶
酞	西一大丶
毡	丿二乚口
莳	艹日寸󰁧
璨	王󰀥夕米
煨	火田一󰀖
谗	讠⺈口󰁦
秸	禾士口󰀝
媲	女丿囗匕
爰	爫一又
貂	豸刀口󰀝
掬	扌勹米󰁶
婵	女丷󰅐󰀢
轳	车󰀥尸ノ
佗	亻宀匕󰁀
唛	口主夂󰁶
瀛	氵亠󰄃丶
玮	王二𠃌丨
桎	木一厶土
敝	丷冂󰅏夂
庾	广臼人󰀦
琛	王冖八木
璀	王山亻󰁷
樵	木亻󰁷灬
剁	几木刂󰀢
烬	火尸󰂃󰁦
噩	王口口口
诿	讠禾女󰀝
邝	广阝󰀢
忖	忄寸󰁶
闩	门一󰀌
杵	木𠂉十󰀢
犟	弓口虫󰀟
硌	石夂口󰀝
瞑	目冖日八
镨	钅䒑󰅊日
躏	口止艹󰁷
渚	氵土丿日
礴	石艹氵寸
嘤	口贝贝女
沌	氵一凵乚
臊	月口口木
钇	钅乙󰁀
铿	钅〢又土
豢	䒑大一󰀓
攥	扌⺮目小
喟	口田月󰀝
珂	王丁口󰀝
铢	钅󰅎󰅇󰁶
蚯	虫󰅍一󰀝
麸	主夕二人
郸	丷󰅐阝󰀢
绯	纟丨三三
氪	󰅎⺄古儿
蚝	虫丿二乚
芗	艹󰁲丿󰁣
蕙	艹一日心
赀	止匕贝󰁧
讴	讠匚乂󰁶
澧	氵ㄇ󰁺䒑
沓	水日󰀘
眸	目厶丿󰀟
镖	钅覀二小
癖	疒尸口十
傣	亻三人氺
潦	氵大丷小
茭	艹亠八乂
咂	口匚冂丨
赈	贝厂二󰀖
孺	孑󰀙丆〢
仞	亻刀丶󰁶
诰	讠丿土口
芷	艹止󰀘
蔺	艹门亻󰁷
绌	纟凵山󰀢
祉	礻󰁶止󰀝
沮	氵󰀐一󰀝
瓤	亠口口󰂃
徇	彳勹日󰀝
绉	纟⺈彐󰀝
蛀	虫丶王󰀝
喑	口立日󰀝
岱	亻󰀁丶山
怃	忄二󰁜󰁀
疟	疒匚一󰀌
圩	土一󰀛󰀢
嗔	口十󰀣八
愫	忄主ㄠ小
浠	氵乂丨
昵	日尸匕󰁀
膂	方𠂉󰀕月
扉	丶尸丨三
繇	爫󰅎山小
蓖	艹丿囗匕
翌	羽立󰀘
芫	艹二儿󰀅
藜	艹禾勹氺
嗷	口主󰁡夂
晁	日儿󰀪󰁧
柞	木𠂉丨二
邸	󰁚󰀁丶阝
勰	力力力心
猞	犭ノ人口
泸	氵󰀥尸ノ
蹩	丷冂󰅇󰁾
殚	一夕丷󰅐
漳	氵立日十
亳	亠口冖七
溘	氵土厶皿
裾	衤󰁧尸古
衮	亠八厶󰀔
媾	女󰀀冂土
脲	月尸水󰁶
畋	田夂󰁶
蹙	厂󰀥一󰁾
搐	扌亠ㄠ田
冼	冫丿土儿
煅	火亻三又
涡	氵口冂人
湫	氵禾火󰁶
铯	钅⺈巴󰁀
淖	氵󰀥日十
掾	扌󰅂一󰀓
闾	门口口󰀌
胄	由月󰀘
蹶	口止厂人
羔	丷王灬󰁧
郏	一丷大阝
嵬	山白󰁜厶
猝	犭ノ亠十
榭	木丿󰀽寸
疸	疒日一󰀌
瘢	疒丿󰁪又
粜	凵山米󰁧
掸	扌丷󰅐󰀢
拎	扌人丶󰁻
丐	一󰀥ㄅ󰁫
唷	口亠厶月
怆	忄人⺋󰁀
骧	󰀊󰀞亠󰀔
缫	纟巛日木
槌	木亻󰁃辶
瞰	目乛耳夂
胯	月大二ㄅ
瘴	疒立日十
狰	犭ノ⺈亅
讵	讠匚󰁃󰀝
茯	艹亻大丶
萼	艹口口ㄅ
韫	二𠃌丨皿
枋	木方ノ
铄	钅丿󰄃小
镬	钅艹亻又
霭	󰀙讠日󰄃
鑫	金釒金󰀘
涪	氵立口󰀝
缥	纟覀二小
戢	口耳󰅅丶
脍	月人二厶
聿	󰁬󰀟󰀵
颔	人丶乛贝
蹬	口止癶䒑
谩	讠日罒又
坨	土宀匕󰁀
喋	口廿󰄃木
嚆	口艹亠口
囔	口一口󰀔
岬	山甲󰀢
悝	忄日土󰀝
浍	氵人二厶
眚	丿主目󰀘
矜	󰁻乛亅乛
洱	氵耳󰀝
呸	口丆卜一
蛆	虫󰀐一󰀝
鸳	夕⺋勹一
郇	勹日阝󰀢
拊	扌亻寸󰁶
啾	口禾火󰁶
噙	口人亠厶
崆	山宀八工
瑕	王󰁃丨又
锵	钅丬夕寸
烩	火人二厶
揶	扌耳阝󰀢
潢	氵󰁺由八
轼	车󰀁工丶
铠	钅山己󰁀
鬣	󰀍厶彡󰁒
掣	󰅎冂丨手
嚎	口亠口󰀓
撅	扌厂䒑人
沤	氵匚乂󰁶
滓	氵宀立十
偎	亻田一󰀖
阖	门土厶皿
缈	纟目小丿
篦	⺮丿囗匕
缄	纟厂一丶
臼	臼丿丨一
蔫	艹一止灬
揄	扌人一刂
悴	忄亠人十
榛	木三人禾
轶	车󰅎人󰁶
砥	石󰁚󰀁丶
邯	艹二阝󰀢
陲	阝丿十一
狒	犭ノ弓󰀯
汨	氵日󰀝
辍	车又又又
抉	扌ユ人󰁶
瞳	目立日土
俳	亻丨三三
凫	勹丶ㄅ几
吡	口󰁴匕󰁀
狎	犭ノ甲󰀢
涮	氵尸冂刂
缜	纟十󰀣八
恚	土土心󰁧
碣	石日勹󰄃
稞	禾日木󰁶
沏	氵七刀ノ
蚤	又丶虫󰁧
裱	衤󰁧主󰀔
鹘	󰀾月勹一
疡	疒ㄋ󰁤󰀏
辕	车土口󰀔
耷	大耳󰀘
湮	氵覀土󰀝
遒	丷西一辶
瓒	王丿土贝
斐	丨三丨文
砜	石几乂󰁶
鸾	亠󰁗勹一
褛	衤󰁧米女
荤	艹冖车󰀬
罔	冂䒑亠󰄃
偃	亻匚日女
诂	讠古󰀝
赓	广󰁬人贝
惆	忄󰀼土口
曷	日勹人󰄃
煦	日勹口灬
跷	口止弋儿
癸	癶一大󰁧
粳	米一日乂
汐	氵夕󰁶
盂	一󰀛皿󰀘
剞	大丁口刂
倜	亻󰀼土口
莞	艹宀二儿
泓	氵弓厶󰁶
缑	纟亻ユ大
犄	牜大丁口
陨	阝口贝󰁶
阱	阝二󰀯󰀢
悖	忄十冖子
炜	火二𠃌丨
焯	火󰀥日十
畈	田⺁又󰁶
螃	虫亠丷方
簪	⺮󰀂󰁜日
匮	匚口丨贝
俅	亻一氺丶
僬	亻亻󰁷灬
扪	扌门󰁀
喔	口尸一土
饨	⺈󰁐一乚
滟	氵三丨巴
溏	氵广󰁬口
妩	女二󰁜󰁀
珩	王彳一丁
楫	木口耳󰀝
鹄	丿土口一
褴	衤󰁧〢皿
耠	三󰅇人口
筲	⺮⺌月󰀘
鲦	󰁢󰀞夂木
赁	亻丿士贝
刈	乂刂󰀢
倏	亻丨夂丶
谪	讠亠丷古
薅	艹女厂寸
饴	⺈󰁐厶口
馄	⺈󰁐日匕
迳	ス工辶󰀌
珑	王ヒ丶
铡	钅贝刂󰀢
俣	亻口一大
岷	山󰁃󰁐弋
憔	忄亻󰁷灬
窠	宀八日木
綦	艹三八小
鳖	丷冂󰅏一
囱	丿囗夕󰀦
胰	月一弓人
圻	土斤󰀢
垧	土丿冂口
玷	王󰀥口󰀝
簌	⺮一口人
鲞	䒑大󰁢一
砒	石󰁴匕󰁀
俚	亻日土󰀝
圳	土川󰀢
骞	宀󰀀八一
祛	礻󰁶土厶
矸	石干󰀢
鹞	爫󰅎山一
癫	疒十󰀣贝
醪	西一羽彡
蹉	口止䒑工
蹋	口止日羽
邺	󰅊一阝󰀢
猗	犭ノ大口
绶	纟爫冖又
玺	⺈小王丶
挈	三丨刀手
铙	钅弋丿儿
酊	西一丁󰀢
畦	田土土󰀝
冢	冖一󰀓丶
鄣	立日十阝
忏	忄丿十󰀢
屙	尸阝丁口
婧	女主月󰀝
嫦	女⺌冖丨
顼	王丆贝󰁶
猷	丷西一丶
痨	疒艹冖力
痘	疒一口䒑
羚	䒑󰀠人󰁻
孪	亠󰁗子󰀘
铱	钅亠󰀔󰁶
篆	⺮󰅂一󰀓
啬	十䒑囗口
僦	亻亠口丶
诘	讠士口󰀝
谀	讠臼人󰁶
谙	讠立日󰀝
芮	艹冂人󰁧
嗌	口䒑八皿
噤	口木木小
囝	囗子󰀌
恹	忄厂大丶
寮	宀大丷小
槁	木亠口口
樽	木丷西寸
戡	艹三八戈
毽	丿二乚廴
鸲	勹口勹一
鹦	贝贝女一
痱	疒丨三三
裨	衤󰁧白十
耩	三󰅇󰀀土
趿	口止乃󰂃
鲛	󰁢󰀞亠乂
鼷	臼󰁐󰁦大
赊	贝人二小
壹	士冖一䒑
丌	一󰀯󰀵
伢	亻󰀂亅丿
谧	讠心丿皿
塥	土一口丨
抻	扌日丨󰀢
哝	口冖󰀔󰁶
浣	氵宀二儿
宸	宀厂二󰀖
弩	女又弓󰀅
鬻	弓米弓丨
橹	木󰁢一日
赆	贝尸󰂃󰁦
胛	月甲󰀢
睨	目臼儿󰁀
跄	口止人⺋
隽	亻󰁷乃󰁣
侗	亻冂一口
孵	󰁚丶丿子
潞	氵口止口
侏	亻󰅎󰅇󰁶
呷	口甲󰀢
泯	氵󰁃󰁐弋
婺	󰁻乛亅女
蜮	虫戈口󰀞
粲	󰀥夕又米
忻	忄斤󰀢
诎	讠凵山󰀢
幔	冂丨日又
钺	钅一󰁐丶
霈	󰀙氵一丨
鲮	󰁢󰀞土夂
诤	讠⺈󰁬亅
谔	讠口口ㄅ
陟	阝止󰀤ノ
壅	亠󰁲丿土
菽	艹󰀥一又
摅	扌󰅋七心
幛	冂丨立十
嶙	山米夕丨
犷	犭ノ广ノ
钸	钅冂丨
趄	土󰁾󰀐一
踹	口止山〢
鞣	廿口十木
鼯	臼󰁐󰁦口
氽	人水󰁧
惬	忄匚一大
觑	󰅋七󰅊󰁜
钤	钅人丶乛
醵	西一󰅋󰀓
稣	󰁢󰀞禾󰁶
畚	厶大田󰀘
荠	艹文󰀯󰀬
莅	艹亻立󰀘
啻	亠丷冖口
怵	忄木丶󰁶
恽	忄冖车󰀢
阕	门癶一大
濯	氵羽亻󰁷
迩	⺈小辶󰀦
姹	女宀丿七
琬	王宀夕⺋
橛	木厂䒑人
轱	车古󰀝
甑	丷󰀺日丶
暄	日宀一一
腚	月宀一󰁾
旌	方𠂉丿主
钚	钅丆卜󰁶
蝠	虫一口田
蝮	虫𠂉日夂
箴	⺮厂一丶
羰	䒑󰀠山火
豇	一口䒑工
踮	口止广口
鼋	二儿口乚
鲷	󰁢󰀞󰀼口
毖	󰁴匕心丿
臀	尸󰁺八月
俪	亻一冂丶
郅	一厶土阝
圄	囗五口󰀌
溽	氵厂二寸
姒	女󰁐丶人
瑭	王广󰁬口
璜	王󰁺由八
舫	丿󰁪方ノ
偻	亻米女󰀝
苋	艹ㄇ󰁜󰀅
琰	王火火󰁶
楹	木乃又皿
豉	一口䒑又
黟	󰀹土灬夕
玖	王ク󰂃󰁶
舷	丿󰁪亠ㄠ
汆	丿󰂃水󰁧
郫	白丿十阝
彷	彳方ノ
洮	氵儿󰀪󰁶
杳	木日󰀘
腴	月臼人󰁶
睽	目癶一大
蝤	虫丷西一
舱	丿󰁪人⺋
鞘	廿口十月
诌	讠⺈彐󰀝
隍	阝白王󰀝
邛	工阝󰀢
叱	口ヒ󰁀
嗖	口臼丨又
恪	忄夂口󰀝
绺	纟夂卜口
梵	木木几丶
昊	日一大󰁧
钋	钅卜󰁶
镂	钅米女󰀝
穹	宀八弓󰀅
皴	厶八夂又
霾	󰀙豸日土
鲇	󰁢󰀞󰀥口
淬	氵亠人十
夙	几一夕󰀦
萘	艹大二小
噘	口厂䒑人
阚	门乛耳夂
弭	弓耳󰀝
舂	三人臼󰀘
醺	西一丿灬
翱	白大十羽
贰	弋二贝丶
龋	止人凵丶
胤	丿ㄠ月乚
鼐	乃目󰁕󰁈
仄	厂人󰀦
叵	匚口󰀌
佝	亻勹口󰀝
俎	人人󰀐一
诩	讠羽󰀝
谑	讠󰅋七一
堇	廿口主󰀘
葺	艹口耳󰀘
蕈	艹覀日十
撺	扌宀八丨
忒	弋心丶󰀦
喹	口大土土
恻	忄贝刂󰀢
浃	氵一丷大
宕	宀石󰀘
逖	犭ノ火辶
嫔	女宀󰅍八
棣	木󰁬氺󰁶
槠	木讠土日
脒	月米󰁶
腼	月丆冂三
飕	几乂臼又
睑	目人一一
睿	󰀥冖一目
锔	钅尸𠃌口
锪	钅勹󰁤心
鹪	亻󰁷灬一
耧	三󰅇米女
蜓	虫丿士廴
竽	⺮一󰀛󰀬
簟	⺮覀日十
跚	口止󰀼一
跻	口止文󰀯
鲅	󰁢󰀞丶
鳊	󰁢󰀞丶艹
鳝	󰁢󰀞䒑口
髀	󰀾月白十
髋	󰀾月宀󰁜
髻	󰀍厶彡口
鬈	󰀍厶彡⺋
亓	二󰀯󰀬
匐	勹一口田
哿	力口丁口
苕	艹刀口󰀘
蓼	艹羽人彡
夤	夕宀一八
砑	石󰀂亅丿
鸬	󰀥尸勹一
箸	⺮土丿日
椽	木󰅂一󰀓
垌	土冂一口
卟	口卜󰁶
徕	彳一米󰁶
暧	日爫冖又
歙	人一口人
煸	火丶尸艹
矶	石几󰁀
砹	石艹乂󰁶
皈	白⺁又󰁶
鸢	󰀁丶勹一
蟾	虫⺈厂言
鸯	ㄇ大勹一
搡	扌又又木
呶	口女又󰁶
怏	忄ㄇ大󰁶
洎	氵丿目󰀝
娌	女日土󰀝
牒	丿丨一木
煜	火日立󰀝
恙	丷王心󰁧
龛	人一口丶
敖	主󰁡夂󰁶
剜	宀夕⺋刂
垩	一󰅊一土
喏	口艹口
婕	女一󰁬󰁾
飒	立几乂󰁶
蜥	虫木斤󰀢
兖	亠八厶儿
埚	土口冂人
塬	土厂白小
苒	艹冂土󰀘
蕲	艹丷󰅐斤
幞	冂丨󰅊人
怛	忄日一󰀝
孑	孑乛亅󰀞
缂	纟廿口十
缏	纟亻一乂
甓	尸口立丶
钫	钅方ノ
锆	钅丿土口
銮	亠󰁗金󰀘
颧	艹口口贝
嚏	口十冖󰁾
仃	亻丁󰀢
仨	亻三󰀝
薰	艹丿一灬
擢	扌羽亻󰁷
啜	口又又又
馀	⺈󰁐人木
闱	门二𠃌丨
汴	氵亠卜󰁶
妍	女一廾󰀢
纾	纟󰁻乛亅
桠	木一󰅊一
欤	一ㄅ󰀞人
飓	几乂󰀣八
戾	丶尸大丶
砣	石宀匕󰁀
磬	士󰁅几石
铗	钅一丷大
鹭	口止夂一
袼	衤󰁧夂口
褓	衤󰁧亻木
蟀	虫亠ㄠ十
蟠	虫丿米田
笸	⺮匚口󰀘
筱	⺮亻丨夂
麒	广󰁃〢八
摈	扌宀󰅍八
蛔	虫囗口󰀝
莆	艹一月丶
氐	󰁚󰀁丶󰀦
僭	亻󰀂󰁜日
籴	丿󰂃米󰁧
袤	亠󰁻乛󰀔
荟	艹人二厶
噍	口亻󰁷灬
崃	山一米󰁶
廛	广日土土
阊	门日日󰀌
浔	氵彐寸󰁶
遴	米夕󰀂辶
骊	󰀊󰀞一丶
戛	丆目戈󰁧
歆	立日⺈人
砼	石人工󰀝
蜻	虫主月󰀝
豕	一󰀓󰀦
麾	广木木乚
肛	月工󰀝
傈	亻覀木󰁶
奘	󰄃丨丆大
琥	王󰅋七几
腱	月󰁬󰀟廴
锶	钅田心󰁶
稗	禾白丿十
茬	艹丨土
苫	艹󰀥口󰀘
丕	丆卜一󰀘
藿	艹󰀙亻󰁷
揆	扌癶一大
啷	口丶彐阝
嘣	口山月月
闫	门三󰀌
绀	纟艹二󰀝
珙	王󰁺八󰁶
栲	木土丿ㄅ
碡	石主母󰁶
钍	钅土󰀝
蒽	艹囗大心
疣	疒乚丶
剐	口冂人刂
馗	九䒑丿目
佶	亻士口󰀝
隈	阝田一󰀖
藓	艹󰁢󰀞󰀟
掼	扌󰅂十贝
唰	口尸冂刂
馔	⺈󰁐巳八
遛	󰁚丶刀辶
孀	女󰀙木目
柰	木二小󰁧
樾	木土󰁾丶
檩	木亠囗小
犍	牜󰁬󰀟廴
旎	方𠂉尸匕
煲	亻口木火
盹	目一凵乚
蛎	虫厂一󰁡
笥	⺮𠃌一口
筌	⺮人王󰀘
篼	⺮白󰁚儿
艄	丿󰁪⺌月
蹒	口止艹人
龌	止人凵土
鲣	󰁢󰀞〢土
鲧	󰁢󰀞丿小
搽	扌艹人木
讣	讠卜󰁶
绦	纟夂木󰁶
佻	亻儿󰀪󰁶
冱	冫一󰅂一
茳	艹氵工󰀘
荩	艹尸󰂃󰁦
咭	口士口󰀝
嗥	口白大十
嶝	山癶一䒑
廪	广亠囗小
阈	门戈口󰀞
驷	󰀊󰀞四󰀝
缗	纟󰁃󰁐日
缙	纟一󰅊日
珀	王白󰀝
柩	木匚ク丶
楮	木土丿日
橐	一口丨木
碹	石宀一一
眄	目一丨𠃌
钷	钅匚口󰀝
钹	钅又丶
铳	钅亠厶儿
耔	三󰅇子󰀝
颏	亠ㄥ丿贝
蝼	虫米女󰀝
蟋	虫丿米心
籁	⺮一口贝
蹊	口止爫大
鳄	󰁢󰀞口ㄅ
鳐	󰁢󰀞爫山
鞴	廿口十丨
髭	󰀍厶彡匕
垸	土宀二儿
葭	艹󰁃丨又
啖	口火火󰁶
瑁	王曰目󰀝
町	田丁󰀢
锟	钅日󰁴匕
桨	丬夕木󰁧
诫	讠戈廾󰀢
痔	疒土寸󰀦
偌	亻艹口
苡	艹󰁐丶人
荏	艹亻丿士
薮	艹米女夂
哓	口弋丿儿
喁	口日冂丶
帑	女又冂丨
幡	冂丨丿田
嶂	山立日十
柚	木由󰀝
楸	木禾火󰁶
砻	ヒ丶石
磔	石夕󰀂木
铌	钅尸匕󰁀
镌	钅亻󰁷乃
蛏	虫又土󰀝
蟓	虫⺈口󰀓
蹴	口止亠丶
靓	主月ㄇ󰁜
霁	󰀙文󰀯󰀬
龇	止人凵匕
鳎	󰁢󰀞日羽
呋	口二人󰁶
洄	氵囗口󰀝
逋	一月丨辶
镉	钅一口丨
菹	艹氵󰀐一
喙	口󰅂一󰀓
猁	犭ノ禾刂
阆	门丶彐󰀖
梏	木丿土口
觌	十乛󰁦󰁜
牖	丿丨一丶
膈	月一口丨
睚	目厂土土
铕	钅月󰀝
臾	臼人󰀦
曝	日日󰁺氺
郧	口贝阝󰀢
蛰	扌九丶虫
佤	亻一󰁐丶
掎	扌大丁口
咻	口亻木󰁶
嗄	口丆目夂
嘞	口廿口力
爿	󰄃丨丆󰀏
涔	氵山人乛
楂	木木日一
晗	日人丶口
觎	人一月󰁜
牯	牜古󰀝
铉	钅亠ㄠ󰁶
锕	钅阝丁口
镧	钅门一󰅇
蛄	虫古󰀝
蛐	虫ㄇ󰁺󰀝
笕	⺮ㄇ󰁜󰀅
鲑	󰁢󰀞土土
偈	亻日勹󰄃
萏	艹⺈臼󰀘
囿	囗月󰀌
圉	囗土䒑十
忾	忄󰅎⺄󰁀
漯	氵田ㄠ小
逵	土八土辶
缁	纟巛田󰀝
缦	纟日罒又
轸	车人彡ノ
贲	十艹贝󰁧
忑	一卜心󰁧
罘	罒丆卜󰁧
蠲	䒑八皿虫
镗	钅⺌冖土
蜉	虫爫子󰀝
箧	⺮匚一大
箜	⺮宀八工
艚	丿󰁪一日
趸	一󰁡口󰁾
鏖	广󰁃〢金
菖	艹日日󰀘
铋	钅心丿ノ
谰	讠门一󰅇
娩	女⺈口󰁜
叁	厶大三󰀘
剽	覀二小刂
堠	土亻ユ大
蔻	艹宀二又
嘌	口覀二小
噼	口尸口十
徼	彳白方夂
獍	犭ノ立儿
饧	⺈󰁐ㄋ󰁤
汊	氵又丶󰁶
涿	氵一󰀓丶
潲	氵禾⺌月
孱	尸子孑子
娅	女一󰅊一
姘	女䒑廾󰀢
璐	王口止口
柃	木人丶󰁻
柢	木󰁚󰀁丶
樯	木十䒑口
胪	月󰀥尸ノ
腓	月丨三三
焖	火门心󰁶
睢	目亻󰁷󰀝
瞽	士口䒑目
畲	人二小田
鹌	大日󰁐一
痧	疒氵小丿
裼	衤󰁧日󰁤
蝌	虫禾󰁦十
豸	豸丿丶丿
鲐	󰁢󰀞厶口
鲻	󰁢󰀞巛田
鳍	󰁢󰀞土日
螟	虫冖日八
鲴	󰁢󰀞囗古
孛	十冖子󰀘
苎	艹宀一󰀘
唑	口人人土
猡	犭ノ罒夕
漭	氵艹大廾
淼	水水水󰁧
稔	禾人丶心
鲕	󰁢󰀞丆〢
俑	亻󰁻月丨
讧	讠工󰀝
茏	艹ヒ丶
荜	艹󰁴匕十
莓	艹𠂉母󰁧
葑	艹土土寸
揿	扌钅⺈人
啕	口勹󰅎山
嚯	口󰀙亻󰁷
湟	氵白王󰀝
滂	氵亠丷方
婀	女阝丁口
缵	纟丿土贝
樨	木尸氺󰀟
瓿	立口一丶
碚	石立口󰀝
瞠	目⺌冖土
锎	钅门一廾
镅	钅󰁅目󰀝
痍	疒一弓人
竦	立一口󰅇
笊	⺮⺁丨󰂃
翮	一口冂羽
卞	亠卜󰁧
橇	木丿二乚
厍	厂车󰀵
厝	厂󰁺日󰀌
儋	亻⺈厂言
谄	讠⺈臼󰀝
荇	艹彳一丁
莴	艹口冂人
葚	艹艹三󰄃
蓓	艹亻立口
薏	艹立日心
弑	乂木󰀁丶
嚅	口󰀙丆〢
嵋	山󰁅目󰀝
狷	犭ノ口月
馓	⺈󰁐󰁺夂
溟	氵冖日八
骀	󰀊󰀞厶口
枵	木口一ㄅ
桤	木山己󰁀
榫	木亻󰁷十
榍	木尸⺌月
殄	一夕人彡
殓	一夕人一
辇	二人二车
牦	牜丿二乚
斓	文门一󰅇
硎	石一廾刂
碛	石主贝󰁶
瞵	目米夕丨
铍	钅󰅌又󰁶
稹	禾十󰀣八
鹩	大丷日一
痫	疒门木󰀦
瘿	疒贝贝女
颚	口口二贝
蟥	虫󰁺由八
篥	⺮覀木󰁧
裟	氵小丿󰀔
籼	米山󰀢
粝	米厂一󰁡
酾	西一一丶
跎	口止宀匕
鲟	󰁢󰀞彐寸
黠	󰀹土灬口
醌	西一日匕
鬲	一口冂丨
墁	土日罒又
鼙	士口䒑十
茜	艹西󰀘
莒	艹口口󰀘
荦	艹冖丿󰀟
吲	口弓丨󰀢
啐	口亠人十
崦	山大日乚
徵	彳山一夂
愠	忄日皿󰀝
懵	忄艹罒目
湎	氵丆冂三
滠	氵耳又又
潸	氵木木月
濑	氵一口贝
缬	纟士口贝
柽	木又土󰀝
镦	钅亠口夂
鹑	亠口孑一
鹜	󰁻乛亅一
袂	衤󰁧ユ人
蚍	虫󰁴匕󰁀
蛱	虫一丷大
筚	⺮󰁴匕十
糨	米弓口虫
翕	人一口羽
雒	夂口亻󰁷
鲲	󰁢󰀞日匕
剀	山󰁁刂󰀢
仳	亻󰁴匕󰁀
诳	讠犭ノ王
郯	火火阝󰀢
埝	土人丶心
咴	口火󰁶
哚	口几木󰁶
嗑	口土厶皿
囫	囗勹󰁤󰀏
嵘	山艹冖木
豳	山一󰀓󰀓
洹	氵一日一
浜	氵󰅍一八
姣	女亠八乂
楝	木一󰀹󰅇
轫	车刀丶󰁶
犒	牜亠口口
氙	󰅎⺄山󰀬
忐	󰀥一心󰁧
睃	目厶八夂
秣	禾一木󰁶
皙	木斤白󰀘
窈	宀八ㄠ力
窕	宀八儿󰀪
耒	三󰅇󰀦
颛	山丆冂贝
蜃	厂二󰀖虫
舣	丿󰁪丶乂
趵	口止勹丶
跛	口止󰅌又
踟	口止𠂉口
鲡	󰁢󰀞一丶
鲱	󰁢󰀞丨三
咿	口亻󰁬丿
骈	󰀊󰀞䒑廾
狙	犭ノ󰀐一
侩	亻人二厶
痈	疒月丨󰀵
陔	阝亠ㄥ人
垅	土ヒ丶
撙	扌丷西寸
喾	󰀧冖丿口
嗉	口主ㄠ小
恂	忄勹日󰀝
戕	󰄃丨丆戈
浞	氵口󰁾󰁶
邈	豸白儿辶
骁	󰀊󰀞弋儿
骐	󰀊󰀞艹八
邕	巛口巴󰀅
珞	王夂口󰀝
琨	王日󰁴匕
杼	木󰁻乛亅
柘	木石󰀝
棹	木󰀥日十
暌	日癶一大
媵	月䒑大女
镎	钅人一手
镏	钅󰁚丶田
疝	疒山󰀵
蚱	虫𠂉丨二
蛉	虫人丶󰁻
罄	士󰁅几山
箬	⺮艹口
跖	口止石󰀝
蹁	口止丶艹
蹼	口止󰅊人
鲳	󰁢󰀞日日
鳅	󰁢󰀞禾火
骷	󰀾月古󰀝
髅	󰀾月米女
墒	土亠丷口
呱	口⺁厶󰂃
绻	纟䒑大⺋
秕	禾󰁴匕󰁀
痉	疒ス工󰀌
泅	氵囗人󰁶
孬	丆卜女子
侬	亻冖󰀔󰁶
诓	讠匚王󰀝
谳	讠十冂丶
掮	扌丶尸月
啁	口󰀼土口
崴	山厂一丶
獾	犭ノ艹󰁷
忪	忄八厶󰁶
妯	女由󰀝
玳	王亻󰀁丶
刖	月刂󰀢
髑	󰀾月罒虫
讫	讠𠂉乙󰁀
瘸	疒力口人
獭	犭ノ一贝
刎	勹󰁤刂󰀢
仉	亻几󰁀
伥	亻丿七󰂃
僖	亻士口口
羸	亠󰄃口丶
讦	讠干󰀢
谇	讠亠人十
茛	艹彐󰀖󰁧
菰	艹孑⺁󰂃
啵	口氵󰅌又
峥	山⺈󰁬亅
獬	犭ノ⺈󰀟
庖	广勹巳󰁫
忤	忄𠂉十󰀢
怊	忄刀口󰀝
懔	忄亠囗小
洇	氵囗大󰁶
濉	氵目亻󰁷
彘	󰅂一𠂉匕
艴	弓󰀯⺈巴
嫠	二󰅇夂女
绾	纟宀丨󰁃
缃	纟木目󰀝
玑	王几󰁀
珉	王󰁃󰁐弋
旮	九日󰀘
虢	爫寸󰅋几
豚	月一󰀓󰁶
腧	月人一刂
膑	月宀󰅍八
硖	石一丷大
钣	钅⺁又󰁶
锞	钅日木󰁶
镒	钅䒑八皿
镥	钅󰁢一日
镫	钅癶一䒑
耖	三󰅇小丿
颞	耳又又贝
螨	虫艹一人
簋	⺮彐󰀖皿
舡	丿󰁪工󰀝
舭	丿󰁪󰁴匕
袈	力口亠󰀔
糗	米丿目丶
酽	西一一厂
踅	扌斤口󰁾
跹	口止丿辶
巽	巳巳󰁺八
螂	虫丶彐阝
佞	亻二女󰀝
诠	讠人王󰀝
阽	阝󰀥口󰀝
圹	土广ノ
埴	土十󰀣󰀝
堙	土覀土󰀝
塄	土罒方ノ
蕺	艹口耳丶
蘼	艹广木三
摁	扌囗大心
撄	扌贝贝女
撷	扌士口贝
撸	扌󰁢一日
呓	口艹乙󰁀
噻	口宀󰀀土
帙	冂丨󰅎人
憷	忄木木󰁾
沔	氵一丨𠃌
沆	氵亠几󰁀
沩	氵丶丿丶
泔	氵艹二󰀝
潴	氵犭ノ日
澉	氵乛耳夂
娆	女弋丿儿
骅	󰀊󰀞亻十
缣	纟䒑󰁬󰁗
韪	日一󰁾丨
栎	木丿󰄃小
栾	亠󰁗木󰁧
桴	木爫子󰀝
榀	木口口口
椴	木亻三又
觋	工人人󰁜
炱	厶口火󰁧
戆	立日十心
畎	田大丶󰁶
盍	土厶皿󰀘
铷	钅女口󰀝
鹗	口口二一
蝻	虫十冂十
笱	⺮勹口󰀘
舢	丿󰁪山󰀢
羯	䒑󰀠日󰄃
醢	西一皿
麇	广󰁃〢禾
佟	亻夂󰁦󰁶
谡	讠田八夂
谶	讠人人󰀞
堞	土廿󰄃木
莪	艹丿扌丶
蕻	艹󰀍厶八
叻	口力ノ
哙	口人二厶
咤	口宀丿七
淝	氵月巴󰁀
逅	⺁一口辶
遑	白王辶󰀌
尕	乃小󰁧
棂	木彐火󰁶
氅	⺌冂口乚
腙	月宀二小
磙	石亠八󰀔
铟	钅囗大󰁶
矬	𠂉大人土
稃	禾爫子󰀝
瘌	疒一口刂
癯	疒目目󰁷
颉	士口丆贝
趱	土󰁾丿贝
踺	口止󰁬廴
扦	扌丿十󰀢
胱	月⺌一儿
糌	米夂卜日
誊	䒑大言󰀘
诟	讠⺁一口
陉	阝ス工󰀝
隗	阝白󰁜厶
郜	丿土口阝
垭	土一󰅊一
埘	土日寸󰁶
荬	艹乛󰁦大
莼	艹纟一乚
菟	艹⺈口丶
葩	艹白巴󰀅
摺	扌羽白󰀝
甙	弋艹二丶
啭	口车二丶
嗫	口耳又又
嘧	口宀心山
馊	⺈󰁐臼又
悌	忄丷弓丿
慵	忄广󰁬丨
洚	氵夂󰀂丨
潋	氵人一夂
蹇	宀󰀀八󰁾
椐	木尸古󰀝
赉	一米贝󰁧
煳	火古月󰀝
戽	丶尸󰁦十
愆	彳氵一心
铹	钅艹冖力
锴	钅󰁴匕白
镆	钅艹日大
窨	宀八立日
窳	宀八⺁󰂃
褊	衤󰁧丶艹
褫	衤󰁧⺁几
篁	⺮白王󰀘
舸	丿󰁪丁口
糅	米󰁻乛木
趔	土󰁾一刂
龃	止人凵一
縻	广木木小
苌	艹丿七󰂃
荽	艹爫女󰀘
搠	扌䒑凵月
渌	氵󰁭氺󰁶
灞	氵󰀙廿月
骛	󰁻乛亅一
齑	文󰀯丨一
硐	石冂一口
聱	主󰁡夂耳
虻	虫亠󰄃󰁀
蝣	虫方𠂉子
螳	虫⺌冖土
筘	⺮扌口󰀘
篌	⺮亻ユ大
麋	广󰁃〢米
鹫	亠口小一
蹿	口止宀丨
娠	女厂二󰀖
伛	亻匚乂󰁶
唏	口乂丨
嘭	口士口彡
幄	冂丨尸土
徉	彳䒑󰀟󰀢
溆	氵人一又
枧	木ㄇ󰁜󰁀
殒	一夕口贝
氆	丿二乚日
钪	钅亠几󰁀
铼	钅一米󰁶
秭	禾丿ㄅ丿
鹈	丷弓丨一
瘊	疒亻ユ大
褡	衤󰁧艹口
螫	土󰁖夂虫
赧	土󰁖卩又
趼	口止一廾
雏	⺈彐亻󰁷
珐	王土厶󰁶
疹	疒人彡󰀏
芈	丨一󰀥󰀟
伉	亻亠几󰁀
倥	亻宀八工
诼	讠一󰀓丶
邬	勹ㄅ󰀞阝
郄	乂厶阝
荑	艹一弓人
莘	艹立十󰀬
蓁	艹三人禾
辔	车纟纟口
岫	山由󰀝
峄	山又󰀟󰀢
崞	山亠口子
忝	一大⺗󰁧
洫	氵丿皿󰀝
洳	氵女口󰀝
湔	氵䒑月刂
濮	氵亻󰅊人
瀹	氵人一艹
迨	厶口辶󰀌
缋	纟口丨贝
枥	木厂力ノ
棼	木木八刀
殍	一夕爫子
昱	日立󰀘
赅	贝亠ㄥ人
擘	尸口立手
旒	方𠂉亠󰀸
燹	一󰀓一火
砭	石丿之󰁶
碓	石亻󰁷󰀝
黻	󰅊一丷丶
睐	目一米󰁶
畀	田一󰀯󰀬
钐	钅彡ノ
锝	钅日一寸
镛	钅广󰁬丨
鸷	扌九丶一
疬	疒厂力󰀏
癍	疒王文王
颡	又又又贝
蜢	虫子皿󰀝
衾	人丶乛󰀔
骶	󰀾月󰁚丶
啄	口一󰀓丶
鳗	󰁢󰀞日又
佰	亻丆日󰀝
妊	女丿士󰀝
兕	丨󰁎󰀽儿
诮	讠⺌月󰀝
谲	讠󰁻乛口
邶	丬󰁴阝󰀢
鄢	一止一阝
圯	土巳󰁀
茔	艹冖土󰀘
茕	艹冖⺄十
茈	艹止匕󰀅
蕨	艹厂䒑人
抟	扌二󰁓丶
摭	扌广廿灬
囹	囗人丶󰁻
帼	冂丨囗丶
愎	忄𠂉日夂
汜	氵巳󰁀
洧	氵月󰀝
洙	氵󰅎󰅇󰁶
澍	氵士口寸
逡	厶八夂辶
遨	主󰁡夂辶
邂	⺈月丨辶
妗	女人丶乛
嬖	尸口立女
绡	纟⺌月󰀝
甾	巛田󰀘
梃	木丿士廴
桷	木⺈月丨
榧	木匚丨三
辋	车冂䒑󰄃
昕	日斤󰀢
炷	火丶王󰀝
祓	礻󰁶丶
碇	石宀一󰁾
罟	罒古󰀘
钗	钅又丶󰁶
铊	钅宀匕󰁀
铤	钅丿士廴
镡	钅覀日十
鸩	冖󰁜勹一
鹆	八人口一
鹉	二止󰁒一
鹧	广廿灬一
瘐	疒臼人󰀦
瘰	疒田ㄠ小
癃	疒阝夂主
耨	三󰅇厂寸
聒	耳丿古󰀝
蚶	虫艹二󰀝
蟑	虫立日十
笪	⺮日一󰀘
羝	䒑󰀠󰁚丶
粑	米巴󰁀
糈	米乛󰁾月
蹰	口止厂寸
躐	口止巛󰁒
鲆	󰁢󰀞一十
鳇	󰁢󰀞白王
挛	亠󰁗手󰀬
睥	目白丿十
耪	三󰅇亠方
靥	厂大丶三
鄞	廿口主阝
酃	󰀙口口阝
埒	土爫寸󰁶
夼	大川󰀬
摞	扌田ㄠ小
擤	扌丿目󰀯
哂	口西󰀝
嗝	口一口丨
噱	口󰅋七󰀓
嚓	口宀󰁯小
帏	冂丨二丨
崮	山囗古󰀘
狴	犭ノ󰁴土
愦	忄口丨贝
泖	氵󰁚丿卩
骠	󰀊󰀞覀小
绂	纟又丶
缒	纟亻󰁃辶
犋	牜󰀣八󰁶
塍	月䒑大土
锒	钅丶彐󰀖
锫	钅立口󰀝
锿	钅亠口󰀔
痦	疒五口󰀌
聃	耳冂土󰀝
蚬	虫ㄇ󰁜󰁀
蟛	虫士口彡
笤	⺮刀口󰀘
鲚	󰁢󰀞文󰀯
蹭	口止丷日
佾	亻八月󰀝
侪	亻文󰀯󰀢
倬	亻󰀥日十
傥	亻⺌冖儿
谮	讠󰀂󰁜日
谵	讠⺈厂言
陧	阝日土󰀝
邴	一冂人阝
垡	亻戈土󰀘
坫	土󰀥口󰀝
苣	艹匚󰁃󰀘
蒌	艹米女󰀘
捭	扌白丿十
吣	口心󰁶
囵	囗人匕󰁫
犰	犭ノ九󰁀
犴	犭ノ干󰀢
猓	犭ノ日木
獐	犭ノ立十
庑	广二󰁜󰁫
阌	门爫冖又
嬗	女亠囗一
缱	纟口丨辶
殁	一夕几又
旰	日干󰀢
牾	牜五口󰀝
彀	士冖一又
旃	方𠂉󰀼亠
畹	田宀夕⺋
钽	钅日一󰀝
铑	钅土丿匕
铪	钅人一口
锛	钅大十廾
镞	钅方𠂉大
鸱	󰁚󰀁丶一
蚩	凵丨一虫
蜍	虫人一木
蜴	虫日勹󰁤
螬	虫一ㄇ日
襞	尸口立󰀔
翳	匚𠂉大羽
貊	豸丆日󰀝
龈	止人凵󰀖
龊	止人凵󰁾
鎏	氵亠厶金
飨	󰁲丿人󰀖
仟	亻丿十󰀢
嘏	古󰁃丨又
侑	亻月󰀝
倨	亻尸古󰀝
偬	亻勹󰁤心
龠	人一口艹
冁	丷󰅐尸󰀖
诖	讠土土󰀝
谫	讠䒑月刀
谯	讠亻󰁷灬
劢	一󰁡力ノ
鬯	󰁘凵匕󰀅
坌	八刀土󰀘
垓	土亠ㄥ人
堀	土尸凵山
艿	艹乃󰁣
莠	艹禾乃󰁣
荻	艹犭ノ火
蓊	艹八厶羽
蕤	艹一󰀓主
掊	扌立口󰀝
搌	扌尸󰁺󰀖
呙	口冂人󰁧
唿	口勹󰁤心
岵	山古󰀝
崂	山艹冖力
嵯	山䒑󰀠工
嵴	山󰀪人月
獠	犭ノ大小
怄	忄匚乂󰁶
怩	忄尸匕󰁀
悛	忄厶八夂
悱	忄丨三三
闳	门厶󰀦
阋	门臼儿󰁫
阗	门十󰀣八
泺	氵丿󰄃小
淦	氵金󰀝
滏	氵八乂䒑
澌	氵艹三斤
瀣	氵󰀥夕一
羼	尸䒑󰀟󰀟
妁	女勹丶󰁶
绁	纟廿󰄃󰁀
缍	纟丿十一
珏	王王丶󰁶
璁	王丿囗心
桡	木弋丿儿
槎	木䒑󰀠工
樗	木󰀙二ㄅ
辚	车米夕丨
晷	日夂卜口
赇	贝一氺丶
牝	牜匕󰁀
胨	月󰀂小󰁶
胂	月日丨󰀢
朐	月勹口󰀝
胼	月䒑廾󰀢
欷	乂冂人
毂	士冖车又
烊	火䒑󰀟󰀢
熳	火日罒又
燔	火丿米田
爨	󰀗ㄇ一火
恁	亻丿士心
畛	田人彡ノ
詈	罒言󰀘
钕	钅女󰀝
锱	钅巛田󰀝
镳	钅广󰁃灬
鸶	󰁲󰁲一一
鹚	䒑ㄠㄠ一
疖	疒ㄗ󰀵
疱	疒勹巳󰁫
疰	疒丶王󰀌
虬	虫乚󰁀
蚪	虫󰁦十󰀢
箨	⺮扌又󰀟
簏	⺮广󰁃匕
艋	丿󰁪子皿
粞	米西󰀝
醅	西一立口
跞	口止丿小
蹀	口止廿木
貔	豸丿囗匕
雠	亻󰁷讠󰁷
鳕	󰁢󰀞󰀙彐
鞫	廿口十言
魇	厂大丶厶
魉	白󰁜厶人
餍	厂大丶󰀖
滗	氵⺮丿乚
蠹	一口丨虫
僳	亻覀米󰁶
囟	丿囗乂󰀦
刳	大二ㄅ刂
勖	曰目力ノ
叟	臼丨又󰁧
矍	目目亻又
蕹	艹亠󰁲󰁷
拶	扌巛夕󰁶
吖	口丷丨󰀢
哐	口匚王󰀝
咩	口䒑󰀟󰀢
哞	口厶丿󰀟
喵	口艹田󰀝
啶	口宀一󰁾
徜	彳⺌冂口
狯	犭ノ人厶
舛	夕󰀂丨󰀢
悭	忄〢又土
阄	门⺈日乚
洌	氵一夕刂
淠	氵田一󰀯
滹	氵󰅋七󰀛
搴	宀󰀀八手
遢	日羽辶󰀌
邋	巛囗乂辶
妲	女日一󰀝
玎	王丁󰀢
琮	王宀二小
枨	木丿七󰂃
榉	木󰀧一󰀟
檫	木宀󰁯小
肼	月二󰀯󰀢
朊	月二儿󰁀
腌	月大日乚
膦	月米夕丨
碜	石厶大彡
罱	罒十冂十
钏	钅川󰀢
疴	疒丁口󰀌
瘘	疒米女󰀌
裥	衤󰁧门日
耢	三󰅇艹力
耵	耳丁󰀢
聩	耳口丨贝
蚋	虫冂人󰁶
蛴	虫文󰀯󰀢
罂	贝贝󰅎山
艨	丿󰁪艹󰀓
跸	口止󰁴十
跣	口止丿儿
跤	口止亠乂
鞯	廿口十子
蓍	艹土丿日
仡	亻𠂉乙󰁀
鲨	氵小丿一
熵	火亠丷口
岿	山リ彐󰀘
亍	一丁󰀬
爻	乂乂󰁧
仵	亻𠂉十󰀢
傩	亻又亻󰁷
僮	亻立日土
訇	勹言󰀌
隰	阝日ㄠ灬
邡	方阝󰀢
凼	水凵󰀵
墀	土尸氺󰀟
苴	艹󰀐一󰀘
荨	艹彐寸󰁧
蓐	艹厂二寸
蓰	艹彳止󰁾
奁	大匚乂󰁧
捃	扌󰁬丿口
揸	扌木日一
唳	口丶尸丶
岽	山󰀂小󰁧
峤	山丿大󰀯
嵛	山人一刂
嶷	山匕𠂉󰁾
狃	犭ノ󰁈二
猕	犭ノ弓小
馑	⺈󰁐廿主
怿	忄又󰀟󰀢
阃	门囗木󰀦
阍	门󰁚弋日
涑	氵一口󰅇
濞	氵丿目󰀯
濠	氵亠口󰀓
瀵	氵米田八
逦	一冂丶辶
逯	󰁭氺辶󰀦
屣	尸彳止󰁾
嫖	女覀二小
嫘	女田ㄠ小
驽	女又󰀊一
骓	󰀊󰀞亻󰁷
绗	纟彳一丁
珈	王力口󰀝
瑗	王爫一又
璩	王󰅋七󰀓
榇	木立木󰁶
殇	一夕𠂉󰁤
殪	一夕士䒑
晔	日亻ヒ十
赙	贝一月寸
毹	人一月乚
歃	丿十臼人
觳	士冖一又
旄	方𠂉丿乚
祧	礻󰁶儿󰀪
禊	礻󰁶三大
怼	又寸心󰁧
憝	亠口孑心
斫	石斤󰀢
碥	石丶尸艹
黼	󰅊一丷丶
眇	目小丿ノ
眦	目止匕󰁀
铒	钅耳󰀝
锖	钅主月󰀝
锘	钅艹口
锸	钅丿十臼
镝	钅亠丷古
矧	𠂉大弓丨
痤	疒人人土
衩	衤󰁧又丶
裣	衤󰁧人一
聍	耳宀丁󰀢
蝽	虫三人日
螽	夂󰁦虫虫
蟊	󰁻乛亅虫
缶	󰅎山󰀵
笄	⺮一廾󰀬
箢	⺮宀夕⺋
舨	丿󰁪⺁又
舻	丿󰁪󰀥尸
舾	丿󰁪西󰀝
艟	丿󰁪立土
醑	西一乛月
醭	西一󰅊人
醯	西一亠皿
趺	口止二人
跗	口止亻寸
踝	口止日木
踬	口止⺁贝
踣	口止立口
躞	口止言又
霪	󰀙氵爫士
鋈	氵丿大金
鲠	󰁢󰀞一乂
鳏	󰁢󰀞罒󰀫
鳘	𠂉母夂一
鳢	󰁢󰀞ㄇ䒑
骰	󰀾月几又
餮	一夕人󰀖
菏	艹氵丁口
乜	𠃌乚󰁫
乩	󰀥口乚󰁀
诜	讠丿土儿
谌	讠艹三󰄃
阢	阝一儿󰁀
鄹	耳又乑阝
劬	勹口力ノ
勐	子皿力ノ
埏	土丿止廴
墉	土广󰁬丨
茌	艹亻士󰀘
茚	艹󰁚一卩
茱	艹󰅎󰅇󰁧
荞	艹丿大󰀯
菥	艹木斤󰀬
菘	艹木八厶
萜	艹冂丨口
菔	艹月卩又
菅	艹宀丨󰁃
葳	艹厂一丶
藁	艹亠口木
呲	口止匕󰁀
哕	口山夕󰁶
哌	口⺁󰀕󰁶
哏	口彐󰀖󰁶
嘬	口日耳又
噌	口丷󰀺日
崤	山乂月
嵫	山䒑ㄠㄠ
狨	犭ノ戈
狺	犭ノ言󰀝
飧	夕人丶󰀖
饩	⺈󰁐󰅎⺄
馐	⺈󰁐䒑二
庥	广亻木󰀦
怙	忄古󰀝
怍	忄𠂉丨二
悃	忄囗木󰁶
泷	氵ヒ丶
泫	氵亠ㄠ󰁶
浈	氵󰀥贝󰁶
渑	氵口日乚
溲	氵臼丨又
滢	氵艹冖丶
宄	宀九󰀅
迓	󰀂亅丿辶
尻	尸九󰁫
妣	女󰁴匕󰁀
妫	女丶丿丶
娉	女由一ㄅ
骜	主󰁡夂一
骟	󰀊󰀞丶羽
缧	纟田ㄠ小
瑷	王爫冖又
杌	木一儿󰁀
枰	木一丷十
柝	木斤丶󰁶
桄	木⺌一儿
椹	木艹三󰄃
辂	车夂口󰀝
暝	日冖日八
氍	目目亻乚
氕	󰅎⺄丿󰁣
氤	󰅎⺄囗大
胗	月人彡ノ
朕	月䒑大󰁶
膻	月亠囗一
熘	火󰁚丶田
燠	火丿ㄇ大
砀	石ㄋ󰁤ノ
砦	止匕石󰀘
礞	石艹冖󰀓
睇	目丷弓丿
钌	钅了󰀢
钔	钅门󰁀
铈	钅亠冂丨
锃	钅口王󰀝
镄	钅弓󰀯贝
锺	钅丿一土
穰	禾亠口󰀔
瓠	大二ㄅ󰂃
瘭	疒覀二小
裢	衤󰁧车辶
裎	衤󰁧口王
襁	衤󰁧弓虫
蛩	工几丶虫
蝥	󰁻乛亅虫
筢	⺮扌巴󰀅
酢	西一𠂉二
醮	西一亻灬
跬	口止土土
觚	⺈月丨󰂃
觫	⺈月丨󰅇
龀	止人凵ヒ
鲺	󰁢󰀞⺄虫
鳓	󰁢󰀞廿力
骺	󰀾月⺁口
黢	󰀹土灬夂
诶	讠厶𠂉大
後	彳ㄠ夂󰁶
缟	纟亠口口
桁	木彳一丁
钯	钅巴󰁀
痣	疒士心󰀦
颌	人一口贝
傧	亻宀󰅍八
谂	讠人丶心
掴	扌囗王丶
剌	一口󰅇刂
脔	亠󰁗冂人
萸	艹臼人󰁧
峋	山勹日󰀝
庠	广䒑󰀟󰀵
庹	广廿尸󰂃
泱	氵ㄇ大󰁶
鲈	󰁢󰀞󰀥尸
薹	艹士口土
捱	扌厂土土
呦	口ㄠ力ノ
圊	囗主月󰀌
岈	山󰀂亅丿
狳	犭ノ人木
缯	纟丷󰀺日
珲	王冖车󰀢
旯	日九󰀅
鹕	古月勹一
顸	干丆贝󰁶
螈	虫厂白小
龉	止人凵口
捌	扌口力刂
疥	疒人󰀯󰀵
疽	疒󰀐一󰀌
柒	氵七木󰁧
鼗	儿󰀪士又
厣	厂大丶甲
刿	山夕刂󰀢
蒯	艹月月刂
仂	亻力ノ
仫	亻丿厶󰁶
伲	亻尸匕󰁀
佴	亻耳󰀝
俦	亻三丿寸
倮	亻日木󰁶
裒	亠臼󰀔󰁧
蠃	亠󰄃口丶
诔	讠三󰅇󰁶
诹	讠耳又󰁶
谝	讠丶尸艹
阼	阝𠂉丨二
陴	阝白丿十
邗	干阝󰀢
邙	亠󰄃阝󰀢
邾	󰅎󰅇阝󰀢
郐	人二厶阝
郗	乂冂阝
劭	刀口力ノ
坼	土斤丶󰁶
坻	土󰁚󰀁丶
埕	土口王󰀝
埸	土日勹󰁤
堍	土⺈口丶
艽	艹九󰀅
芨	艹乃󰂃󰁧
芎	艹弓󰀅
芑	艹己󰀅
芾	艹一冂丨
芰	艹十又󰁧
苈	艹厂力󰁣
芩	艹人丶乛
芪	艹󰁚弋󰀅
苤	艹丆卜一
苘	艹冂口󰀘
苻	艹亻寸󰁧
茑	艹勹丶一
莩	艹爫子󰀘
萑	艹亻󰁷󰀘
蒉	艹口丨贝
葶	艹亠口丁
蒎	艹氵⺁󰀕
蔌	艹一口人
甍	艹罒冖丶
蔹	艹人一夂
蕖	艹氵匚木
薤	艹一夕一
薜	艹尸口十
薷	艹󰀙丆〢
蘅	艹彳󰁢丁
匏	大二ㄅ巳
尥	乚勹丶
捩	扌丶尸丶
揠	扌匚日女
揎	扌宀一一
搋	扌⺁󰅋几
吒	口丿七󰁀
呒	口二󰁜󰁀
咣	口⺌一儿
唪	口三人󰀟
唼	口立女󰀝
喈	口󰁴匕白
嗪	口三人禾
嗲	口八乂夕
嗍	口䒑凵月
嗾	口方𠂉大
岘	山ㄇ󰁜󰁀
岙	丿大山󰀬
岢	山丁口󰀘
岣	山勹口󰀝
峁	山󰁚丿卩
彳	彳丿丿丨
狁	犭ノ厶儿
狲	犭ノ孑小
猃	犭ノ人一
猊	犭ノ臼儿
猢	犭ノ古月
猱	犭ノ󰁻木
獯	犭ノ丿灬
庳	广白丿十
廨	广⺈月󰀟
忮	忄十又󰁶
怫	忄弓󰀯󰀢
隳	阝工⺗
闶	门亠几󰁫
阒	门目大丶
洵	氵勹日󰀝
涠	氵囗二丨
溱	氵三人禾
溷	氵囗一󰀓
澹	氵⺈厂言
澶	氵亠囗一
宥	宀月󰀘
寤	宀󰄃丨口
妪	女匚乂󰁶
姝	女󰅎󰅇󰁶
娲	女口冂人
婊	女主󰀔󰁶
媪	女日皿󰀝
嫫	女艹日大
嫒	女爫冖又
嫱	女十䒑口
骖	󰀊󰀞厶彡
骘	阝止󰀤一
骝	󰀊󰀞󰁚田
纡	纟一󰀛󰀢
绔	纟大二ㄅ
绠	纟一日乂
绨	纟丷弓丿
缇	纟日一󰁾
缌	纟田心󰁶
缛	纟厂二寸
缲	纟口口木
缳	纟罒一󰀔
珥	王耳󰀝
璎	王贝贝女
杓	木勹丶󰁶
杪	木小丿ノ
栌	木󰀥尸ノ
柁	木宀匕󰁀
栳	木土丿匕
栝	木丿古󰀝
棰	木丿十一
椋	木亠口小
椁	木亠口子
槿	木廿口主
樘	木⺌冖土
橥	犭ノ土木
殛	一夕了一
轷	车丿丷󰀛
轺	车刀口󰀝
轾	车一厶土
辏	车三人大
軎	車口󰀘
瓴	人丶󰁻丶
昀	日勹冫󰀝
昝	夂卜日󰀘
晡	日一月丶
暾	日亠口夂
贶	贝口儿󰁀
赕	贝火火󰁶
觇	󰀥口ㄇ󰁜
觏	󰀀ㄇ土󰁜
牮	亻󰀁丶󰀟
挲	氵小丿手
毪	丿二乚󰀟
氲	󰅎⺄日皿
肫	月一凵乚
肭	月冂人󰁶
胍	月⺁厶󰂃
胴	月冂一口
脶	月口冂人
腩	月十冂十
欹	大丁口人
炝	火人⺋󰁀
焐	火五口󰀝
爝	火爫罒寸
扃	丶尸冂口
祢	礻󰁶⺈小
禳	礻󰁶亠󰀔
悫	士冖几心
愍	󰁃󰁐弋心
慝	匚艹心
砗	石车󰀢
硗	石弋丿儿
磲	石氵匚木
礅	石亠口夂
黹	󰅊一丷󰅏
眢	夕⺋目󰀘
眙	目厶口󰀝
瞍	目臼丨又
疃	田立日土
罡	罒一止󰀘
罴	罒土厶灬
罹	罒忄亻󰁷
罾	罒丷󰀺日
钿	钅田󰀝
铘	钅󰀂亅阝
锇	钅丿扌丶
锬	钅火火󰁶
锾	钅爫一又
镔	钅宀󰅍八
镟	钅方𠂉󰁾
镤	钅󰅊一人
镲	钅宀󰁯小
皤	白丿米田
鸺	亻木勹一
鹁	十冖孑一
鹂	一冂丶一
鹣	䒑󰁬󰁗一
鹬	󰁻乛亅一
鹳	艹口口一
疔	疒丁󰀵
疳	疒艹二󰀌
瘃	疒一󰀓丶
痿	疒禾女󰀌
瘥	疒䒑󰀠工
瘼	疒艹日大
瘵	疒󰁯二小
癜	疒尸󰁺又
窬	宀八人刂
衿	衤󰁧人乛
袢	衤󰁧丷󰀟
襦	衤󰁧󰀙〢
襻	衤󰁧木手
耜	三󰅇丨󰁃
耱	三󰅇广石
耋	土丿匕土
颟	艹一冂贝
颢	日亠口贝
颥	󰀙丆冂贝
颦	止󰀤丆十
虿	一󰁡虫󰁧
蚺	虫冂土󰀝
蛲	虫弋丿儿
蛘	虫䒑󰀟󰀢
蛑	虫厶丿󰀟
蛸	虫⺌月󰀝
蜊	虫禾刂󰀢
蜞	虫艹三八
蜾	虫日木󰁶
蜩	虫󰀼土口
蝾	虫艹冖木
蝰	虫大土土
螵	虫覀二小
蠖	虫艹亻又
罅	󰅎山󰅋󰀛
笏	⺮勹󰁤󰁣
筅	⺮丿土儿
筮	⺮工人人
篑	⺮口丨贝
舄	臼勹灬󰁧
臬	丿目木󰁧
衄	丿皿󰁈二
舯	丿󰁪口丨
舳	丿󰁪由󰀝
敉	米夂󰁶
糁	米厶大彡
糇	米亻ユ大
糍	米䒑ㄠㄠ
艮	彐󰀖󰀦
翥	土丿日羽
絷	扌九丶小
纛	主母󰀣小
麴	木人人米
酤	西一古󰀝
酡	西一宀匕
酩	西一夕口
酹	西一爫寸
醐	西一古月
醍	西一日󰁾
跏	口止力口
跆	口止厶口
蹯	口止丿田
貘	豸艹日大
觯	⺈月丨󰅐
謦	士󰁅几言
龅	止人凵巳
黾	口日乚󰀅
鼍	口口田乚
隼	亻󰁷十󰀬
雎	󰀐󰀞亻󰁷
銎	工几丶金
錾	车斤金󰀘
鐾	尸口立金
鲎	󰀧冖󰁢一
鲔	󰁢󰀞月
鲵	󰁢󰀞臼儿
鲼	󰁢󰀞十贝
鲽	󰁢󰀞廿木
鳆	󰁢󰀞𠂉夂
鳋	󰁢󰀞又虫
鞒	廿口十󰀯
髁	󰀾月日木
饕	口一ㄅ󰀖
髹	󰀍厶彡木
鬟	󰀍厶彡󰀔
黧	禾勹丿灬
鼢	臼󰁐󰁦刀
倭	亻禾女󰀝
酆	山三丨阝
坩	土艹二󰀝
苜	艹目󰀘
莜	艹亻丨夂
莨	艹丶彐󰀖
蓥	艹冖金󰀘
瞢	艹罒冖目
呔	口大丶󰁶
夥	日木夕夕
馕	⺈󰁐一󰀔
汩	氵日󰀝
骒	󰀊󰀞日木
纰	纟󰁴匕󰁀
玟	王文󰁶
炅	日火󰁧
砬	石立󰀝
颃	亠几丆贝
麽	广木木厶
齄	丿目田一
赜	匚丨口贝
劐	艹亻󰁷刂
卺	了󰀩一⺋
鄄	覀土阝󰀢
圬	土二ㄅ󰁀
坜	土厂力ノ
蒇	艹厂贝丶
蒹	艹䒑󰁬󰁗
蒗	艹氵丶󰀖
蔟	艹方𠂉大
掭	扌一大⺗
搛	扌䒑󰁬󰁗
擐	扌罒一󰀔
擗	扌尸口十
帔	冂丨󰅌又
岍	山一廾󰀢
崧	山木八厶
甯	宀心月丨
嬲	田力女力
骢	󰀊󰀞丿心
纥	纟𠂉乙󰁀
枞	木人人󰁶
栊	木ヒ丶
柙	木甲󰀢
枳	木口八󰁶
椤	木罒夕󰁶
檗	尸口立木
搿	人一手
炀	火ㄋ󰁤ノ
烀	火丿丷󰀛
穑	禾十䒑口
裆	衤󰁧⺌彐
颍	匕水丆贝
蚴	虫ㄠ力ノ
匦	匚车九󰁫
劂	厂䒑凵刂
伧	亻人⺋󰁀
佧	亻󰀥一卜
俜	亻由一ㄅ
黉	󰀧冖󰁺八
馘	䒑丿目󰀞
凇	冫木八厶
谖	讠爫一又
陬	阝耳又󰁶
郢	口王阝󰀢
鄯	䒑󰀟䒑阝
垆	土󰀥尸ノ
坭	土尸匕󰁀
坶	土母󰁶
埽	土彐冖丨
芄	艹九丶󰁧
苊	艹厂⺋󰀅
芘	艹󰁴匕󰀅
苁	艹人人󰁧
芟	艹几又󰁧
茆	艹󰁚丿卩
荛	艹弋丿儿
荮	艹纟寸󰁧
莰	艹土⺈人
莶	艹人一一
菪	艹宀石󰀘
蓣	艹󰁻乛贝
蕞	艹日耳又
薨	艹罒冖匕
蘧	艹󰅋七辶
廾	廾一丿丨
尢	乚󰁫
揲	扌廿󰄃木
揞	扌立日󰀝
搦	扌弓冫冫
撖	扌乛耳夂
攉	扌󰀙亻󰁷
攮	扌一口󰀔
呤	口人丶󰁻
哜	口文󰀯󰀢
哳	口扌斤󰀢
唣	口白七󰁀
啉	口木木󰁶
喱	口厂日土
囗	囗丨󰁈一
帱	冂丨三寸
帻	冂丨主贝
屺	山己󰁀
岜	山巴󰀅
崾	山覀女󰀝
嵝	山米女󰀝
徂	彳󰀐一󰀝
犸	犭ノ󰀊一
狻	犭ノ厶夂
猹	犭ノ木一
猸	犭ノ󰁅目
馇	⺈󰁐木一
庀	广匕󰁫
廑	广廿口主
丬	丬丶󰀞丨
氵	氵丶丶󰀞
汔	氵𠂉乙󰁀
沲	氵𠂉也󰁀
浯	氵五口󰀝
浼	氵⺈口󰁜
渖	氵宀日丨
渫	氵廿󰄃木
湓	氵八刀皿
溻	氵日羽󰀝
迕	𠂉十辶󰀵
迮	𠂉丨二辶
彐	彐󰁈一一
弪	弓ス工󰀝
屮	凵丨󰀵
妤	女󰁻乛亅
娈	亠󰁗女󰀘
胬	女又冂人
媸	女凵丨虫
嫜	女立日十
尜	小大小󰁧
孓	了󰂃󰀦
驵	󰀊󰀞󰀐一
驺	󰀊󰀞⺈彐
骣	󰀊󰀞尸子
纟	纟ㄥㄥ󰀞
纩	纟广ノ
绋	纟弓󰀯󰀢
绐	纟厶口󰀝
绱	纟⺌冂口
绲	纟日󰁴匕
缡	纟亠乂厶
巛	巛󰁑󰁑󰁑
玢	王八刀ノ
琚	王尸古󰀝
璺	󰀗ㄇ一丶
杩	木󰀊一󰀝
枘	木冂人󰁶
桕	木臼󰀝
桊	䒑大木󰁧
桫	木氵小丿
椟	木十乛大
椠	车斤木󰁧
楗	木󰁬󰀟廴
楱	木三人大
榘	𠂉大匚木
槔	木白大十
榱	木亠口󰀔
槊	䒑凵丿木
槭	木厂󰀥丶
槲	木⺈月十
檠	艹勹口木
檎	木人亠厶
橼	木纟󰅂󰀓
檑	木󰀙田󰀝
獒	主󰁡夂丶
殂	一夕󰀐一
辁	车人王󰀝
戗	人⺋戈󰁶
戤	乃又皿戈
甏	士口䒑丶
攴	󰀥又󰁧
昃	日厂人󰁧
昴	日󰁚丿卩
胲	月亠ㄥ人
脞	月人人土
脬	月爫子󰀝
脘	月宀二儿
腠	月三人大
腽	月日皿󰀝
腭	月口口ㄅ
膣	月宀八土
旆	方󰅎冂丨
煺	火彐󰀖辶
礓	石一田一
礤	石艹󰁯小
盱	目一󰀛󰀢
眍	目匚乂󰁶
眭	目土土󰀝
眵	目夕夕󰁶
鹎	白丿十一
瘅	疒丷󰅐󰀵
皲	冖车󰅌又
虍	󰅋七󰁫
酲	西一口王
鹾	󰀥囗乂工
跫	工几丶󰁾
跽	口止己心
踔	口止󰀥十
躔	口止广土
躜	口止丿贝
貅	豸亻木󰁶
觖	⺈月丨人
雩	󰀙二ㄅ󰀅
龆	止人凵口
隹	亻󰁷󰀝
鍪	󰁻乛亅金
鏊	主󰁡夂金
鲒	󰁢󰀞士口
鲩	󰁢󰀞宀儿
鲶	󰁢󰀞人心
鳜	󰁢󰀞厂人
鳟	󰁢󰀞丷寸
饔	亠󰁲丿󰀖
黪	󰀹土灬彡
鼽	丿目田九
卮	⺁一⺋󰁫
匚	匚一󰄃
劁	亻󰁷灬刂
侔	亻厶丿󰀟
傺	亻󰁯二小
儇	亻罒一󰀔
佥	人一󰀧一
勹	勹丿𠃌
亠	亠丶一
谘	讠冫⺈口
谠	讠⺌冖儿
墼	車凵几土
圮	土己󰁀
垤	土一厶土
垲	土山己󰁀
垴	土亠乂凵
埙	土口贝󰁶
埯	土大日乚
埤	土白丿十
堋	土月月󰀝
埭	土󰁬氺󰁶
墚	土氵刀木
艹	艹一丨丨
芏	艹土󰀘
芴	艹勹󰁤󰁣
芤	艹孑乚󰀅
茇	艹又丶
苠	艹󰁃󰁐弋
茼	艹冂一口
莛	艹丿士廴
茺	艹亠厶儿
荭	艹纟工󰀘
萁	艹艹三八
菝	艹扌丶
萆	艹白丿十
菸	艹方人󰁦
菀	艹宀夕⺋
葙	艹木目󰀘
蒈	艹󰁴匕白
葸	艹田心󰁧
蓠	艹亠乂厶
蒡	艹亠丷方
彡	彡丿丿丿
犭	犭ノ丿丿
夂	夂丿乛󰂃
饣	⺈󰁐󰀅
饫	⺈󰁐丿大
庋	广十又󰀦
廒	广主󰁡夂
忄	忄丶丶丨
忭	忄亠卜󰁶
惝	忄⺌冂口
愀	忄禾火󰁶
慊	忄䒑󰁬󰁗
闼	门大辶󰀦
泐	氵阝力ノ
沭	氵木丶󰁶
潆	氵艹冖小
漤	氵木木女
漶	氵口口心
濡	氵󰀙丆〢
宀	宀丶丶乛
宓	宀心丿󰁣
褰	宀󰀀八󰀔
逄	夂󰀂丨辶
逑	一氺丶辶
逭	宀丨󰁃辶
遄	山丆冂辶
遘	󰀀冂土辶
彖	󰅂一󰀓󰁧
屦	尸彳米女
琊	王󰀂亅阝
珧	王儿󰀪󰁶
琏	王车辶󰁶
曛	日丿一灬
曜	日羽亻󰁷
曩	日亠口󰀔
牿	牜丿土口
犏	牜丶尸艹
毳	丿二乚乚
毵	厶大彡乚
氇	丿二乚日
攵	夂丿一󰂃
敫	白方夂󰁶
肟	月二ㄅ󰁀
肜	月彡ノ
肓	亠󰄃月󰀘
肷	月⺈人󰁶
胩	月󰀥一卜
胙	月𠂉丨二
胝	月󰁚󰀁丶
脎	月乂木󰁶
膪	月亠丷口
臌	月士口又
臁	月广䒑󰁗
飑	几乂勹巳
灬	灬丶丶丶
礻	礻󰁶丶丶
祜	礻󰁶古󰀝
禚	礻󰁶丷灬
恧	丆冂〢心
肀	󰁬丨󰀵
泶	󰀧冖水󰁧
砘	石一凵乚
砟	石𠂉丨二
硭	石艹亠󰄃
硇	石丿囗乂
硪	石丿扌丶
磉	石又又木
磴	石癶一䒑
瞀	󰁻乛亅目
罨	罒大日乚
钅	钅丿一󰁐
钆	钅乚󰁀
钭	钅󰁦十󰀢
钬	钅火󰁶
钶	钅丁口󰀝
铖	钅厂𠃌丶
铥	钅丿土厶
铩	钅乂木󰁶
铫	钅儿󰀪󰁶
铴	钅氵ㄋ󰁤
铽	钅弋心丶
锊	钅爫寸󰁶
锩	钅䒑大⺋
锼	钅臼丨又
镘	钅日罒又
镙	钅田ㄠ小
镢	钅厂䒑人
镩	钅宀八丨
镱	钅立日心
稂	禾丶彐󰀖
瓞	⺁厶󰂃人
鸫	󰀂小勹一
鸸	丆冂〢一
鸹	丿古勹一
鹇	门木勹一
鹋	艹田勹一
鹛	󰁅目勹一
鹨	羽人彡一
鹱	勹丶ㄅ又
疒	疒丶一󰀞
疠	疒一󰁡󰀏
痄	疒𠂉丨二
痃	疒亠ㄠ󰀦
痖	疒一󰅊一
瘗	疒一丷土
瘕	疒󰁃丨又
瘙	疒又丶虫
瘛	疒三丨心
癀	疒󰁺由八
瘳	疒羽人彡
癔	疒立日心
穸	宀八夕󰁧
窀	宀八一乚
窆	宀八丿之
窭	宀八米女
衤	衤󰁧丶丶
衲	衤󰁧冂人
裰	衤󰁧又又
耥	三󰅇⺌口
虮	虫几󰁀
虺	一儿虫󰀦
虼	虫𠂉乙󰁀
蚨	虫二人󰁶
蚧	虫人󰀯󰀢
蚰	虫由󰀝
蛳	虫リ一丨
蛞	虫丿古󰀝
蜣	虫䒑󰀠乚
蜱	虫白丿十
螋	虫臼丨又
蝓	虫人一刂
螓	虫三人禾
螯	主󰁡夂虫
螅	虫丿目心
螭	虫亠乂厶
螗	虫广󰁬口
蟪	虫一日心
蟮	虫䒑󰀟口
蠓	虫艹冖󰀓
蠛	虫艹罒丶
蠼	虫目目又
笫	⺮丿ㄅ丿
笮	⺮𠂉丨二
笳	⺮力口󰀘
笾	⺮力辶󰁧
箦	⺮主贝󰁧
箝	⺮扌艹二
篚	⺮匚丨三
篪	⺮⺁󰅋几
簖	⺮米󰄃斤
籀	⺮扌󰁚田
舁	臼廾󰀬
舴	丿󰁪𠂉二
艏	丿󰁪䒑目
粢	冫⺈人米
綮	丶尸夂小
趑	土󰁾冫人
酎	西一寸󰁶
酴	西一人木
醣	西一广口
鲭	󰁢󰀞主月
鲰	󰁢󰀞耳又
鞔	廿口十󰁜
骱	󰀾月人󰀯
髂	󰀾月宀口
髌	󰀾月宀八
魃	白󰁜厶丶
魈	白󰁜厶月
魍	白󰁜厶󰄃
髟	󰀍厶彡ノ
麈	广󰁃〢王
鼬	臼󰁐󰁦由
丨	丨丨〇〇
丿	丿丿〇〇
乇	丿七󰁫
丶	丶丶〇〇
刂	刂丨亅
冂	冂丨𠃌
亻	亻丿丨
冫	冫丶󰀞
冖	冖丶乛
讠	讠丶󰁉
卩	卩𠃌丨
阝	阝󰁋丨
廴	廴󰁌󰂃
凵	凵󰄃丨
厶	厶ㄥ丶
葜	艹三丨大
扌	扌一亅󰀞
辶	辶丶󰁋󰂃
钰	钅王丶󰁶
铞	钅口冂丨
锍	钅亠厶󰀸
锓	钅彐冖又
镪	钅弓口虫
稆	禾口口󰀝
鸪	古勹丶一
痂	疒力口󰀌
袷	衤󰁧人口
裉	衤󰁧彐󰀖
疋	乛󰁾󰀦
蠊	虫广䒑󰁗
筇	⺮工阝󰀬
筻	⺮一日乂
艉	丿󰁪尸乚
糸	ㄠ小󰁧
鬏	󰀍厶彡火
訫	言心󰁶
曈	日立曰土
殑	一夕古儿
叡	󰀥冖一又
汏	氵大󰁶
栢	木丆日󰀝
咗	口工󰀝
恆	忄一丨一
亜	一口〢一
喆	士口士口
嗱	口人一手
喎	口ㄇ󰁈口
暁	日十艹儿
冧	冖木木󰁧
涙	氵丶尸大
恵	一由心󰁧
兲	王八󰁧
穫	禾艹亻又
冏	冂八口󰀌
羙	丷王火󰁧
楽	白󰀪木󰁧
燊	火火火木
囧	囗八ㄇ󰁫
啛	口一󰁬女
円	冂丨一󰀌
槑	口木口木
秂	禾人󰁧
関	門䒑大󰀦
啲	口白勹丶
実	宀三人󰁧
荳	艹一口䒑
覚	󰀧冖目儿
諨	言一口田
犳	犭󰁥勹丶
羨	丷王氵人
垚	土土土󰀘
菈	艹扌立󰀘
琍	王禾刂󰀢
尒	人小󰁧
嗰	口亻囗古
佺	亻人王󰀝
嚟	口禾勹氺
恏	女子心󰁧
煋	火曰丿
啱	口山石󰀝
滘	氵冖八口
眞	匕目󰄃八
潵	氵󰁺月攵
伝	亻二厶󰁶
冚	冖山󰀬
児	丨日儿󰀅
偲	亻田心󰁶
粿	米曰木󰁶
複	衤󰁧𠂉夂
沢	氵尸󰂃󰁶
咲	口䒑大󰁶
攞	扌罒糹󰁷
妳	女⺈小󰁶
囖	口⺮罒󰁷
喺	口亻丿小
揾	扌曰皿󰀝
吇	口子󰀝
蹟	口止貝
啫	口土丿日
翀	羽口丨󰀢
錵	釒艹亻ヒ
堃	方方土󰀘
冇	冂󰀅
玹	王亠幺󰁶
搵	扌囗人皿
魜	󰁢灬人󰁶
尛	小小小󰁧
朲	木人󰁶
瓑	王厂禾止
衹	衤󰁧󰁚󰀁
様	木丷王水
唸	口人丶心
菓	艹曰木󰁧
屌	尸口冂丨
緈	糹土䒑十
尓	𠂉小󰁧
珺	王󰁬丿口
祂	礻󰁶也󰁀
嬛	女罒一󰀔
瞓	目言川󰀢
哋	口土也󰁀
媞	女曰一󰁾
佢	亻匚󰁃󰀝
孖	孑子󰀝
峯	山夂三丨
吔	口也󰁀
囍	士口䒑口
惢	心心心󰁧
託	言丿七󰁀
呎	口尸󰂃󰁶
籹	米女󰀝
〇  〇〇〇〇