礼	二小乚󰁀
邟	亠几阝󰀢
溥	氵一月寸
娘	女丶彐󰀖
肟	月二ㄅ󰁀
癤	疒⺮󰁮卩
亥	亠ㄥ丿人
㨘	扌小丿目
遟	尸辛辶󰀵
幥	冂丨⺌手
橘	木󰁻乛口
皤	白丿米田
蚤	又丶虫󰁧
㩘	扌丷王丶
乥	丿丷乙󰀅
馘	䒑丿目󰀞
覘	󰀥口目儿
痤	疒人人土
感	厂一口心
妘	女二厶󰁶
严	一󰅊厂󰁣
㦘	白方攵心
駘	󰀋灬厶口
烟	火囗大󰁶
蘤	艹白爫灬
姘	女䒑廾󰀢
惟	忄亻󰁷󰀝
㷥	火火了一
䃟	石󰁺月攵
㾥	疒上小又
坤	土日丨󰀢
侥	亻弋丿儿
礘	石曰幺灬
杤	木一󰁡󰁥
龥	人一口貝
蝤	虫丷西一
㥘	忄土厶丶
䅟	禾厶大彡
垤	土一厶土
枤	木犬󰁶
瞤	目門王󰀝
螤	文虫曰人
酟	西一󰀥口
囤	囗一凵乚
伥	亻丿七󰂃
㢘	广䒑󰁬灬
题	日一󰁾贝
舟	丿󰁪󰀦
缥	纟覀二小
戟	十日十戈
以	󰁐丶人󰁶
廥	广人一日
㜤	女覀早󰀢
軥	車勹口󰀝
黥	󰀹土灬小
滥	氵〢𠂉皿
營	火火冖口
埘	土日寸󰁶
挫	扌人人土
㾙	疒乂丨
䠤	口止口十
龙	ヒ丶󰀦
𠂇	一丿
猫	犭ノ艹田
辙	车亠厶夂
柤	木󰀐一󰀝
埤	土白丿十
俙	亻乂丨
㿙	疒罒罒大
鍫	禾火金󰀘
这	文辶󰀦
矤	弓𠂉大󰁶
㡘	冂丨䒑八
䡘	車勹田󰀝
塘	土广󰁬口
桘	木丿󰃧󰀝
碤	石艹ㄇ大
袤	亠󰁻乛󰀔
颤	亠囗口贝
䡤	土丿日車
㡤	冂丨业未
桤	木山己󰁀
堘	土丷夫土
衤	衤󰁧丶丶
砘	石一凵乚
鋫	禾刂金󰀘
㛘	女十冖子
溙	氵三人氺
盘	丿󰁪皿󰀘
䈫	⺮糹冂人
庙	广由󰀌
舫	丿󰁪方ノ
鈫	釒文󰁶
㚘	夫夫󰁶
磤	石⺁彐又
棤	木󰁺日󰀝
嚘	口丆󰀐夂
䉫	⺮禾勹氺
隘	阝䒑八皿
裤	衤󰁧广车
㼙	冂丨一丶
伙	亻火󰁶
冫	冫丶󰀞
憫	忄門文󰁶
缙	纟一󰅊日
蝘	虫匚曰女
馤	禾日曰󰄃
㜘	女虍󰀐一
凫	勹丶ㄅ几
余	人一木󰁧
燫	火广䒑八
朘	月厶八夂
霘	󰀙氵冂口
蜘	虫𠂉大口
闘	門一口寸
焫	火艹冂人
脫	月八口儿
嶙	山米夕丨
涙	氵丶尸大
㗘	口甫寸󰁶
䨤	󰀙由辶󰁧
﨤	乃󰂃辶󰀦
鷙	土䒑十灬
腫	月丿一土
秤	禾一丷十
槤	木車辶󰁶
巙	山䒑丿夂
䧤	阝业䒑夫
㷙	火䒑月刂
陘	阝一巛工
噘	口厂䒑人
檤	木䒑丿辶
窤	宀八曰󰁴
肫	月一凵乚
㪤	日艹󰀟攵
䪤	丨三丨田
𡗗	三人󰀦
阘	门曰羽󰀌
惫	夂田心󰁧
嘘	口󰅋七一
蘘	艹亠口󰀔
烫	氵ㄋ󰁤火
乙	乙乙〇〇
㹙	牜火火目
蓘	艹六厶󰀔
鬤	󰂞彡亠󰀔
擘	尸口立手
笤	⺮刀口󰀘
䬤	尸人丶艮
哘	口彳一丁
㓘	几一夕丶
髤	󰂞彡木󰁧
聫	耳幺幺大
糙	米丿土辶
撘	扌⺮人口
咘	口冂丨
䫤	冖日六貝
㒘	亻匚丨立
殤	一夕𠂉󰁤
畘	田冂土󰀝
认	讠人󰁶
鴙	𠂉大󰁟灬
㕘	厶厶厶小
䕘	艹人丶貝
室	宀一厶土
甘	艹二󰀌
浙	氵扌斤󰀢
锘	钅艹口
蔘	艹厶厶彡
㭤	木󰁠一󰀝
孤	孑⺁厶󰂃
䵙	禾人氺夕
鏘	釒爿󰁝寸
珘	王丿󰁪󰁶
菘	艹木八厶
宙	宀由󰀘
末	一木󰀦
㜫	女彳山攵
䏘	月匚儿󰁀
鎘	釒一口丨
诤	讠⺈󰁬亅
睫	目一󰁬󰁾
毙	󰁴匕一匕
寤	宀󰄃丨口
䯙	󰀾月甫󰁶
㯙	木亠厶攵
粤	丿囗米ㄅ
蚫	虫勹巳󰁀
鲤	󰁢󰀞日土
㑘	亻戈廾󰀢
䑘	臼⺶工󰀝
员	口贝󰁧
氙	󰅎⺄山󰀬
萘	艹大二小
籙	⺮釒󰁭氺
鐘	釒立曰土
䱙	󰁢灬上又
㱤	一夕木斤
曫	言糹糹日
吘	口𠂉十󰀢
㴤	氵木丶王
洤	氵人王󰀝
瘫	疒又亻󰁷
䴤	󰁙󰁴匕
嘫	口󰁝犬灬
蘫	艹氵匚皿
鋘	釒口一大
㳤	氵廾灬󰁶
癫	疒十󰀣贝
晫	日󰀥早󰀢
噫	口立日心
䫙	十艹木貝
銘	釒夕口󰀝
芘	艹󰁴匕󰀅
㬙	日爫丿灬
䶤	止󰀆󰀾月
嶤	山土土儿
涤	氵夂木󰁶
笙	⺮丿主󰀘
荘	艹丬士󰀘
閫	門囗木󰀦
㭙	木土寸󰁶
嗫	口耳又又
䭙	人良󰀄日
痫	疒门木󰀦
浤	氵宀厶
闫	门三󰀌
茘	艹刀刀刀
甫	一月丨丶
覙	⺈小目儿
妙	女小丿ノ
渤	氵十冖力
㸤	辛丿丨辛
䇘	⺮一彑󰀘
鈘	釒十又󰁶
膘	月覀二小
熘	火󰁚丶田
敫	白方夂󰁶
姙	女亻丿士
䧙	阝山人⺗
㕫	口方󰁥
香	禾日󰀘
咫	尸󰂃口八
托	扌丿七󰁀
牘	丿丨一貝
艘	丿󰁪臼又
㺤	犭󰁥人󰀞
交	亠八乂󰁧
战	󰀥口戈󰁶
婙	女⺈󰁬亅
舘	人干口󰃧
爘	火󰀥夕艮
乤	一卜乙󰀅
㓫	大一廾刂
钫	钅方ノ
䢙	貝辶󰀦
弤	弓󰁚󰀁丶
㼤	三丨刀丶
輤	車月󰀝
郘	口口阝󰀢
漤	氵木木女
碙	石冂䒑山
廤	广車口匕
令	人丶󰁻󰁧
㣙	彳由󰀝
飙	大丶大乂
裙	衤󰁧󰁬口
炘	火斤󰀢
滤	氵󰅋七心
㾤	疒宀八工
侤	亻土丿ㄅ
厫	厂󰁡攵
慘	忄厶厶彡
玫	王夂󰁶
辤	爫冖又辛
鎫	釒丿ㄇ夂
㥙	忄口丨心
彤	󰀼亠彡ノ
䏫	月亻木󰁶
罤	罒丷弓丿
揫	禾火手󰀬
鄘	广󰁬月阝
轤	車虍田皿
鍪	󰁻乛亅金
獪	犭󰁥人日
螙	木虫虫󰁧
柙	木甲󰀢
埙	土口贝󰁶
俤	亻丷弓丿
㟙	山󰁺日󰀝
耘	三󰅇二厶
竫	立⺈󰁬亅
髫	󰂞彡刀口
垙	土⺌一儿
捪	扌󰁚󰀁日
㬫	廿口丬日
䍪	⺶一木󰁶
翚	羽冖车󰀬
聘	耳由一ㄅ
遘	󰀀冂土辶
侚	亻勹日󰀝
㡙	冂丨丿匕
抪	扌冂丨
嫫	女艹日大
鈪	釒厂⺋󰁀
蛙	虫土土󰀝
㠙	山󰁸冖󰀓
䪫	立日一工
堙	土覀土󰀝
濚	氵火火木
艪	丿󰁪󰁢日
隙	阝小日小
㩫	扌斤斤貝
爪	⺁丨󰂃󰀦
曙	日罒土日
婫	女曰󰁴匕
会	人二厶󰁧
醪	西一羽彡
膪	月亠丷口
㨫	扌〢𠂉皿
樫	木匚丨土
罚	罒讠刂󰀬
䉪	⺮田田田
剪	䒑月刂刀
自	丿目󰀌
霙	󰀙艹ㄇ大
㧫	扌丆冂〢
坙	一巛土󰀘
亚	一󰅊一󰀌
秫	禾木丶󰁶
镫	钅癶一䒑
㻚	王月月󰀝
䇪	⺮一厶土
妫	女丶丿丶
滚	氵六厶󰀔
绚	纟勹日󰀝
酪	西一夂口
疙	疒𠂉乙󰁫
褫	衤󰁧⺁几
喙	口彑󰀓󰁶
湚	氵丿幺乚
业	󰅊一󰀌
㥫	忄󰁸日󰀝
邪	󰀂亅丿阝
涚	氵丷口儿
士	士一丨一
肪	月方ノ
炪	火凵山󰀢
㤫	月心󰁧
䖙	匚丨󰁃几
阙	门䒑凵人
墫	土丷西寸
昙	日二厶󰁧
烪	火䒑大󰁶
被	衤󰁧󰅌又
䣫	西一十又
㶚	氵覀廿月
铙	钅弋丿儿
衫	衤󰁧彡ノ
瓙	王士乛灬
擙	扌丿ㄇ大
㢫	弓山󰀢
䃪	石亠囗一
聪	耳丷口心
钙	钅一󰀥ㄅ
栫	木丨子
砫	石丶王󰀝
填	土十󰀣八
䴚	󰀥囗󰁘几
㓙	文凵󰀵
留	󰁚丶刀田
教	土丿孑夂
镙	钅田幺小
蕙	艹一日心
䠫	口止耳乑
咙	口ヒ丶
㠫	工几丶夫
攙	扌⺈口丶
甙	弋艹二丶
螫	土󰁖夂虫
鞫	廿󰀜勹言
㟫	山白水󰁶
岚	山几乂󰁧
䲚	󰁢灬木貝
錪	釒ㄇ󰁺八
茪	艹⺌一儿
翤	口冂艹羽
㳚	氵戈人󰁶
䔙	艹釒勹丶
垫	扌九丶土
靪	廿󰀜丁󰀢
睪	罒土䒑十
莙	艹󰁬丿口
坪	土一丷十
杪	木小丿ノ
㱚	一夕月󰀝
䱚	󰁢灬󰁭氺
軫	車人彡󰁥
瑙	王巛丿乂
鑙	釒禾日
䮚	󰀋灬土夂
㑙	亻耳乚󰁀
暪	日廿冂󰂃
呙	口冂人󰁧
盪	氵曰一皿
萙	艹木冖󰁜
鐙	釒癶一䒑
㛪	女大日乚
享	󰁸子󰀘
囪	丿囗󰁤󰂃
曪	日罒糹󰁷
狙	犭ノ󰀐一
昪	曰厶廾󰀬
嬚	女广䒑八
䋙	糹耳󰀝
鹫	󰁸小一
苙	艹立󰀘
㬚	日亠厶攵
渫	氵廿󰄃木
筚	⺮󰁴匕十
䊙	石一廾米
噪	口口口木
芙	艹二人󰁧
鸫	󰀂小勹一
㙪	土士冖䒑
巫	工人人󰀦
䍙	罒𠂉母󰁧
獙	犭󰁥㡀攵
淫	氵爫丿士
骚	󰀊󰀞又虫
薪	艹立木斤
㪚	󰁺日攵󰁶
䗪	广廿灬虫
嗪	口三人禾
涫	氵宀丨󰁃
竚	立宀丁󰀢
茙	艹戈󰁣
闪	门人󰀦
饫	⺈󰁐丿大
藙	艹立󰀓又
痙	疒一巛工
渚	氵土丿日
㶫	大丷火󰁧
镪	钅弓口虫
紫	止匕ㄠ小
贫	八刀贝󰁧
啪	口扌白󰀝
敪	又又又攵
㕪	口冖󰁜󰁀
䩚	廿󰀜󰁚丶
䇹	⺮󰁬丿口
㨺	扌廿冂丶
⺻	󰁬丨一󰀌
㺻	王一冂丨
亻	亻丿丨
固	囗古󰀌
溻	氵日羽󰀝
鳫	厂󰁟灬󰀦
蛺	虫大人人
麻	广木木󰀦
撪	扌厶大車
峫	山󰀄亅阝
覚	󰀧冖目儿
禚	礻󰁶丷灬
䦚	門丿古󰀌
㒪	人匚丨󰀓
㻻	王󰁸孑攵
嚺	口罒䒑辶
任	亻丿士󰀝
鈙	釒󰀥又󰁶
暺	日口口十
黻	󰅊一丷丶
蚺	虫冂土󰀝
则	贝刂󰀢
戙	冂一口戈
爙	火亠口󰀔
舙	丿古丿古
㓪	丶󰁮刀󰁥
䈙	⺮糹寸󰁧
伻	亻一丷十
弻	弓一囗弓
㝺	䒑󰁬〢丿
蝺	虫丿口丶
鼻	丿目田󰀯
漻	氵羽人彡
睺	目亻ユ大
多	夕夕󰁧
䃙	石󰁙󰁴匕
㐪	一凵人󰀦
郙	甫阝󰀢
胙	月𠂉丨二
烙	火夂口󰀝
搪	扌广󰁬口
场	土ㄋ󰁤ノ
䜺	一口䒑日
㽻	疒十又󰀦
霺	󰀙彳山攵
轻	车ス工󰀝
眺	目儿󰀪󰁶
机	木几󰁀
䰫	白󰁜厶儿
呪	口口儿󰁀
㑪	亻文󰀳󰀝
肙	口月󰀘
邙	亠󰄃阝󰀢
楚	木木乛󰁾
炙	󰁝火󰁧
逹	土䒑十辶
基	艹三八土
澻	氵䒑󰀓辶
瀹	氵人一艹
蟺	虫亠囗一
㟺	山󰀻女󰀘
侻	亻丷口儿
㯫	木虍一󰀓
兙	古儿十󰀵
䅙	禾日󰁴匕
煙	火覀土󰀝
梚	木⺈口󰁜
颚	口口二贝
诫	讠戈廾󰀢
鞺	廿󰀜⺌土
恹	忄厂大丶
忻	忄斤󰀢
聹	耳宀心丁
翻	丿米田羽
䁹	目尸口辛
㞺	山𠂉大󰁧
㮫	木宀三口
䮫	󰀋灬󰀻女
壚	土虍田皿
揪	扌禾火󰁶
磚	石一曰寸
裚	扌斤亠󰀔
飚	几乂火火
顺	川丆贝󰁶
硺	石一󰀓丶
霪	󰀙氵爫士
轫	车刀丶󰁶
罫	罒土土卜
氚	󰅎⺄川󰀬
彫	󰀼土口彡
䏙	月冖󰁜󰁀
㽫	亠󰁲丿田
鏹	釒弓口虫
菹	艹氵󰀐一
珹	王戊𠃌󰁀
揹	扌丬匕月
叹	口又󰁶
䏹	月目儿󰁀
㰺	󰁃丨二人
㣺	忄丶󰀦
䄹	禾人丿十
壺	士冖󰀚一
棺	木宀丨󰁃
磺	石󰁺由八
脹	月󰀍󰀖󰁶
鄹	耳又乑阝
㢺	弓立女󰀝
兹	䒑ㄠㄠ󰁧
䢺	凵山阝󰀢
煹	火󰀀冂土
梺	木木一卜
酹	西一爫寸
腹	月𠂉日夂
㥺	忄土厶皿
楺	木󰁻乛木
祺	礻󰁶艹八
䂹	石󰁝火󰁶
奺	女ク󰂃󰁶
肹	月八一ㄅ
邹	⺈彐阝󰀢
㤺	忄亠󰄃󰀸
烹	󰁸了灬󰁧
惹	艹口心
夺	大寸󰁧
䤺	釒石斤󰀢
郹	目犬阝󰀢
褺	土䒑十󰀔
秺	禾宀丿七
船	丿󰁪几口
駺	󰀋灬丶艮
㧺	扌水日󰀝
䈹	⺮宀亻日
刹	乂木刂󰀢
槺	木广󰁬氺
艹	艹一丨丨
特	牜土寸󰁶
馺	󰀋灬乃󰂃
䉹	⺮󰀙口人
㦺	厂二󰀖戈
批	扌󰁴匕󰁀
妺	女一木󰁶
騚	󰀋灬䒑刂
赫	土󰁖土󰁖
燙	氵曰一火
熹	士口䒑灬
嵫	山䒑ㄠㄠ
䔪	艹大乂乂
㵫	氵子孑日
㩺	󰁴󰁴十又
䆹	宀八立土
㬹	月⺈󰁬亅
䍸	⺶甫寸󰁶
卸	󰅎止卩󰀢
捸	扌󰁬氺󰁶
笹	⺮廿󰄃󰀅
荸	艹十冖子
鍸	釒古月󰀝
淹	氵大日乚
巹	了󰀩一己
䖸	丿扌󰁒虫
㷹	火艹󰀥早
閸	門一󰀚一
跹	口止丿辶
疸	疒日一󰀌
䪹	丆卜󰀞貝
媹	女󰁚丶田
㪹	󰀻女󰁦十
苸	艹丿丷󰀛
鋸	釒尸古󰀝
拸	扌夕夕󰁶
狸	犭ノ日土
㭹	木弓亠幺
孹	尸口辛子
䌸	纟二󰁓丶
猸	犭󰁥󰁅目
歹	一夕󰀦
錸	釒木人人
茸	艹耳󰀘
㑸	亻古丁口
䑸	丿󰁪宀小
鑸	釒田田土
呸	口丆卜一
摸	扌艹日大
瑸	王宀丘八
葸	艹田心󰁧
劸	土土力󰁥
䊸	糹二ㄅ󰁀
㫹	日⺁󰁃斤
髹	󰂞彡亻木
芸	艹二厶󰁧
竹	𠂉丨𠂉亅
抸	扌丿之󰁶
㮹	木一厶攵
䏸	月五口󰀝
鏸	釒一曰心
箹	⺮糹勹丶
讹	讠亻ヒ󰁀
容	宀八人口
揸	扌木日一
䱹	󰁢灬⺶工
㐸	亻⺈人󰁶
鐸	釒罒土十
搸	扌三人禾
屹	山𠂉乙󰁀
豹	豸勹丶󰁶
籹	米女󰀝
㴹	氵米辶󰁶
䴹	木人人木
啸	口󰁬󰅏󰀯
洹	氵一日一
畸	田大丁口
蕸	艹󰁃丨辶
镸	󰂞一丨丶
栺	木匕日󰀝
堺	土田八󰀯
䠺	丿󰀽三口
㠺	冂丨小丿
㲹	氵几󰁀
油	氵由󰀝
粹	米亠人十
䓸	艹女女干
岹	山刀口󰀝
蓸	艹一ㄇ日
铸	钅三丿寸
㵹	氵山艹大
唸	口人丶心
䔸	艹犬犬犬
甸	勹田󰀌
浹	氵大人人
锸	钅丿十臼
蔸	艹白󰁚儿
㙸	土亻业夫
䙸	目儿寸󰀦
帹	冂丨立女
晸	曰一止攵
癸	癶一大󰁧
踹	口止山〢
鸹	丿古勹一
㳹	氵木王󰀝
糹	糹ㄥㄥ丶
撸	扌󰁢一日
咸	厂一口丶
䳹	󰁟灬宀又
钸	钅冂丨
蒸	艹了󰀩灬
嶹	山士乛寸
涹	氵禾女󰀝
㶹	火工水󰁶
䗸	亠󰁲丿虫
闸	门甲󰀵
痸	疒𠂉一刂
藸	艹一󰀓日
乹	十早乚󰁀
㘸	一夕匕土
昸	日夂󰁦󰁶
幹	十早人干
蘸	艹西一灬
瘸	疒力口人
阸	阝丶尸乙
渺	氵目小丿
嗹	口車辶󰁶
为	丶丿𠃌丶
㗹	口亻󰁷心
鸺	亻木勹一
踺	口止󰁬廴
痹	疒田一󰀯
櫺	木󰀙口口
猹	犭ノ木一
茹	艹女口󰀘
錹	釒止月󰀝
㫺	人人人日
䌹	纟冂口󰀝
嫺	女門月󰀝
獹	犭󰁥虍田
捹	扌大十廾
鍹	釒宀一一
荹	艹止󰀤󰁣
㪺	大目目十
卹	丿皿卩󰀢
䪺	土厶丆貝
芹	艹斤󰀬
銹	釒禾乃󰁥
抹	扌一木󰁶
筺	⺮匚王丶
䭺	󰀋灬亠几
孺	孑󰀙丆〢
㭺	木大日乚
鋹	釒󰀍󰀖󰁶
苹	艹一丷十
笺	⺮二󰅅丶
欺	艹三八人
勹	勹丿𠃌
䬺	人良羊󰀢
㬺	月丷夫丨
鐹	釒ㄇ󰁈辶
䀃	一󰀓皿󰀘
倃	亻夂卜口
怃	忄二󰁜󰁀
搹	扌一口丨
考	土丿一ㄅ
诺	讠艹口
㐹	亻气󰁀
䯺	󰂞彡󰁚口
鑹	釒宀八󰁒
摹	艹日大手
宺	宀口一󰀸
论	讠人匕󰁀
箺	⺮三人日
䮺	󰀋灬󰀴󰀳
㮺	木一口口
鎹	釒䒑大辶
玹	王亠幺󰁶
莹	艹冖王丶
屺	山己󰁀
決	氵ユ人󰁶
㱺	一夕虍皿
䎹	丿米耳󰀘
僃	亻艹勹用
䃃	石冂䒑󰄃
郃	人一口阝
胃	田月󰀘
烃	火ス工󰀝
惃	忄日󰁴匕
儃	亻亠囗一
愃	忄宀一一
焃	火土󰁖󰁶
脃	月⺈巴󰁀
䳺	人丶乛灬
峺	山一曰乂
改	󰁁夂󰁶
甹	由一ㄅ󰀅
蔹	艹人一夂
锹	钅禾火󰁶
㕹	口又丶
䁃	目󰀔󰁶
啹	口尸古󰀝
恃	忄土寸󰁶
粺	米白丿十
聃	耳冂土󰀝
鲺	󰁢󰀞⺄虫
蕹	艹亠󰁲󰁷
䂃	目爫罒寸
傃	亻幺小
肃	󰁬󰅏󰀯󰀵
邃	宀八䒑辶
䵺	土目󰁕󰁈
咹	口宀女󰀝
蒹	艹䒑󰁬󰁗
鵺	亠亻夂灬
臃	月亠󰁲󰁷
燃	火󰁝大灬
懃	廿口心
凃	冫人一朩
瓹	口月一丶
洺	氵夕口󰀝
哹	口爫子󰀝
䓹	艹人丶艮
鴺	一弓人灬
贺	力口贝󰁧
醃	西一大乚
㘹	止匕土󰀘
䘹	衤󰁧亠十
嘹	口大丷小
淺	氵戈戈󰁶
瘹	疒釒勹丶
蘹	艹忄亠󰀔
阹	阝土厶󰁶
釃	西一一匕
䙹	一廾目儿
㶺	火一大口
涺	氵尸古󰀝
煃	火大土土
䅃	工几丶禾
趺	口止二人
癹	癶几又󰁧
鶺	󰀪人月灬
鄃	人一月阝
喹	口大土土
膃	月囗人皿
㖹	口八刀皿
乺	⺁󰁃斤乙
䆃	䒑丿目禾
閹	門大曰乚
疹	疒人彡󰀏
薹	艹士口土
酃	󰀙口口阝
㜸	艹丿󰃧女
役	彳几又󰁶
佹	亻⺈厂⺋
罹	罒忄亻󰁷
朸	木力󰁥
霸	󰀙廿󰀜月
轹	车丿󰄃小
抃	扌亠卜󰁶
犃	牜立口󰀝
䊃	米几一丨
劃	󰁬土田刂
芃	艹几丶󰁧
銃	釒亠厶儿
亹	亠󰀗ㄇ一
囸	囗一止󰀌
㛸	女士口䒑
蛸	虫⺌月󰀝
雸	󰀙甘󰀘
溹	氵十冖小
相	木目󰀝
剃	丷弓丨刂
䉃	⺮爿󰁝寸
牃	爿廿󰄃木
扃	丶尸冂口
鉃	釒𠂉大󰁶
艃	丿󰁪曰土
馸	󰀋灬斤󰀢
匃	勹人󰄃󰁫
焿	火广󰁬人
愿	厂白小心
儿	儿丿乚
䦸	门ㄇ一丶
㦸	󰀥早戈󰁶
猃	犭ノ人一
范	艹氵⺋󰀅
錃	氵皮金󰀘
㝸	小白儿󰀅
伹	亻󰀐一󰀝
弹	弓丷曰十
漹	氵一止灬
睸	目󰁅目󰀝
輹	車𠂉日夂
靸	廿󰀜乃󰂃
狃	犭ノ󰁈二
拃	扌𠂉丨二
勃	十冖孑力
䋃	糹毛󰁀
鋃	釒丶艮󰁶
苃	艹又󰁧
核	木亠ㄥ人
堸	土几丿虫
蠸	虫艹口󰁷
砸	石匚冂丨
䠸	丿󰀽三ㄅ
㠸	冂丨夫󰁶
厃	⺈厂󰁣
掃	扌彐冖丨
䎃	冂土羽󰀝
鎃	釒氵⺁󰀕
玃	犭󰁥目又
莃	艹乂丨
顸	干丆贝󰁶
矸	石干󰀢
边	力辶󰀏
埸	土日勹󰁤
澹	氵⺈厂言
㟸	山白大十
侹	亻丿士廴
䍃	爫𠂉十凵
捃	扌󰁬丿口
千	丿十󰀵
荃	艹人王󰀘
獃	山一口犬
鍃	釒勹󰁤心
頸	一巛工貝
倿	亻立女󰀝
䀿	目扌斤󰀢
㚸	女𠃌一口
黹	󰅊一丷󰅏
蚸	虫斤丶󰁶
瀿	氵𠂉母小
吃	口𠂉乙󰁀
搃	扌丷口心
球	王一氺丶
萃	艹亠人十
鐃	釒土土儿
塸	土匚口口
桸	木乂丨
硸	石山厂干
衸	衤󰁧人󰀯
㡸	广𠂉丨二
䡸	車艹罒󰁐
揃	扌䒑月刂
參	厶厶厶彡
䏃	耳冖日六
鏃	釒方𠂉大
菃	艹氵匚󰁃
珃	王冂土󰀝
䒃	丿󰁪丿辶
咃	口亻也󰁀
㤸	忄土󰁖󰁶
㒃	亻󰀁二丶
夸	大二ㄅ󰀅
䆿	宀八爿木
熿	火󰁺由八
憿	忄白方攵
醿	西一广小
膿	月ㄇ󰁺󰀖
蒃	艹彑󰀓󰁧
钃	釒尸氺虫
撃	車几又手
璃	王亠乂厶
㑃	亻幺力󰁥
㣸	彳业󰀓
呃	口厂⺋󰁀
䑃	月艹冖󰀓
懿	士冖一心
磸	石丷西大
䇿	⺮木口󰀘
凿	󰅊一䒑凵
裸	衤󰁧日木
飸	口一ㄅ艮
瑃	王三人日
摃	扌工貝󰁶
鑃	釒羽亻󰁷
葃	艹日𠂉二
㔃	糹⺈巴刀
䔃	艹礻󰁶一
錿	釒虍几󰁀
许	讠𠂉十󰀢
猿	犭ノ土󰀔
挿	扌丿一丨
匿	匚艹口
锃	钅口王󰀝
㮸	木䒑大辶
唃	口⺈用󰀢
攃	扌艹󰁯小
甃	禾火一丶
蔃	艹弓口虫
哃	口冂一口
䓃	艹口巴󰀅
㓃	冖言丿七
㥸	󰁂󰀁田心
䥸	弓一八金
兿	䒑扌九厶
楸	木禾火󰁶
祸	礻󰁶口人
腿	月彐󰀖辶
酿	西一丶󰀖
铃	钅人丶󰁻
蓃	艹臼丨又
瓃	王田田田
擃	扌ㄇ󰁺󰀖
㖃	口⺁一口
䖃	艹口口
肿	月口丨󰀢
炿	火丿󰀼亠
邿	土寸阝󰀢
䂿	石水日󰀝
㨸	扌宀心山
悿	忄一大⺗
傿	亻一止灬
閃	門人󰀦
疃	田立日土
薃	艹氵󰁸口
喃	口十冂十
斃	㡀攵一匕
䕃	艹阝人󰂞
㕃	厂一廾󰀵
駸	󰀋灬彐又
烿	火󰀼亠彡
觸	⺈用罒虫
姸	女一干
惿	忄日一󰁾
㧸	扌󰁸了󰀢
䧸	古亻󰁷󰀝
镃	钅䒑幺幺
敃	󰁂󰀁攵󰁶
啃	口止月󰀝
蕃	艹丿米田
畃	曰丨勹丶
䘃	虫󰀹土土
嘃	口广󰁬丨
昃	日厂人󰁧
瘃	疒一󰀓丶
蘃	艹止止木
阃	门囗木󰀦
爿	󰄃丨丆󰀏
梸	木禾刂󰀢
墸	土艹土日
䈿	⺮冖日六
鈿	釒田󰀝
舿	丿󰁪大ㄅ
㘃	口艹心
䗃	虫戈戈󰁶
㗃	口󰁂󰀁日
穸	宀八夕󰁧
聿	󰁬󰀟󰀵
避	尸口立辶
㩸	扌田田亠
䩸	廿󰀜艹耳
婸	女曰一󰁤
恿	󰁻用心󰁧
闃	門目犬󰀦
藃	艹󰁸冂人
痃	疒亠ㄠ󰀦
旃	方𠂉󰀼亠
嗃	口󰁸冂口
暃	曰丨三三
皃	白儿󰀅
䚃	󰀥囗󰁃儿
嚃	口罒󰀫辶
蚃	󰁲丿虫󰁧
隃	阝人一刂
箿	⺮口耳󰀘
殿	尸󰁺八又
鍾	釒丿一土
访	讠方ノ
䐾	月罒土十
吾	五口󰀘
㯿	木巛囗󰁒
㚃	士冖乂䒑
噃	口丿米田
䙃	衤󰁧月
癃	疒阝夂主
晃	日⺌一儿
陃	阝一冂人
虃	艹氵人󰀞
掾	扌彑󰀓󰁶
玾	王甲󰀢
莾	艹大十廾
鎾	釒曰皿󰀝
㮿	木日艹󰀟
宿	宀亻丆日
䍾	一廾羽󰀝
㙃	土丘八󰁶
眃	目二厶󰁶
蜃	厂二󰀖虫
霃	󰀙氵冖󰁜
㜃	女亻言󰀝
链	钅车辶󰁶
圃	囗一月丶
瓾	禾女一丶
㭿	木日󰁚卩
䭿	󰀋灬丿夫
厾	⺄土厶󰀦
盃	丆卜皿󰀘
曃	日󰁬氺辶
囃	口亠人󰁷
䛃	言二儿󰁀
锾	钅爫一又
甾	巛田󰀘
蛃	虫一冂人
洿	氵大二ㄅ
哾	口丷口儿
䓾	艹氵小女
㓾	尸氺丿刂
㛃	三丨刀女
鞃	廿󰀜弓厶
瞃	目⺁十目
螃	虫亠丷方
垃	土立󰀝
枃	木勹冫󰀝
㞃	八人口丶
䞃	貝一厶攵
骿	󰀾月䒑廾
檿	厂曰月木
剾	匚口口刂
艾	艹乂󰁧
窿	宀八阝主
㫿	日亻󰁷󰀝
䌾	纟十冂十
蝃	虫又又又
睃	目厶八夂
靃	󰀙亻󰁷󰁷
䝃	一口䒑灬
㝃	孑⺈口󰁜
权	木又󰁶
坃	土二儿󰁀
銾	釒工水󰁶
婿	女乛󰁾月
橿	木一田一
穿	宀八󰀂丿
芾	艹一冂丨
䉾	丬匕米󰁧
㪿	凵丿凵斤
鏾	釒󰁺月攵
谿	爫幺大口
現	王目儿󰁀
堃	方方土󰀘
恂	忄勹日󰀝
灂	氵爫罒寸
聂	耳又又󰁧
遂	䒑󰀓辶󰀦
㩿	𠂉乙攵󰁶
䩿	廿󰀜十貝
韃	廿󰀜士辶
蟃	虫曰罒又
矃	目宀心丁
柃	木人丶󰁻
埃	土厶𠂉大
䟃	土󰁾厶彡
㟃	山𠃌一口
诿	讠禾女󰀝
鐾	尸口立金
搾	扌宀八二
琾	王田人󰀯
尿	尸水󰀦
䰿	󰁢灬𠂉也
㰿	爫幺大人
鶿	䒑幺幺灬
蕾	艹󰀙田󰀘
䃂	石日󰁴匕
境	土立日儿
㢃	广丶艮󰀦
袃	七刀亠󰀔
颃	亠几丆贝
梃	木丿士廴
碃	石月󰀝
㷿	火人一人
显	日󰅊一󰀘
瘾	疒阝⺈心
䘾	衤󰁧宀󰃧
嘾	口覀早󰀢
薾	艹一八乂
閾	門戈口󰀞
㡃	冂丨人󰀸
塃	土艹亠󰀸
䀂	宀女皿󰀘
瀂	氵󰁢灬日
怂	人人心󰁧
适	丿古辶󰀌
耂	土丿󰀏
㕾	小口匕󰀅
啾	口禾火󰁶
䕾	艹口口攵
畾	田田田󰀘
涿	氵一󰀓丶
迹	亠󰁖辶󰀦
翹	土土土羽
枸	木勹口󰀝
垸	土宀二儿
俹	亻一󰀚一
㿹	皮土羊辶
夃	乃又󰀦
慂	氵󰁻用心
煂	火廿󰀜󰀢
腂	月曰木󰁶
㤃	忄方󰁥
䤃	西一立日
㵿	氵白白白
䵿	士口䒑口
喾	󰀧冖丿口
斾	方𠂉冂丨
疾	疒𠂉大󰀦
壃	土一田一
䣃	𠂉一止阝
㣃	弓亠厶弓
邂	⺈用刀辶
肂	一夕󰁬󰀟
炂	火八厶󰁶
棃	禾勹丿木
鞸	廿󰀜曰󰀟
葾	艹夕⺋心
瑾	王廿口主
釂	西一爫寸
鑾	言糹糹金
燂	火覀早󰀢
覃	覀早󰀬
妃	女己󰁀
懂	忄艹丿土
㦃	忄立丿
䦃	钅艹土日
峿	山五口󰀝
放	方夂󰁶
㳿	氵亠厶木
䔾	艹扌日󰄃
璾	王󰀴󰀳󰀝
鄂	口口二阝
钾	钅甲󰀢
楃	木尸一土
儂	亻ㄇ󰁺󰀖
脂	月匕日󰀝
焂	亻丨攵火
䥃	釒冖亻󰁷
㥃	忄門󰀝
䲿	尸󰁴󰁟灬
㲿	氵广󰁥
摾	扌弓口虫
岿	山リ彐󰀘
鸿	氵工勹一
藾	艹木口貝
㱿	士冂一又
䒾	艹亠󰀔󰁧
屿	山一ㄅ一
撾	扌ㄇ󰁈辶
蘾	艹土亠󰀔
阾	阝人丶󰁻
駃	󰀋灬ユ人
膂	方𠂉󰀕月
秃	禾几󰀅
憂	丆󰀐冖夂
冂	冂丨𠃌
䧃	阝田󰀝
㧃	扌󰁐丨󰀢
㗾	口廿󰀜ヒ
痾	疒阝丁口
旾	一凵乚日
嗾	口方𠂉大
䗾	虫日幺灬
㩃	扌宀󰀀󰁦
刂	刂丨亅
䈂	⺮䒑廾󰀬
穃	禾宀八口
橃	木癶弓又
鈂	釒冖󰁜󰁀
㻺	厂禾禾丶
仺	人匚一󰀘
圹	土广ノ
朹	木九󰁀
眹	目䒑大󰁶
蜹	虫艹冂人
霹	󰀙尸口辛
㪃	丁口󰀥又
膸	月工辶
秹	禾亻丿士
檃	阝爫工木
窃	宀八七刀
䪃	廿󰀜󰁸攵
㧹	扌日一寸
苂	艹火󰁧
鋂	釒𠂉母󰁶
㫃	方人󰁶
犂	禾勹丿󰀟
抂	扌王󰀝
劂	厂䒑凵刂
䫃	厂二󰀖貝
佺	亻人王󰀝
彺	彳王󰀝
銂	釒丶丿丨
节	艹ㄗ󰀬
轺	车刀口󰀝
隹	亻󰁷󰀝
潺	氵尸子子
皹	皮冖車󰀢
㬃	日厶口火
䬃	几丿虫立
卂	⺄十󰀵
欃	木⺈口丶
㝹	小丿⺈丶
庺	广八厶木
人	人人人人
睹	目土丿日
杹	木亻ヒ󰁀
鬃	󰂞彡宀小
躺	丿󰀽三口
䭃	人良人心
㭃	木幺󰁶
挂	扌土土󰀝
孃	女亠口󰀔
選	巳巳󰁺辶
堹	土丿一土
根	木彐󰀖󰁶
灸	ク󰂃火󰁧
蠹	一口丨虫
茂	艹厂󰅅丶
筃	⺮囗大󰁧
㠹	冂丨人󰀯
俺	亻大日乚
它	宀匕󰀅
殃	一夕ㄇ大
㮃	木禾女󰀝
䮃	󰀋灬土厶
囹	囗人丶󰁻
伺	亻𠃌一口
㼺	广󰁬丨丶
雹	󰀙勹巳󰀅
蛹	虫󰁻月丨
盹	目一凵乚
漺	氵大乂乂
掂	扌广󰀥口
厂	厂一丿
䎂	羽勹巳󰁀
㯃	木木人氺
鞹	廿󰀜亠阝
瞹	目爫冖夂
螹	虫車斤󰀢
垹	土三丿阝
枹	木勹巳󰁀
㞹	山丁口󰀝
鎂	釒丷王大
诃	讠丁口󰀝
篃	⺮󰁅目󰀘
摂	扌耳󰀪󰁶
簃	⺮禾夕夕
调	讠󰀼土口
鑂	釒丿一灬
项	工丆贝󰁶
桹	木丶艮󰁶
倸	亻爫木󰁶
耸	人人耳󰀘
瀸	氵人人󰀞
㑂	亻一冂人
䰃	󰂞彡䒑业
呂	口丿口󰀘
䤹	釒宀火又
搂	扌米女󰀝
椹	木艹三󰄃
萂	艹禾口󰀘
腸	月日一󰁤
酸	西一厶夂
㐂	七七七󰀅
吂	󰄹丶一一
䐂	月󰁭氺󰁶
㤹	忄一氺丶
䯹	󰂞彡彐又
铂	钅白󰀝
沃	氵丿大󰁶
瓂	王艹土皿
䓂	艹言󰀘
哂	口西󰀝
㲃	󰀥日󰁴又
鎸	釒亻󰁷乃
诹	讠耳又󰁶
玸	王勹巳󰁀
毹	人一月乚
对	又寸󰁶
惸	忄勹日子
碹	石宀一一
糃	米曰一󰁤
撂	扌田夂口
胸	月勹乂凵
郸	丷󰅐阝󰀢
咂	口匚冂丨
䳃	󰁟灬夕⺋
㒂	亻艹土日
㢹	弓辛󰀢
镂	钅米女󰀝
䥹	釒三丨󰀆
焸	日日火󰁧
楹	木乃又皿
啂	口爫孑乚
洃	氵火󰁶
畂	田ク󰂃󰁶
蕂	艹月丷力
凉	冫󰁸小󰁶
䕂	艹厶口辶
㥹	米八刀心
稹	禾十󰀣八
艸	凵丿凵丨
騹	󰀋灬廿
攂	扌田田田
䉸	⺮辛言辛
剸	一曰丨刂
樹	木土口寸
䔂	艹宀辛󰀬
㵃	氵虫宀匕
炸	火𠂉丨二
棹	木󰀥早󰀢
壹	士冖一䒑
䂸	石戈口󰀞
痂	疒力口󰀌
藂	艹耳又乑
邸	󰁚󰀁丶阝
裹	亠日木󰀔
㗂	口小丿目
䗂	虫虍几󰁀
㣹	彳广亻心
馹	󰀋灬日󰀝
禹	丿口冂丶
臸	一厶土土
跃	口止丿大
懸	󰀣小丿心
㦹	日一勹戈
巃	山立月三
䖂	艹言糹手
㷃	火󰀍󰀖󰁧
詹	⺈厂八言
穹	宀八弓󰀅
鈸	釒又丶
䈸	⺮⺈用十
㩹	扌又又一
橹	木󰁢一日
婹	女覀女󰀝
㙂	土丷口儿
七	七一乚
噂	口丷西寸
渃	氵艹口
療	疒大丷小
虂	艹󰀙口口
陂	阝󰅌又󰁶
笸	⺮匚口󰀘
掿	扌艹口
鎿	釒人一手
莿	艹木冂刂
㹃	丨三丨󰀟
幃	冂丨󰁆㐄
䘂	虫十戈󰀞
瘂	疒一󰀚一
昂	日󰁚卩󰀬
阂	门亠ㄥ人
蘂	艹心心木
县	󰀐一厶󰁧
䎿	耳禾火󰁶
菿	艹一厶刂
鏿	釒⺌冖木
揿	扌钅⺈人
珿	王口󰁾󰁶
㛂	女⺁巴󰁀
溃	氵口丨贝
盂	一󰀛皿󰀘
亃	米夕㐄乚
広	广厶󰀦
䫸	几丿虫刀
嫸	女羊䒑口
蛂	虫又丶
㫸	日一󰁬󰁾
政	一止夂󰁶
嶸	山火火木
䔿	艹丷西寸
㶸	火力力力
㻃	ㄇ󰁺王丶
皂	白七󰀅
暂	车斤日󰀘
廃	广癶二儿
䚂	土󰁖目儿
锿	钅󰁸󰀔󰁶
隂	阝人󰂞󰁶
甿	田亠󰄃󰁀
捿	扌一󰁬女
筸	⺮曰干󰀬
荿	艹戊𠃌󰀅
鍿	釒巛一田
睂	人人丨目
較	車六乂󰁶
靂	󰀙厂禾止
㝂	孑扌斤󰀢
㭸	木⺈口丶
坂	土⺁又󰁶
卿	󰁚丿彐卩
銿	釒󰁻用󰀢
永	丶𠃌󰀩󰀦
尸	尸󰁈一丿
芿	艹亻乃󰁣
簸	⺮艹三又
蜂	虫夂三丨
眂	目󰁚󰀁󰁀
䰸	󰁢灬八厶
齃	丿目田󰄃
佃	亻田󰀝
㽃	丿米田丶
潃	氵彳夂月
圂	囗一󰀓󰀦
鋿	釒⺌冂口
篸	⺮厶厶彡
诸	讠土丿日
勿	勹󰁤󰀏
拿	人一口手
龃	止人凵一
䯸	󰂞彡冫人
羃	罒艹曰丨
蟂	虫󰁟木󰁶
埂	土一日乂
澃	彡丆貝水
㾃	疒宀匕󰁫
侃	亻口󰀸󰁀
骸	󰀾月亠人
萿	艹氵丿古
琿	王冖車󰀢
檸	木宀心丁
鞂	廿󰀜禾󰁶
螂	虫丶彐阝
翃	厶羽󰀝
濃	氵ㄇ󰁺󰀖
䐿	月丿ㄇ大
促	亻口󰁾󰁶
㞂	乚爫女
鉿	釒人一口
㡂	一夕刂丨
䂁	目⺈口丶
塂	土󰁺八巳
桂	木土土󰀝
炁	󰀄󰁜灬󰁧
衂	丿皿刀丶
邁	艹曰冂辶
㱸	一夕尸辛
䱸	󰁢灬臼又
㠂	山󰁡攵
㖿	口耳阝󰀢
䃁	石一󰀚一
砂	石小丿ノ
䖿	禾勹丿虫
郁	月阝󰀢
蠂	虫艹廿木
閿	門爫冖又
贸	󰁚丶刀贝
韹	立日白王
蟹	⺈用刀虫
矹	石一儿󰁀
柹	木丿ㄅ丿
培	土立口󰀝
䟹	口止爫寸
㟹	山耳󰁚卩
䣂	二木阝󰀢
㗿	口門丁口
㣂	弓一口丨
泸	氵󰀥尸ノ
送	䒑大辶󰀦
棂	木彐火󰁶
鑑	釒匚丨皿
葑	艹土土寸
粒	米立󰀝
藿	艹󰀙亻󰁷
呑	丿大口󰀘
䲒	󰁢灬⺈󰀟
㑑	亻丿目󰀝
偁	亻爫冂土
䁁	目󰁸小󰁶
㢂	广丿󰃧󰀌
遁	⺁十目辶
袂	衤󰁧ユ人
鐑	釒糹士口
恁	亻丿士心
琑	王⺌月󰀝
萑	艹亻󰁷󰀘
向	丿冂口󰀌
泒	氵⺁厶󰂃
㳒	氵大厶󰁶
䐑	月廿󰄃木
醁	西一󰁭氺
冁	丷曰十󰀖
楂	木木日一
祂	礻󰁶也󰁀
㕿	禾口󰀘
䕿	艹廿口灬
铑	钅土丿匕
浸	氵彐冖又
䆁	禾罒土十
氒	󰁚󰀁十󰀬
长	丿七󰂃󰀦
谒	讠日勹󰄃
簒	⺮目大厶
䓑	艹氵一廾
㓑	冫土䒑十
釁	󰀗ㄇ一刀
䒿	艹冖月󰀘
夂	夂丿乛󰂃
褂	衤󰁧土卜
咿	口亻󰁬丿
钑	钅乃󰂃󰁶
䤂	西一甘木
㤂	乃󰂃心󰁧
咑	口扌丁󰀢
汒	氵亠󰄃󰁀
籒	⺮扌一田
蒑	艹⺁彐又
蒿	艹󰁸冂口
璿	王󰀥冖目
㱒	止丁口󰀘
钿	钅田󰀝
駂	匕十󰀋灬
焁	口⺈人火
观	又ㄇ󰁜󰁀
㓿	禾人氺刂
䓿	艹󰁻囗十
㧂	丶尸田󰀌
䧂	阝刀口󰀝
卑	白丿十󰀬
䍑	冂乂乂干
㮒	木覀土󰀝
鍑	釒𠂉日夂
荑	艹一弓人
箒	⺮彐冖丨
蓿	艹宀亻日
䈃	⺮氵刀口
刃	刀丶󰀦
戃	忄⺌冖灬
爃	火火火木
㘿	土日土󰀝
鈃	釒一廾󰀢
概	木彐厶󰁜
允	厶儿󰀅
䅁	宀女禾󰁧
昿	日广厶󰁶
嘿	口󰀹土灬
䲸	人󰀯󰁟灬
䯒	󰀾月彳丁
寒	宀󰀀八󰁦
阿	阝丁口󰀝
㯒	木爫目儿
诒	讠厶口󰀝
錑	釒丶尸犬
毒	主母󰁧
篒	⺮人丶艮
㹸	犭󰁥白儿
乸	也母󰀦
幸	土䒑十󰀬
摿	扌人立日
㬒	日艹犬廾
发	ㄥ丿又丶
䏑	󰁝冂人人
瑿	匚𠂉大丶
葿	艹󰁅目󰀘
鑿	业䒑十金
菑	艹巛田󰀘
俿	亻虍几󰁀
堾	土三人日
㿿	乛󰁾皿󰀘
蠾	虫尸氺虫
頾	彡丆貝匕
栾	亠󰁗木󰁧
翿	士乛工羽
㭒	木󰃧󰀝
䎑	羽󰁭氺󰁶
厑	厂口匕󰁫
掑	扌󰀎八󰁶
筒	⺮冂一口
莑	艹夂三丨
鎑	釒土厶皿
埾	耳又土󰀘
骒	󰀊󰀞日木
㟾	山广󰁬丨
窒	宀八一土
扑	扌卜󰁶
蟾	虫⺈厂言
矾	石几丶󰁶
柾	木一止󰀝
难	又亻󰁷󰀝
鈑	釒⺁又󰁶
暾	日󰁸孑攵
爑	火艹亻灬
蹿	口止宀丨
嫒	女爫冖又
我	丿扌󰅅丶
㚾	女口儿󰁀
乿	爫幺小乚
陾	阝丆冂大
苑	艹夕⺋󰀅
稒	禾囗古󰀝
虾	虫一卜󰁶
百	丆日󰀘
䋑	糹一冂人
㨒	扌大土土
䙾	宀匕目儿
娒	女𠂉母󰁶
穒	禾󰁟灬󰁧
芑	艹己󰀅
銑	釒丿土儿
㩒	扌木木小
䊑	米⺌冂口
婒	女火火󰁶
橒	木󰀙二厶
遽	󰅋七一辶
社	礻󰁶土󰀝
聽	耳王十心
夾	大人人󰀦
恽	忄冖车󰀢
㤾	忄冖八木
䁽	目巛囗󰁒
煑	土丿曰火
慑	忄耳又又
兑	丷口儿󰀅
䅑	禾爫女󰀝
馒	⺈󰁐日又
腑	月广亻寸
邽	土土阝󰀢
肽	月大丶󰁶
炽	火口八󰁶
悽	忄一󰁬女
傽	亻立早󰀢
䂽	石󰀥早󰀢
㣾	忄又丶󰁶
㦒	忄罒言󰀝
槒	木亠幺田
㽿	疒⺁厶󰂃
䧒	阝木人人
儑	亻日幺灬
枾	木十󰀯一
瞾	目目宀工
轿	车丿大󰀯
鄑	一业日阝
㧒	扌宀八󰁶
㾿	疒丶󰁮阝
䇑	立白丿十
坾	土宀丁󰀢
懑	氵艹一心
睾	丿罒土十
褒	亠亻口󰀔
靾	廿󰀜廿󰄃
耽	耳冖󰁜󰁀
㤒	忄大十󰀢
䆑	宀八丁󰀬
奒	大亠ㄥ人
憑	冫󰀋灬心
熑	火䒑󰁬八
膑	月宀󰅍八
醑	西一乛月
樾	木土󰁾丶
煽	火丶尸羽
䨾	广丨三三
兽	丷田一口
腽	月日皿󰀝
騾	󰀋灬田小
逐	一󰀓辶󰀦
耐	丆冂〢寸
瀐	氵十戈󰀞
怐	忄勹口󰀝
㥒	忄爫木󰁶
㧾	扌勹󰁤心
秾	禾冖󰀔󰁶
槾	木曰罒又
冽	冫一夕刂
䧾	人干口󰁷
駾	󰀋灬丷儿
觾	⺈用廿灬
遐	󰁃丨二辶
砑	石󰀂亅丿
蠑	虫火火木
堑	车斤土󰀘
恐	工几丶心
䡑	車󰁂󰀁󰁀
㡑	禾火冂丨
碾	石尸󰁺󰀖
能	厶月匕匕
都	土丿日阝
㢾	弓覀土󰀝
䢾	丿土儿阝
墾	豸艮土󰀘
惽	忄󰁂󰀁日
邐	一冂丶辶
悐	犭󰁥火心
壑	󰀥冖一土
肐	月𠂉乙󰁀
炐	火三丨󰀢
㠑	山罒丨三
䁐	目艹ㄇ大
衾	人丶乛󰀔
焽	日月火󰁧
顾	厂⺋丆贝
䡾	車虍一犬
㡾	广艮󰀦
桾	木󰁬丿口
儽	亻田田小
鉽	釒󰀁工丶
笾	⺮力辶󰁧
艽	艹九󰀅
剽	覀二小刂
款	士二小人
㬾	匚𠂉大月
䬾	人良丷丿
墑	土亠丷古
惐	忄戈口󰀞
碑	石白丿十
胐	󰀼冫凵山
䂐	𠂉大凵山
㣑	广󰁬月彡
髾	󰂞彡⺌月
芽	艹󰀂亅丿
犽	犭󰁥󰀄丿
抽	扌由󰀝
劽	一夕刂力
靑	冂丨一
辒	车曰皿󰀝
睑	目人一一
村	木寸󰁶
㢑	广亻󰁷十
䢑	󰁚󰀁丶辶
蜑	丿󰀥󰄃虫
霑	󰀙氵󰀥口
朑	月廿󰄃󰁀
習	羽白󰀘
徒	彳土󰁾󰁶
侒	亻宀女󰀝
㾒	疒女口󰀌
㦾	丶尸也󰁫
䇽	⺮扌斤󰀬
妾	立女󰀘
榾	木󰀾月󰀝
燽	火士乛寸
覾	宀丿米儿
釽	釒⺁丨󰂃
缒	纟亻󰁃辶
柑	木艹二󰀝
鼒	󰀛丿目󰁈
輒	車耳乚󰁀
俒	亻宀二儿
忒	弋心丶󰀦
㥾	忄匚艹口
㿒	疒士乛寸
刽	人二厶刂
䈽	⺮廿口
爽	大乂乂乂
楾	木白水󰁶
鈽	釒冂丨
襾	一ㄇ凵󰀵
卼	一儿⺈⺋
䮽	󰀋灬󰁙灬
㮽	木丿󰁪又
枑	木一彑󰀝
罒	罒丨󰁈一
螑	虫丿目犬
鞑	廿󰀜大辶
㼒	⺁厶󰂃󰁤
埑	扌斤土󰀘
伒	亻斤󰀢
鍼	釒戊一口
荼	艹人一木
獼	犭󰁥弓乂
捼	扌禾女󰀝
䎼	耳󰁭氺󰁶
孽	艹亻󰁃子
虑	󰅋七心󰀦
癑	疒ㄇ󰁺󰀖
㽒	田力丿
佒	亻ㄇ大󰁶
垑	土夕夕󰁶
莼	艹纟一乚
鎼	釒虍手󰀢
掼	扌󰅂十贝
筽	⺮口一大
䬽	人良丷儿
㬽	月口口ㄅ
阑	门一󰀹󰅇
绒	纟戈ノ
蘑	艹广木石
溒	氵土口󰀔
噑	口白󰀪十
互	一󰅂一󰀌
㙑	丿口冂土
欽	釒⺈人󰁶
嬽	女罒丨大
苼	艹丿󰀘
狼	犭ノ丶󰀖
㫽	日󰁭氺󰁶
䌼	纟丷口儿
蛑	虫厶丿󰀟
监	〢𠂉丶皿
雑	九朩亻󰁷
廒	广主󰁡夂
滒	氵丁口口
㻒	王囗禾󰁶
䘑	丿皿丶󰀩
嫽	女大丷小
挼	扌爫女󰀝
竽	⺮一󰀛󰀬
茼	艹冂一口
皑	白山己󰁀
蚑	虫十又󰁶
隑	阝山一䒑
沽	氵古󰀝
岽	山󰀂小󰁧
䲽	石󰁟灬󰁶
㲽	氵刀丶󰁶
鲽	󰁢󰀞廿木
葼	艹乂凵夂
瑼	王一曰寸
丒	刀丶一󰀘
㸒	爫丿士󰀘
曑	曰曰曰彡
囑	口尸氺虫
镑	钅亠丷方
蕑	艹門月󰀘
咼	冂󰁈冂口
撼	扌厂一心
㒼	廿冂丨丶
䒼	艹ㄇ󰁺󰀘
钼	钅目󰀝
籽	米子󰀝
蒼	艹人丶口
㚑	彐大󰁧
乒	󰅍一丿󰁣
嚑	口丿一灬
湒	氵口耳󰀝
蔑	艹罒厂丶
鷒	一曰丨灬
㰽	匚日女人
叼	口𠃌󰀞󰀝
䏼	月戈戈󰁶
㶒	氵門󰀋灬
揼	扌石水󰁶
鏼	釒⺮木冂
菼	艹火火󰁧
畑	火田󰀝
涒	氵󰁬丿口
啑	口一󰁬󰁾
䕑	艹糹爫女
闑	門丿目木
藑	艹⺈ㄇ夂
㐼	亻丿廾󰀢
䯽	󰂞彡立口
寽	爫寸󰁧
毽	丿二乚廴
琼	王󰁸小󰁶
萼	艹口口ㄅ
鐼	釒十艹貝
淒	氵一󰁬女
甑	丷󰀺日丶
䔑	艹人一十
唑	口人人土
赒	贝󰀼土口
閑	門木󰀦
㶽	火口冂人
畼	田日一󰁤
涽	氵󰁚󰀁日
啼	口亠丷丨
䕼	艹廿口󰁷
镼	󰂞尸凵山
蕼	艹󰂞󰁬󰀟
㴒	氵亠󰁖廾
崒	山亠人十
䴒	󰀙口口灬
痑	疒夕夕󰀦
鐐	釒大丷小
㵽	氵田田田
浽	氵爫女󰀝
疼	疒夂󰁦󰀦
䖼	虫土厶卩
嵽	山廿儿丨
薼	艹󰁙󰁴土
鵽	又又又灬
㖑	口戈廾󰀢
䵒	禾人氺日
喑	口立日󰀝
浒	氵讠𠂉十
疑	匕𠂉大󰁾
瑐	王䒑月刂
谑	讠󰅋七一
呐	口冂人󰁶
民	󰁃󰁐弋󰁫
㑐	亻上小󰁶
䰑	󰂞彡󰀙〢
䴽	木人人十
㓼	木人氺刂
洽	氵人一口
哼	口󰁸了󰀢
蓼	艹羽人彡
瓼	一󰁐󰁊土
鴽	女口󰁟灬
钐	钅彡ノ
萐	艹一󰁬󰁾
籑	⺮目大艮
汑	氵丿七󰁀
吐	口土󰀝
䐐	月禾火󰁶
㱑	止夕󰁧
㳽	氵弓𠂉小
䔼	艹刀丶止
峽	山大人人
泽	氵又󰀟󰀢
甼	田丁󰀬
蔼	艹讠日󰄃
鳽	一廾󰁟灬
鑐	釒󰀙丆〢
哐	口匚王󰀝
擐	扌罒一󰀔
粑	米巴󰁀
貑	豸󰁃丨又
㲑	毛水󰀦
䓐	艹大一乚
霾	󰀙豸日土
眾	罒亻人人
軿	車䒑廾󰀢
廿	廿一丨一
滿	氵廿冂丶
㻿	王罒勹虫
仿	亻方ノ
撐	扌⺌冖丿
峑	山人王󰀘
蒐	艹白󰁜厶
糑	米弓冫冫
䒐	艹罒冖巴
㒐	亻⺮勹日
鼿	丿目田儿
蛾	虫丿扌丶
盾	⺁十目󰀌
曾	丷󰀺日󰀘
图	囗夂󰁦󰀦
伿	亻口八󰁶
㛾	女戊一口
鲑	󰁢󰀞土土
䬑	几丿虫月
嬑	女立曰心
㬑	日󰁸孑阝
荐	艹丨子
鍐	釒乂凵夂
捐	扌口月󰀝
獐	犭󰁥立早
㸽	牜貝󰁶
帽	冂丨曰目
䗼	虫丿一灬
痼	疒囗古󰀌
渽	氵十戈口
闼	门大辶󰀦
踽	口止丿丶
孑	孑乛亅󰀞
䭑	人良䒑八
㭑	木未󰁶
㨃	扌󰁸子󰀝
䉂	⺮田幺小
茐	艹勹󰁤󰂃
樃	木丶󰁮月
稃	禾爫子󰀝
艂	丿󰁪夂丨
騃	󰀋灬厶大
㘼	土土丿ㄅ
䘼	衤󰁧宀⺋
巽	巳巳󰁺八
淽	氵艹止󰀝
瘼	疒艹日大
跽	口止己心
阼	阝𠂉丨二
㮑	木丿十臼
䏐	月ユ人󰁶
叐	丿又󰀦
殑	一夕古儿
箑	⺮一󰁬󰁾
菐	业䒑夫󰁧
鏐	釒羽人彡
㞿	山土乂󰁧
弸	弓月月󰀝
伸	亻日丨󰀢
缸	󰅎山工󰀝
漸	氵車斤󰀢
鞿	廿󰀜幺人
螿	爿󰁝寸虫
㯑	木弓󰀍󰀖
寑	宀亻󰁬又
䎐	十早羽󰀝
篑	⺮口丨贝
掐	扌⺈臼󰀝
鎐	釒爫𠂉凵
莐	艹氵冖󰁜
㽸	疒冖󰁜󰁫
䝿	臼人貝󰁧
坿	土亻寸󰁶
潸	氵木木月
睿	󰀥冖一目
轸	车人彡ノ
靿	廿󰀜幺力
鉐	釒石󰀝
牐	丿丨一臼
艐	丿󰁪乂夂
剐	口冂人刂
樑	木氵刀木
㨑	扌乂凵夂
䉐	⺮車古󰀘
郾	匚日女阝
胾	十戈冂人
烾	火火土󰀘
椿	木三人日
僾	亻爫冖夂
䤿	釒三丨手
㤿	忄大日乚
驑	󰀋灬一田
舐	丿古󰁚弋
穑	禾十䒑口
橑	木大丷小
刐	󰀼亠刂󰀢
䈐	⺮忄火
㩑	扌一大三
鄾	丆󰀐冖阝
磿	厂禾禾石
脾	月白丿十
壿	士丷西寸
愾	忄气米󰁶
㣿	忄勹丶󰁶
䄾	禾戈󰁥
窑	宀八󰅎山
苐	艹弓丨丿
鋐	釒宀厶
㪑	大日󰁐又
䪑	󰁆口㐄匕
媑	女丿一土
檑	木󰀙田󰀝
隿	󰀁丶亻󰁷
暿	日士口口
嚿	口艹亻臼
蚿	虫亠幺󰁶
皿	皿丨󰁈一
䚿	言⺈人󰁶
㚿	女勹巳󰁀
芐	艹一卜󰁧
竑	立厶󰁶
髑	󰀾月罒虫
䊐	米日󰁴匕
㫑	日力󰁥
櫑	木田田田
劐	艹亻󰁷刂
陿	阝匚大人
噿	口羽亠十
晿	日曰曰󰀝
癿	白乚󰁀
虿	一󰁡虫󰁧
㙿	土丷王丶
䙿	未目儿󰁀
㤑	忄口󰀝
椑	木白丿十
煐	火艹ㄇ大
䅐	禾目儿󰁀
児	丨日儿󰀅
㐟	丨三丨乙
蔈	艹覀二小
腐	广亻寸人
酐	西一干󰀢
㬘	日󰁬十󰀲
閞	門厶廾󰀵
䄵	禾㐄󰀬
㔈	艹丨三刂
䔈	艹工貝󰁧
鄵	口口口阝
㯘	木士二人
㤟	ㄇ󰁺心󰁧
庸	广󰁬月丨
亸	󰁸孑丷十
㠿	止匕冂丨
㯟	木木󰁭氺
麸	主夕二人
蠿	󰁃幺幺虫
纸	纟󰁚弋󰁀
溸	氵幺小
㲵	气⺌月󰀌
㻫	王日艹󰀟
㗏	口丆卜止
㘞	囗力󰀏
㥑	丆󰀐冖心
㞶	山文󰁶
㬦	日艹亻又
㔮	廿口夫匕
焐	火五口󰀝
楑	木癶一大
契	三丨刀大
䥑	釒木人夕
镈	钅甫寸󰁶
㕧	口尸󰁥
鄐	亠幺田阝
脐	月文󰀯󰀢
㱟	一夕皮󰁶
䕈	艹爿廿木
郵	丿士󰁺阝
㡦	冂丨宀貝
㱉	业䒑未人
㲉	士冖一又
㘦	土力󰁥
㢥	冂一口丶
䀾	石又目󰀘
埿	氵尸匕土
㹧	犭󰁥ㄇ大
㻸	王󰀄󰁜日
耾	耳厶󰁶
逾	人一月辶
柿	木亠冂丨
矿	石广ノ
㐞	󰀎八乙󰀅
㽈	匕𠂉大丶
㞦	山几󰁀
𠂉	𠂉丿一
㑟	亻丘八󰁶
㢟	󰀥󰄃廴󰁫
㟨	山山丆〢
㦑	忄乛耳攵
䇐	立󰁬氺󰁶
凐	冫覀土󰀝
懐	忄亠罒󰀔
燐	火米夕㐄
臐	月丿一灬
㧿	扌人人󰁾
䆵	宀八丷日
㪥	虍󰀐󰀞又
兾	丷田󰁺八
䦿	阝口丨󰀢
煾	火囗大心
榿	木山一䒑
酾	西一一丶
腾	月䒑大一
䒈	丿󰁪十貝
憵	尸口辛心
㟟	山󰁺八⺋
㐜	一氺丶九
㤥	忄亠ㄥ人
㷘	火厶口木
䐤	月⺶工󰀝
䐥	月八厶羽
㱵	一夕十貝
䑤	丿󰁪人乛
㥟	忄彑󰀓󰁶
㪧	人一口又
焞	火󰁸子󰀝
䓤	艹勹󰁤心
㲥	广󰁬丨毛
䓈	艹彳几又
㧑	扌丶力丶
㓈	冫石󰀝
姑	女古󰀝
䆐	三八禾禾
熐	火冖日六
槑	口木口木
駑	女又󰀋灬
觑	󰅋七󰅊󰁜
㦿	丶尸木󰀦
㔟	丿九力
䥿	钅⺁一󰁡
奿	九丶女󰀌
楿	木禾日󰀝
熾	火亠丷日
西	西一丨一
饿	⺈󰁐丿丶
㧧	扌亠厶󰀸
䕯	艹覀二󰂃
㠧	山广木三
㸘	八乂罒丁
㡥	冂丨爫心
㫧	日米󰁧
䕟	艹󰀗ㄇ八
峮	山󰁬丿口
㜥	女罒貝󰁶
䙟	衤󰁧囗㐄
㕝	古又󰁧
興	󰀗ㄇ一八
萴	艹貝刂󰀬
爈	火虍田心
㣧	彳幺月乚
䛟	言大人人
㐴	亻夕󰁶
㺦	犭󰁥耳一
㼦	工几丶丶
㙦	人一朩土
㘥	囗爫𠂉小
鋾	釒勹𠂉凵
苾	艹心丿󰁣
狾	犭󰁥扌斤
拾	扌人一口
勾	勹厶󰀦
䝞	豸虍几󰁀
㩝	扌󰁸冖󰀓
顐	冖車丆貝
䞂	貝丆冂大
硐	石冂一口
衐	彳匚󰁃丁
塐	土幺小
桐	木冂一口
㡐	冂丨䒑刂
䡐	車宀匕󰁀
䄞	礻󰁶󰁯小
㸵	牜士口󰀝
䞟	土󰁾白󰀌
䞥	土󰁾月
艈	丿󰁪亠󰀸
叴	九口󰀘
珴	王丿扌丶
㿉	疒口丨貝
䟚	口止二󰀯
䟝	口止几又
䟟	斤丶口󰁾
䟥	口止󰁻丿
䂞	石木󰁧
䟦	口止丿又
䟧	口止田󰀝
䟵	口止一丶
髿	󰂞彡氵丿
㞸	山丆卜󰁧
竿	⺮干󰀬
茾	艹一廾󰀬
匾	匚丶尸艹
櫿	木火火口
䬿	人良尸毛
㬿	月󰁸孑攵
䠈	口止󰁬氺
預	󰁻乛亅貝
蠐	虫󰀴󰀳󰀝
砐	石乃󰂃󰁶
栐	木丶𠃌󰀩
堐	土厂土土
䠐	口止目犬
㠐	山丿大口
銥	釒亠󰀔󰁶
㳊	氵攵󰁶
㔥	罒厶月力
䠒	口止古月
䠟	土䒑十󰁾
䠥	口止㡀攵
䠦	口止𠂉日
璴	王木木󰁾
䒴	艹月󰀘
䠶	丿󰀽三大
㯝	木口止口
䡞	󰀣八車󰀬
䡧	車󰁞灬󰁶
䎞	土丿日乛
㴦	氵宀口口
䢈	厂二󰀖日
葴	艹戊一口
䑴	丿󰁪󰀎八
䢞	木木辶󰀦
䢟	方攵辶󰀦
㱦	一夕大口
䢱	士罒貝辶
聾	立月一耳
碿	石尸⺌月
㕜	口丨又󰁧
遾	⺮工人辶
䢿	宀女阝󰀢
㢿	弓亻ユ大
梿	木车辶󰁶
偾	亻十艹贝
䣅	厂二󰀖阝
㯦	木󰀎八木
㣐	白水彡󰁥
䣐	艹ㄇ大阝
䣤	目目亻阝
䣥	西一匕󰁀
㾷	疒⺁虍几
䝶	貝󰁸小󰁶
㩟	扌宀󰀀朩
䅧	禾立日󰀝
䤞	釒乚丶
䤟	釒冖几󰁀
䤠	釒止󰀝
㗞	口石皮󰁶
䌥	糹爫工心
嗏	口艹人朩
痏	疒月󰀌
闏	門几丿虫
㷟	火丿󰃧辶
䋥	糹日土󰀝
䆧	宀八禾女
䎥	二木八口
䞶	土󰁾日󰁤
覞	目儿目儿
炾	火口儿󰁀
衿	衤󰁧人乛
邾	󰅎󰅇阝󰀢
垶	土辛󰀢
㡿	广䒑凵丿
墐	土廿口
塿	土󰀻女󰀝
桿	木曰干󰀢
瞶	目口丨貝
㻉	王止󰀤󰁥
䢐	󰀐一辶󰀌
㢐	广ㄇ󰁈口
鞶	丿󰁪几󰀜
㵟	氵彳山攵
䦉	󰂞四󰀝
䈥	⺮⺈用力
䩞	廿󰀜󰀥口
㺈	犭󰁥凵虫
瘏	疒土丿日
蘏	艹匕二貝
㹵	犭󰁥一工
䧉	阝日土󰀝
㘠	囗心丿󰀏
䧊	阝丿土口
囶	囗八土󰀌
㼷	山丆冂丶
䛶	言三丨木
䧥	阝一日心
盶	目二儿󰁀
䊥	米󰁬十󰀲
㕋	厂金󰀌
䧱	九亻󰁷󰀝
燾	士乛工灬
鼑	󰀥目󰁕󰁈
漑	氵白匕󰁜
灗	氵虫亠一
䨊	亻󰁷亻一
㦌	毛毛毛心
騿	󰀋灬立早
臾	臼人󰀦
㒞	亻山亻𠃌
䕏	艹丷王丶
䨐	󰀙人一口
䨚	󰀙勹󰁤心
休	亻木󰁶
偗	亻小丿目
蕏	艹犭󰁥日
㼑	木󰀹⺁󰂃
問	門口󰀌
䨦	󰀙亠丷方
䄥	礻󰁶󰀙人
䨷	󰀙木木又
䅈	丷夫禾󰁧
䩉	丆囗〢甫
䩊	丆囗〢⺋
朶	乃木󰁧
圶	大土󰀘
䜶	一口䒑㐄
㻷	王木冂冂
䃥	石立日土
㨿	扌虍夂几
霶	󰀙氵亠方
䄈	礻󰁶一䒑
䆥	宀八一󰀓
槿	木廿口主
轑	車大丷小
䈾	⺮木⺌月
悗	忄⺈口󰁜
㼈	王罒糹󰁷
䩷	廿󰀜亠方
觿	⺈用山口
駿	󰀋灬厶夂
䪁	廿󰀜业夫
閏	門王󰀌
䂈	󰁻乛亅虫
䪘	󰁆口㐄󰁾
傗	亻亠幺田
佑	亻口󰀝
㜐	女山一䒑
䪞	一大丨一
荽	艹爫女󰀘
鍽	釒丶尸艹
捽	扌亠人十
獽	犭󰁥亠󰀔
䪟	一冂丨一
䪦	立日工󰀝
䪧	立日也󰁀
鐈	釒丿大口
戵	目目亻戈
䐈	月十󰀣󰀝
䪶	󰀐󰀞丆貝
䈵	⺮八厶羽
䰾	󰁢灬巴󰁀
卽	白匕卩󰀢
刵	耳刂󰀢
㰾	白方⺈人
某	艹二木󰁧
羑	丷王ク󰂃
辑	车口耳󰀝
龑	立月一大
䪷	勹口丆貝
䫁	丿目丆貝
䫉	豸丆貝󰁶
䫌	白丿十貝
䫘	日勹人貝
䫝	禾日丆貝
䫠	彡丆卜貝
䫥	白󰁜厶貝
䫦	土厶皿貝
㟐	山艹亠󰄃
侑	亻月󰀝
埐	土彐冖又
鎽	釒山夂丨
课	讠日木󰁶
玽	王勹口󰀝
毾	曰羽毛󰁀
䫫	󰀻女丆貝
䃝	石土丿攵
䬌	虍几几虫
䬘	几丿虫口
鑈	釒一八乂
葈	艹厶口木
燵	火土羊辶
䑈	月白幺木
厽	厶厶厶󰁧
䎽	耳󰁚󰀁日
㯾	木一ㄇ辶
䬦	人良几又
瞐	目目目󰀘
析	木斤󰀢
逗	一口䒑辶
耗	三󰅇丿乚
䬧	人良二儿
䬵	人良亠人
䭉	人良月
䭘	人良日小
䎵	耳心丿󰁥
㣞	彳八厶儿
䂝	石戈󰁶
䭥	人良丷艮
㿑	疒羽亻󰁷
䭦	人良艹寸
倗	亻月月󰀝
䀗	目ユ人󰁶
骾	󰀾月一乂
䭧	人良广小
䇝	⺮戈󰁧
㦞	士乛工心
媾	女󰀀冂土
檾	火火冖木
狽	犭󰁥貝󰁶
苽	艹⺁厶󰂃
䮆	󰀋灬丆十
莈	艹氵几又
㪾	夂口斤󰀢
䪾	丆貝人彡
鎈	釒⺶工󰀝
㥞	忄䒑󰀓󰁶
䎈	羽日󰁒丿
厈	厂干󰀵
帑	女又冂丨
渑	氵口日乚
㙐	土山丆〢
丑	󰁈丨二󰀌
犵	犭󰁥𠂉乙
䊵	糹九󰁀
劵	丷夫力󰁣
㧶	扌丿󰀽丿
䁈	丶尸攵目
䮥	󰀋灬一丨
䮦	󰀋灬󰁸口
䮵	󰀋灬立土
限	阝彐󰀖󰁶
䮶	󰀋灬亻木
癐	疒人一日
虐	󰅋七匚一
㝋	宀了󰀬
錽	釒一火夂
䯟	󰀾月䒑󰀓
䂉	󰁻乛亅大
橾	木口口木
匽	匚曰女󰀌
茽	艹亻口丨
猽	犭󰁥冖六
㯧	木土󰁾口
䯫	日󰁸小口
䌽	纟爫木󰁶
㩾	丿士󰁺又
䯱	󰂞彡丆卜
㒶	八白󰀘
䌝	糹木木小
䰉	󰂞彡丿又
湑	氵乛󰁾月
嘐	口羽人彡
乑	乑丿丨󰂃
㘐	口󰀋灬乂
䄉	礻󰁶丿丶
䰓	󰂞彡丿方
㑶	亻气米󰁶
㱧	一夕宀⺋
䰚	一口冂文
䰝	一口冂日
䰞	弓土丿丨
䰠	白󰁜厶丨
䰡	白󰁜厶夫
鹑	󰁸孑󰁠一
蹑	口止耳又
瘐	疒臼人󰀦
崾	山覀女󰀝
派	氵⺁󰀕󰁶
㴾	氵十冖攵
䴾	木人人工
唴	口⺶乚󰁀
蔴	艹广木木
甴	ㄇ丨二󰀌
䰵	󰁢灬子󰀝
䰶	󰁢灬亠󰄃
䰷	󰁢灬三丨
䱉	󰁢灬󰀐一
䱊	󰁢灬米󰁶
鑽	釒丿土貝
䱐	󰁢灬爫子
瑽	王彳人󰁾
葽	艹覀女󰀘
㛐	女一日乂
云	二厶󰁧
庑	广二󰁜󰁫
曐	曰曰曰
㭞	木小丿力
䱜	󰁢灬󰁺日
䱝	󰁢灬白十
挜	扌一业󰀝
郟	大人人阝
巉	山⺈口丶
䱥	𠂉一冂灬
㼽	大乂乂丶
盐	土卜皿󰀘
蛐	虫ㄇ󰁺󰀝
雐	虍亻󰁷󰀌
妦	女三丨󰀢
泾	氵ス工󰀝
峾	氵斤山󰀬
䳾	癶一口灬
㒽	󰀰丷夫⺋
䱷	虍󰁢灬攵
䲉	󰁢灬󰀎斤
㔴	匚田󰁺八
擴	扌广󰁺八
㯷	木亻业夫
䲞	󰁢󰀞立󰀝
䲟	󰁢󰀞󰁚卩
䲠	󰁢󰀞三日
䎝	土丿匕羽
钽	钅日一󰀝
蒽	艹囗大心
璽	一八冂丶
仑	人匕󰀅
㻑	王禾子󰀝
滑	氵󰀾月󰀝
廑	广廿口主
䌊	糹爫𠂉凵
䆷	宀八󰁻口
䲱	󰁟灬方󰁥
铧	钅亻ヒ十
㝊	宀又󰁧
糠	米广󰁬氺
䦛	門⺈󰁬亅
䳊	又丶灬
蚐	虫勹冫󰀝
皐	白󰀪十󰀬
㻋	王木口󰀝
隐	阝⺈彐心
揽	扌〢𠂉󰁜
箾	⺮⺌月刂
菽	艹上小又
鏽	釒󰁬十󰀲
䑝	口口冖㐄
㴵	氵心丿皿
斴	米夕㐄斤
喴	口戊一女
㚅	夂一丿
閴	門貝󰀦
㛊	女几木󰁶
䳠	丿士󰁺灬
䳡	亻󰁷󰁟灬
㮾	丶󰁮月木
䮾	󰀋灬立三
宾	宀󰅍一八
䓚	艹彳󰀐一
㴑	氵广䒑丿
㲛	𠂉大口毛
媠	女工月
洑	氵亻犬󰁶
畐	一口田󰀘
䴑	又又又灬
崑	山曰󰁴匕
煟	火田月󰀝
耏	丆冂〢彡
蕐	艹一人󰀟
鴑	女又󰁟灬
㘊	口󰀙言󰀝
㔦	丷王飠力
㤰	亻𠂉丨心
䴊	丷王丿灬
签	⺮人一一
搽	扌艹人木
鐽	釒土羊辶
落	艹氵夂口
䖴	虫儿󰀪󰁶
䴌	󰁟灬艹󰀓
啴	口丷曰十
䴛	󰀥囗󰁘月
㸞	丿丨一󰁈
䴫	󰁙󰁴󰁴󰁻
䴶	木人人丨
聧	耳癶一大
㭾	木尸凵山
怙	忄古󰀝
吽	口丿󰀟󰀢
䐽	月廿冂丶
㵑	氵力口貝
㶋	氵业󰀓
琚	王尸古󰀝
䵊	󰀼亠󰁺八
甐	米夕㐄丶
浑	氵冖车󰀢
嵑	山曰勹󰄃
䵑	禾人氺丶
䵋	󰁺由八月
䇷	⺮口力刂
鵑	口月󰁟灬
赑	贝贝贝󰁧
㧰	扌丿󰄃小
㕴	口冖几󰁀
䕴	艹禾亻灬
㓝	二󰀯刂󰀢
䵚	禾人氺臼
㕽	口󰁐丶人
䵟	󰀹土灬干
䵠	󰀹土灬丶
渾	氵冖車󰀢
畽	田丿一土
举	󰀧一八󰀟
帾	冂丨土日
谐	讠󰁴匕白
簐	⺮車⺈人
氐	󰁚󰀁丶󰀦
镽	󰂞大丷小
䰐	󰂞彡匚皿
㰐	木阝辶
䵤	一廾󰀹灬
䵦	󰀹土灬󰀛
䵧	十戈󰀹灬
㜝	女人丶一
䵶	勹口黽󰀝
㗐	口大丶皿
䶑	丿目田󰁾
嗐	口宀三口
涑	氵一口󰅇
痐	疒囗口󰀌
趑	土󰁾冫人
鶑	火火󰁟灬
㕊	厂甫󰀦
㙝	土力力月
䊚	米丿󰃧辶
䶉	臼󰁐󰁦田
䶋	丿目田󰂃
䶖	止󰀆人乛
㷾	火虍一󰀓
䶘	止󰀆立󰀝
㻞	王丶尸艹
蘈	艹禾几貝
疽	疒󰀐一󰀌
施	方𠂉也󰁀
巾	冂丨󰀵
䖽	禾刂虫󰁧
籐	⺮月丷氺
豐	山三丨䒑
閽	門󰁚󰀁日
汐	氵夕󰁶
㱐	二止丶󰀦
䍗	罒亠幺󰁧
耴	耳乚󰁀
昈	日丶尸󰁥
䘈	虫厂艹力
瀴	氵貝貝女
㷑	火覀土󰀘
䶚	止󰀆虫󰁶
巑	山丿土貝
䖐	斤虍几󰁀
疐	十冖田󰁾
淑	氵上小又
鷑	⺮立󰁟灬
薐	艹禾土夂
䂶	石土厶力
䶞	止󰀆󰀎八
罱	罒十冂十
䶠	戊一口󰀆
䶦	止󰀆貝
䶧	止󰀆土儿
㓽	山宀二刂
䲾	工一ㄅ灬
岾	山󰀥口󰀝
沾	氵󰀥口󰀝
䶪	止󰀆十󰁷
䶯	女丿󰁵󰀝
䗝	礻󰁶日虫
䁶	目白方攵
熫	火广廿灬
㐊	士乙󰀅
㸛	爿刀口󰀝
蠵	虫山亻口
精	米主月󰀝
蓽	艹曰艹󰀟
铽	钅弋心丶
虈	艹口口口
䠵	丿󰀽三寸
䙈	衤󰁧亻大
㙈	土虍几󰁀
奋	大田󰀘
並	䒑业󰀘
䖶	虫一󰀓󰁶
㿞	白毛󰁀
龸	⺌冖󰀅
蜿	虫宀夕⺋
羸	亠󰄃口丶
朿	木冂󰁫
圿	土人󰀯󰀢
侸	亻一口䒑
㾸	疒󰁸冂口
䗚	虫甫寸󰁶
乊	丿丷󰀏
䔽	艹氵日󰄃
㔽	󰀥囗口󰀘
汾	氵八刀ノ
唽	口木斤󰀢
䀦	目古󰀝
㔚	丿古力󰁥
乢	山乚󰁀
斈	文子󰀘
疈	一口田田
薈	艹人一日
㖈	土丿匕口
䖈	虍匕󰁫
蔽	艹丷冂夂
籾	米刀丶󰁶
䂴	石言󰀝
锽	钅白王󰀝
㢵	弓人一口
䅚	禾丷夫⺋
乵	辛乚󰁀
乶	甫乙󰀅
䍊	𠂉十凵乂
䙧	衤󰁧丿灬
雿	󰀙儿󰀪󰁧
㘢	囗⺌一儿
盿	目文󰁶
迸	䒑廾辶󰀵
囿	囗月󰀌
濸	氵艹人口
㿸	皮日罒又
俸	亻三人󰀟
㚶	女󰃧󰀝
䚶	言一大󰁶
㾠	疒犭󰁥王
䘧	衤󰁧ㄇ大
㛢	女禾乃󰁥
䃚	石方𠂉大
旈	方亠厶󰀸
聴	耳十罒心
㗈	口󰁻用力
灴	火工󰀝
咗	口工󰀝
䒗	艹𠂉乙󰀅
㬐	日一业日
䗈	虫亠󰄃目
鬐	󰂞彡土日
蒗	艹氵丶艮
璗	氵曰一丶
欐	木一ㄇ匕
姄	女󰁂󰀁󰁀
㧜	扌匚冂丨
㚢	亻女󰀝
㔶	匚立早貝
猈	犭󰁥白十
䈊	⺮土八夂
錈	釒丷夫⺋
㢝	广󰁢灬禾
㑚	亻𠃌󰀠阝
䫵	丿目宀貝
茰	艹曰乂󰁧
亷	立丿󰁬八
䨞	󰀙丿口丶
亽	人丶󰁧
䆜	宀八月
䎚	羽三丨心
仈	亻八󰁶
䍈	𠂉十凵十
仏	亻厶󰁶
獈	犭󰁥䒑皿
捈	扌人一朩
䍶	⺶木日󰀝
䄙	礻󰁶冖六
啝	口禾口󰀝
䭐	人良丷心
子	子子子子
勴	虍田心力
㭐	大一木󰁧
著	艹土丿日
鑗	釒禾勹氺
歐	匚口口人
瑗	王爫一又
仠	亻干󰀢
仦	亻小󰁶
仧	上人󰁧
㘶	夕㐄土󰀘
㦝	豸白儿心
䅜	禾丿士󰁺
咜	口宀匕󰁀
抈	扌月󰀝
犈	牜丷夫⺋
㵠	氵宀八山
䛛	言囗口󰀝
㹔	牜一田一
㥚	忄臼人󰁶
㹄	牜田八夂
䂊	󰁻乛亅󰀓
䎴	耳二󰀯󰀢
䜛	言⺈口󰁜
䐧	月󰁸冂口
㤋	忄八刀󰁥
㗽	󰁲丿丶口
䗽	糹亻󰁷虫
嗽	口一口人
涾	氵水日󰀝
痽	疒亻󰁷󰀌
沐	氵木󰁶
鶾	十早人灬
茗	艹夕口󰀘
猗	犭ノ大口
伡	亻车󰀢
杧	木亠󰄃󰁀
䲐	󰁢灬虍力
㲐	毛人丶乛
勈	󰁻用力󰁥
獴	犭󰁥艹󰀓
䛧	言米󰄃󰁀
㻠	王宀八犬
捴	扌八厶心
桛	木上一卜
㢷	弓山夕󰁶
䈚	⺮厶口心
㒷	ㄇ人一八
㖅	口戊一󰀝
㛺	女立日󰀝
㭝	木木九󰀅
䟋	土󰁾⺈言
䆚	宀八冂口
肏	丿󰂃冂人
邏	罒糹亻辶
炏	火火󰁶
榵	木艹耳󰀝
㵾	氵月儿
㲠	未攵毛󰀅
鋗	釒口月󰀝
䵾	亻寸土又
瘽	疒廿口
浾	氵土󰁖󰁶
阽	阝󰀥口󰀝
蘽	艹田田木
狗	犭ノ勹口
苗	艹田󰀘
黧	禾勹丿灬
旴	日一󰀛󰀢
㳐	氵木乚󰁀
䳐	冫⺈人灬
䍋	𠂉十凵󰁺
㾄	疒由󰀌
䌙	糹󰁺由八
侊	亻⺌一儿
䄚	礻󰁶一日
聏	耳丆冂〢
嗴	口⺶乚厶
㮝	木八人卩
䞋	貝立朩儿
䒜	艹丿󰀟󰀬
㱝	一夕󰁴力
侫	亻亠󰄃女
侴	人一󰁈刂
鄏	厂二󰀖阝
䄏	礻󰁶艹大
嚴	口口厂攵
婡	女木人人
䈘	⺮䒑幺幺
䆰	宀八匚口
䐜	月十󰀣八
尀	匚口寸󰁶
䰀	󰂞彡禾女
㰀	木禾勹氺
㼬	土䒑十丶
伬	亻尸󰂃󰁶
弬	弓匚丨丨
漬	氵貝󰁶
缬	纟士口贝
輬	車󰁸小󰁶
鼬	臼󰁐󰁦由
俖	亻丆卜口
癴	疒言糹手
㲝	毛亻󰁷󰀌
㚪	女毛󰁀
䍧	牜羊󰀢
䃏	石日丿
烏	󰁞灬󰀦
惏	忄木木󰁶
䙴	覀大巳󰀅
噴	口十艹貝
閇	門一卜󰀦
薇	艹彳山夂
疇	田士乛寸
文	文丶一󰂃
㾉	疒人丶󰁻
㙴	土⺈厂言
䟛	口止一丨
㹉	牜厂白小
㸝	丿丨一人
倊	亻八厶心
㴔	氵⺈彐心
䬥	󰀁丶人艮
䕇	艹广白厶
局	尸𠃌口󰀌
㻬	王󰀙二ㄅ
㱀	勹凵丿人
廬	广虍田皿
们	亻门󰁀
绬	纟艹ㄇ大
滬	氵丶尸巴
黬	󰀹土灬口
軬	厶大車󰀬
㺘	犭󰁥亻灬
䕙	艹十戈󰁷
䌉	糹罒一止
䊝	米丿米心
㥋	亻亠󰀔心
䄊	礻󰁶士心
㶝	氵氵广心
䎧	二木立口
㵚	氵八乂金
㽬	一口田田
蕇	艹口口十
镇	钅十󰀣八
汀	氵丁󰀢
籀	⺮扌󰁚田
鏉	釒木口人
䏰	月刀丶心
䠱	口止尸虫
䱦	󰁢灬亻󰁷
䀪	目彳一丁
䛜	言丿囗乂
䐇	月勹󰁤日
㶀	氵月羽彡
䌞	糹人一人
䝰	貝土寸󰁶
㝰	宀丿目方
亞	一󰀚一󰀌
䮘	󰀋灬臼儿
㞫	山之󰁧
湕	氵󰁬󰀟廴
㘝	囗又󰀦
䀧	目󰁺八󰁶
側	亻貝刂󰀢
䫱	丆冂〢貝
甉	䒑󰁬〢丶
䌛	󰁝言丿小
䘜	衤󰁧冂丨
隳	阝工⺗
㤚	忄彳一丁
罭	罒戈口󰀞
蚳	虫󰁚󰀁丶
彭	士口䒑彡
暳	日三丨彐
㽭	田󰀙丆〢
鐇	釒丿米田
䂪	石儿󰀪󰁶
櫰	木亠罒󰀔
涀	氵目儿󰁀
吇	口子󰀝
萇	艹󰀍󰀖󰁧
琇	王禾乃󰁥
㒉	亻⺌冖木
㙛	土甫寸󰁶
㷀	火火⺄十
䏇	耳覀二小
䝮	貝亠幺󰁶
㕙	厶八夂丶
㹚	牜火火口
伈	亻心󰁶
㺝	犭󰁥匚皿
䙜	衤󰁧夂辶
㧴	扌丿扌丶
傠	亻言寸󰁶
㜰	女白幺木
䖞	虫寸󰁶
㕷	口白󰀝
䞜	土󰁾丆卜
㞜	尸彳禾女
畉	田夫󰁶
㦫	忄丿土貝
靬	廿󰀜干󰀢
辭	爫󰁻冂辛
睬	目爫木󰁶
曳	日󰅅󰀏
坬	土⺁厶󰂃
鷀	䒑幺幺灬
㾭	疒禾火󰀦
䭝	人良人日
䔷	艹王王乛
叇	二厶󰁬辶
淀	氵宀一󰁾
珇	王󰀐一󰀝
菇	艹女古󰀘
僁	亻丿米心
䟜	口止冂人
䘛	衤󰁧几󰁀
䲋	󰁢灬夫日
䜜	言󰀥冖目
㻝	王木口刂
䟰	口止彳丁
㕛	又又󰁧
欀	木亠口󰀔
嬀	女爫丿灬
䊇	米甫󰁶
㬀	日󰁸子󰀝
䱟	󰁢灬尸古
䛥	言乂丨
䝜	豸厶八夂
䜊	言一ㄇ日
阳	阝日󰀝
㾝	疒車󰀵
䣷	西一丿未
䀴	目一巛工
忭	忄亠卜󰁶
濭	氵艹土皿
砬	石立󰀝
蠬	虫立月三
㼚	亠几一丶
㰘	木彑米廾
㘳	丬匕土󰀘
俭	亻人一一
愶	忄力力月
儶	亻山亻口
㽛	田勹口󰀝
鄶	人一󰀺阝
儁	亻亻󰁷𠃌
䉷	⺮口口攵
㓲	丶尸冂刂
䁘	目爫𠂉凵
萵	艹ㄇ󰁈口
䋋	糹󰁂󰀁󰁀
䐵	月󰁺由八
䧡	阝广󰁬丨
孀	女󰀙木目
扇	丶尸羽󰀌
㭀	月⺮工人
䉇	⺮󰀎八刂
䘷	衤󰁧㡀󰁶
㐵	亻一󰀛󰀢
萔	艹扌刀口
㝉	宀一󰀘
僶	亻黽󰀝
韬	二𠃌丨臼
輢	車大丁口
䄛	礻󰁶󰀻女
柬	一󰀹󰅇󰀦
噳	口虍口大
虳	虫勹丶󰁶
艇	丿󰁪丿廴
㦚	辛心辛󰀢
䌋	糹艹人口
䙳	覀火󰁧
㙳	土戊一心
舉	󰀗一󰁕󰀟
戉	戈󰁐󰁫
䏵	月乚丶
㠜	山匕𠂉󰁾
㿡	白儿󰀪󰁧
䔴	艹凵山又
䣜	虍󰀐󰀞阝
㣔	彳丁󰀢
㔇	癶弓几刂
䆶	宀八亻灬
唇	厂二󰀖口
䲀	土䒑十灬
㞡	尸工工󰀔
憶	忄立日心
醶	西一人人
䟶	口止人土
䌪	糹門⺈臼
䅺	禾覀二小
㢜	广廿田心
䂛	石󰁻乛亅
袬	亠厶口󰀔
閳	門車󰀵
斳	廿口斤
疳	疒艹二󰀌
佊	亻皮󰁶
牉	丿丨一󰀟
璵	王󰀗一八
㒵	白八󰁧
甇	火火冖丶
攇	扌宀三心
锇	钅丿扌丶
貀	豸凵山󰀢
䢬	爫冖夕辶
喳	口木日一
䘯	衤󰁧⺌月
㢬	弓厶󰁶
腶	月丿丨又
嶱	山艹曰󰄃
䌷	纟由󰀝
䟠	口止戈󰁐
冃	冂二󰀌
㓇	冫丿大󰁶
䓇	艹土󰁖󰁧
哇	口土土󰀝
熉	火口貝󰁶
憉	忄士口彡
膉	月䒑八皿
摵	扌戊上小
㒰	丿󰂃工󰀘
䣡	丷王丿阝
䨉	貝貝女󰁷
㹳	犭󰁥五口
闳	门厶󰀦
衬	衤󰁧寸󰁶
硬	石一日乂
桬	氵小丿木
戶	丿尸󰀏
㣝	彳戈󰁥
䎷	耳丿未󰁶
㸡	丿丨一未
擇	扌罒土十
瓇	王丆󰀐夂
蓇	艹󰀾月󰀘
铇	钅勹巳󰁀
嗳	口爫冖又
䡬	車日罒又
㡬	幺幺戈󰁡
䥙	釒阝䒑󰀓
䆋	禾⺈󰁵󰀝
㹕	二儿丆󰀟
䌰	糹耳耳耳
㽉	匚丨󰁃丶
䜈	言巛日木
㹅	牜勹󰁤心
釶	釒也󰁀
懶	忄木口貝
㨀	扌禾󰁬󰀝
䥠	釒艹戊口
凁	冫木口󰀝
䩔	廿󰀜几又
率	亠ㄠ󰀪十
掇	扌又又又
厇	厂丿七󰁫
䎇	丿󰁪羽󰀝
椬	木宀󰀐一
申	日丨󰀵
蔳	艹氵月
言	言言言言
㷤	士冖一又
䆘	宀八甲󰀬
㐥	釒󰀐󰀞乙
㲱	毛巛囗󰁒
㔫	匕󰁫
䜝	言幺幺󰄃
䝈	一󰀓⺁⺋
㝈	言糹糹子
㘔	口宀󰀀貝
㤬	忄土土󰀝
䤬	釒氵小丿
唳	口丶尸犬
坈	土冖几󰁀
抶	扌丿夫󰁶
銶	釒一氺丶
㮟	木石木󰁶
䖠	虫几丶󰁶
劶	⺁一口力
䡈	車乂乂󰁶
俧	亻士心󰁶
䌘	㡀攵幺小
郎	丶艮阝󰀢
䙔	衤󰁧匚口
䍰	⺶囗大󰁶
捇	扌土󰁖󰁶
獇	犭󰁥⺶厶
䍇	𠂉十凵之
升	丿廾󰀵
磬	士󰁅几石
敳	山一口攵
镳	钅󰁙󰁴灬
鍇	釒󰁴匕白
㺅	犭󰁥⺈大
䙄	衤󰁧丿臼
凲	几䒑󰁬八
㪜	山丆冂又
䍘	罒米󰁧
䇛	⺮止󰀘
䝘	豸几又󰁶
鉋	釒勹巳󰁀
㕳	口乂凵󰀢
牶	丷夫丿󰀟
壬	丿士󰀌
䕳	艹弓一乂
䉱	⺮衤󰁧口
砦	止匕石󰀘
剶	彑󰀓刂󰀢
䬜	几丿虫厶
䞺	土󰁾⺁目
䬄	几丿虫一
䋘	糹二木󰁶
䈱	⺮爫臼󰀘
䮀	󰀋灬勹巳
㮀	木了󰀪凵
戇	立早夂心
宀	宀丶丶乛
䪰	立日立心
㮜	木匚爿士
䛈	言𠂉大󰁶
㺉	士冖一又
咳	口亠ㄥ人
撳	扌釒⺈人
㒳	冂丨丿丶
䦬	門三丨大
與	󰀗一󰁕八
简	⺮门日󰀘
蛈	虫丿夫󰁶
鈇	釒夫󰁶
搉	扌冖亻󰁷
㐉	丁乙󰀅
䆛	宀八口七
㸧	󰀄亅丿艮
钳	钅艹二󰀝
㰉	木一厶禾
璳	王丿未貝
覬	山一口儿
螚	厶月匕虫
䑠	丿󰁪了󰀢
㰙	木廿口󰁷
俥	亻車󰀢
㿷	⺶工皮󰁶
㱜	一夕󰁾󰁶
䌠	戊一口小
㰜	木十󰀣貝
㯀	木方𠂉󰁾
䇇	立󰁂󰀁󰁀
凇	冫木八厶
懇	豸艮心󰁧
䑞	匚火火㐄
䑉	月󰄹月丶
呉	口󰁕一八
䦲	門⺈厂言
擳	扌⺮󰁮卩
哳	口扌斤󰀢
䓳	艹彳艮󰁧
㓳	日一󰁾刂
燇	火丷西寸
诀	讠ユ人󰁶
采	爫木󰁧
㮊	木󰁻乛木
䎘	󰁬十󰀲羽
浖	氵爫寸󰁶
擞	扌米女夂
䠔	口止䒑󰀓
䵥	󰀹土灬巴
铳	钅亠厶儿
蓳	艹廿口
瓳	古一󰁐丶
㮙	木口口ㄅ
㹟	犭󰁥ユ人
㶰	火甘󰀝
䠄	口止ㄇ八
㿅	疒彳止󰁾
䔘	艹𠂉十一
鐉	釒巳巳八
崃	山一米󰁶
䋪	糹阝丁口
丘	󰅍一󰀌
䖔	土厶虍几
䢲	目目亻辶
䬫	人良󰁚丶
㫤	日丶𠃌󰀩
领	人丶󰁻贝
㶤	火夕󰁶
㐳	亻一儿󰁀
䨬	󰀙氵木木
墆	土廿儿丨
梆	木三丿阝
㢆	广日土󰀌
䢆	冖几厂寸
䡫	車夂三辶
䰊	󰂞彡甫寸
㴜	氵丶尸艹
䣲	西一厶廾
㸠	丿丨一󰀪
绥	纟爫女󰀝
稬	禾丆冂大
萳	艹十冂十
騬	󰀋灬禾匕
随	阝月辶
筢	⺮扌巴󰀅
䔔	艹立日儿
㳕	氵丷三󰀝
䠲	丿󰀽三󰁻
䕔	艹彳釒丁
䥥	釒立丿八
㩤	扌甫方攵
㗉	三丨刀口
勑	木人人力
䁚	目口貝󰁶
㹜	犬犬󰁶
䥡	釒丿丨木
䆌	禾禾言
䝱	力力力貝
诙	讠火󰁶
逅	⺁一口辶
者	土丿日󰀘
㑳	亻勹凵丿
槬	木大二󰂃
倅	亻亠人十
䀅	礻󰁶土皿
㡆	冂丨亠󰀸
厘	厂日土󰀌
㸙	八乂土日
㼕	⺌冖口󰂃
䬅	几丿虫力
䪗	󰁆口㐄又
㫄	二勹方󰁣
葳	艹厂一丶
瑳	王⺶工󰀝
㸜	爿宀八工
駬	󰀋灬耳󰀝
㔵	匚巳巳八
蔵	艹戊匚丨
㑦	亻丶尸犬
䆠	宀八匚丨
䟱	口止木冂
䄫	禾己󰁀
蟕	虫止匕用
㿲	大丁口皮
煈	火几丿虫
䆻	宀八乛攵
㪀	一󰀛攵󰁶
㵉	氵氵木木
匇	勹夕󰀦
䌇	糹十冖小
窀	宀八一乚
指	扌匕日󰀝
錇	釒立口󰀝
茇	艹又丶
㺜	犭󰁥ㄇ󰀖
䪕	󰁆口㐄米
檬	木艹冖󰀓
窬	宀八人刂
䎳	耳月󰀝
厳	󰀧厂乛攵
磢	石大乂乂
擵	扌广木手
莳	艹日寸󰁧
鎳	釒丿目木
嶶	山彳山攵
㷵	火󰀹土灬
䆫	宀八勹心
㝘	宀言󰀘
㹱	犭󰁥口󰁾
䘰	衤󰁧丿廴
䶟	止󰀆⺈臼
儈	亻人一日
焈	丶尸巳火
脈	月⺁󰀕󰁶
䦡	門宀󰃧󰀌
㾊	疒木冂󰁫
㖵	口󰀣八󰁶
䖵	虫虫󰁶
䜔	言工辶
㫀	日日斤󰀢
䋇	糹尸󰂃󰁶
嫀	女三人禾
拇	扌母󰁶
狇	犭󰁥木󰁶
苇	艹二𠃌丨
髀	󰀾月白十
䝋	一󰀓宀小
閵	門亻󰁷󰀌
珳	王文彡󰁥
橬	木󰀄󰁜日
婬	女爫丿士
䏳	月扌斤󰀢
䲊	󰁢灬阝月
㻱	王夂三辶
马	󰀊一󰀌
菳	艹金󰀘
䝔	一󰀓艹󰁷
䮅	󰀋灬戈󰁐
䢉	󰀗丿囗󰀖
惈	忄曰木󰁶
䋫	糹⺈󰁬亅
䙰	衤󰁧亠󰁷
㸱	牜𠂉也󰁀
㕵	口王󰀝
䒄	丿󰁪冖田
畵	󰁬土田凵
敵	亠丷冂攵
鍬	釒禾火󰁶
妇	女彐󰀝
箭	⺮䒑月刂
捬	扌广亻寸
宭	宀󰁬丿口
䮭	󰀋灬爫儿
㮭	木󰁻囗十
煆	火󰁃丨又
榇	木立木󰁶
䊫	米罒丨三
㸟	丿丨一日
䥞	釒白方攵
㬬	日目目󰁷
䌳	糹一八丶
嬬	女󰀙丆〢
挳	扌一巛工
第	⺮弓丨丿
茳	艹氵工󰀘
鬬	丨王王斤
镵	钅⺈口丶
㡜	冂丨󰁯小
倵	亻一󰀁丶
故	古夂󰁶
㡶	广口八󰀦
炈	火几又󰁶
肈	丶尸戈󰀟
䤕	西一白木
㴅	水囗八口
㟷	山艹人口
䍫	⺶宀匕󰁀
㺱	亻乃王丶
鎬	釒󰁸冂口
䲤	󰁢󰀞氵一
䆆	禾口口木
奇	大丁口󰀘
厬	厂曰夂口
掬	扌勹米󰁶
膆	月幺小
䭭	䒑丿目貝
憆	忄⺌冖土
熆	火土厶皿
㱏	二止󰀘
䯅	󰀊󰀞耳又
㫬	日勹日󰀝
䜡	言丆󰀐夂
嫬	女广廿灬
䍳	⺶又又又
獳	犭󰁥󰀙〢
捳	扌丘山󰀢
鍳	匚丨󰁃金
荳	艹一口䒑
㶊	氵匚丨貝
䌫	糹匚丨儿
䚏	米夕㐄儿
瘉	疒人一刂
昉	日方󰁥
䢶	木阝󰀢
䳷	彳人人灬
㼢	匚丨口丶
䟡	口止󰁚丶
㸫	牜斤󰀢
䢓	宀一󰀛辶
頇	干丆貝󰁶
㴱	氵宀八丷
䑔	臼一冂丨
标	木二小󰁶
堇	廿口主󰀘
蠇	虫艹曰丶
砇	石文󰁶
䞡	土󰁾日一
䗄	虫八乂斤
䠇	口止尸山
㠇	山󰁸小丶
㛤	女一冂丶
䈟	⺮貝刂󰀬
㺢	犭󰁥󰀙󰁷
䙡	衤󰁧口貝
䇔	󰄹月立丶
䶊	丿目田一
虉	艹一口灬
癉	疒口口十
䙉	衤󰁧⺁目
㙉	土ㄇ󰁺八
䘳	衤󰁧金󰀝
㻢	王方𠂉也
䳥	山人丶灬
䆟	宀八人口
㶅	氵󰀗乂子
㟧	山口口ㄅ
㸢	丿丨一用
㺠	犭󰁥宀󰂃
㘤	囗氵󰀲一
䰦	白󰁜厶十
逆	䒑凵丿辶
吅	口口󰀝
䄎	礻󰁶大口
疉	田田田彑
倆	亻一冂丶
怆	忄人⺋󰁀
瀆	氵士罒貝
耆	土丿匕日
斉	文󰀳󰀘
聵	耳口丨貝
㟇	山人人土
䟇	土󰁾幺人
㹊	牜冖亻󰁷
偵	亻󰀥貝󰁶
䖉	虍一󰀛󰀵
贤	〢又贝󰁧
䄇	礻󰁶口王
䄟	毛毛毛小
㱲	一夕䒑皿
䕡	艹門口口
䙕	衤󰁧彳󰁾
㸖	八乂󰀐一
䜅	言山亻󰁷
㮉	木亻一大
䁟	目⺶工󰀝
䮲	󰀋灬󰁺八
䬕	几丿虫虫
㷢	⺶工火󰁧
㛼	女丿十臼
鼀	土八黽󰀘
蚇	虫尸󰂃󰁶
缀	纟又又又
暇	日󰁃丨又
开	一廾󰀵
䚇	小丿目儿
㼀	王土䒑辶
岭	山人丶󰁻
䲭	󰁚󰀁󰁟灬
㑬	亻女古󰀝
䙅	衤󰁧覀女
鲭	󰁢󰀞主月
葬	艹一夕廾
瑬	氵亠厶丶
沭	氵木丶󰁶
㸆	火丿土三
㱱	一夕白厶
䞁	貝匚日女
㴢	氵氵亻丨
㜼	女又又一
䁲	目罒貝󰁶
割	宀三丨刂
䚆	艹ㄇ大儿
䬲	人良勹口
猵	犭󰁥丶艹
應	广亻亻心
臉	月人一人
䡳	車󰀎八斤
装	丬士亠󰀔
䌵	糹尸氺虫
匵	匚士罒貝
齀	丿目田丶
䱆	󰁢灬乃子
癇	疒門月󰀌
轀	車囗人皿
彀	士冖一又
晇	日大二ㄅ
㽀	丷西一丶
䙇	衤󰁧丆大
䒬	艹二小󰁧
咬	口亠八乂
䛳	言大日乚
㒬	二儿王󰀌
蒬	艹冖⺈丶
钬	钅火󰁶
撬	扌丿二乚
籭	⺮一ㄇ匕
䎔	羽甫寸󰁶
䲢	月丷夫一
䢳	几阝󰀢
㲢	丶尸冂毛
㥧	忄丆貝󰁶
䍉	𠂉十凵八
䪄	廿󰀜󰁺八
苵	艹丿夫󰁧
狵	犭󰁥丶
匉	勹一丷十
䣳	西一𠃌口
䝅	一󰀓土󰀝
㢧	弓一󰀌
瑘	王耳阝󰀢
勵	厂艹曰力
㘜	亻󰁷言口
䫕	亠丷冖貝
䠞	口止戊小
䅲	禾土丿日
䞅	貝厂二口
哠	口丿土口
鰭	󰁢灬土日
哤	口乚丶
䭊	人良艹大
㤇	忄丿大󰁶
召	刀口󰀘
僆	亻車辶󰁶
簭	⺮工人口
礇	石丿ㄇ大
惆	忄󰀼土口
郆	士口阝󰀢
複	衤󰁧𠂉夂
隅	阝日冂丶
獉	犭󰁥三禾
㔕	气力󰁥
䔕	艹月甫󰁧
億	亻立日心
㒡	亻爫𠂉小
掵	扌人一卩
音	立日󰀘
䇻	⺮尸毛󰀅
唓	口車󰀢
恗	忄大二ㄅ
唥	口冫人󰁻
䋉	糹宀八󰁶
芉	艹干󰀬
犉	牜󰁸子󰀝
䞦	土󰁾夂口
捵	扌ㄇ󰁺八
䍵	⺶⺈󰁬亅
腔	月宀八工
䮢	󰀋灬丿臼
鐬	釒止戊󰀤
啓	丶尸攵口
䡅	車川󰀢
䧳	止亻󰁷󰀝
听	口斤󰀢
搬	扌丿󰁪又
篭	⺮立曰乚
儆	亻艹勹夂
愆	彳氵一心
焆	火口月󰀝
脆	月⺈厂⺋
䯭	󰂞彡又󰁧
䢕	戊一辶󰀌
啞	口一󰀚一
啟	丶尸口攵
凴	冫󰀋灬几
䯢	广木木月
㠉	山立日土
䘵	衤󰁧󰁭氺
鋉	釒木口󰀝
㳛	氵臼人󰁶
䮤	󰀋灬冖󰁷
䢅	臼厂二󰀖
䟕	口止又丶
蘵	艹耳亠日
㝞	宀一󰀚一
䬢	人良刀󰁥
䘕	彳亠几丁
瞇	目米辶󰁶
枇	木󰁴匕󰁀
蕬	艹糹幺小
一	一一〇〇
涭	氵爫冖又
啬	十䒑囗口
鸀	罒勹虫灬
螇	虫爫幺大
䈲	⺮丿󰁪又
喢	口丿十臼
聈	耳幺力󰁥
灈	氵目目󰁷
恈	忄厶丿󰀟
䠉	口止宀󰃧
⺶	⺶丶丿丿
㚧	女广󰁥
㳟	󰁺八氺󰁧
䁫	目󰀹土灬
嗙	口亠丷方
䪳	󰁬丿丆貝
旵	曰山󰀬
嗧	力口人艹
乫	力口乙󰀅
耈	土丿匕口
䡉	車亠几󰁀
磽	石土土儿
秗	禾丿大󰁶
㿘	疒火火口
㞇	乚田󰀖
䫢	⺁虍几貝
嘜	口木人夕
嘥	口彳止󰁾
杇	木二ㄅ󰁀
睇	目丷弓丿
疬	疒厂力󰀏
均	土勹冫󰀝
喬	丿大口口
浭	氵一曰乂
蝇	虫口日乚
鹀	工人人一
暵	日廿口夫
皵	󰁺日皮󰁶
㭰	止匕木冂
䨢	󰀙󰀎八󰄃
噈	口󰁸小丶
䫔	三丨刀貝
噏	口人一羽
䌅	糹广󰁬口
癌	疒口口山
忪	忄八厶󰁶
㽖	田力󰁥
㾗	疒丶艮󰀦
糳	业䒑十米
㸶	牜囗大󰁶
躜	口止丿贝
噞	口人一人
噟	广亻亻口
䜤	讠󰁺八󰁶
噦	口止戊󰀤
噧	口艹曰丶
䵣	󰀹土灬一
㝇	󰁸孑󰁸子
䞲	土󰁾丿丶
虵	虫也󰁀
蘇	艹󰁢灬禾
羀	ㄇ乂乂田
癵	疒言糹人
龀	止人凵ヒ
䘇	文虫虫虫
㾀	疒土厶󰀦
昇	曰丿廾󰀬
往	彳丶王󰀝
㴭	氵宀八目
晵	丶尸攵日
哬	口亻丁口
䓬	艹󰀥早󰀬
瓬	方一󰁐丶
洭	氵匚王󰀝
铬	钅夂口󰀝
蓬	艹夂三辶
撉	󰁸孑攵手
䳰	亻口木灬
嚙	口止󰀆󰀢
䉕	⺮丷󰀺日
䚳	言十又󰁶
嚥	口廿口灬
蝚	虫󰁻乛木
䙢	衤󰁧丷日
㽳	疒一󰀛󰀵
镔	钅宀󰅍八
璶	王󰁬丨皿
撶	扌艹一󰀟
匹	匚儿󰁫
䤢	釒口力󰁥
乣	幺乚󰁀
㹣	犭󰁥夂󰁦
翀	羽口丨󰀢
藇	艹󰀗一八
闇	門立日󰀌
㝲	宀爿艹丨
㗇	口󰁃丨又
俀	亻爫女󰀝
嗇	土人人口
激	氵白方夂
囜	囗厶󰀦
㳭	氵口木󰁶
䳭	󰁮卩󰁟灬
峭	山⺌月󰀝
泭	氵亻寸󰁶
甬	󰁻用󰀬
蔬	艹乛止󰀸
锬	钅火火󰁶
囦	囗水󰀦
䬆	几丿虫刂
䛢	言禾几󰁀
蚚	虫斤󰀢
隚	阝⺌冖土
暚	日爫𠂉凵
䚚	⺈用丿儿
嚚	口口匚口
菶	艹三人󰀟
鏶	釒亻󰁷木
䑶	丿󰁪月
䫆	戊𠃌丆貝
圕	囗󰁬土日
㯞	木糹口月
䵡	一大󰀹灬
㓖	冫日艹󰀟
纭	纟二厶󰁶
晬	日亠人十
噬	口⺮工人
亭	󰁸冖丁󰀬
㻲	王󰀻女󰀝
圧	厂土󰀌
麭	木人人巳
虬	虫乚󰁀
㥤	󰁻乛亅心
䛕	言日乂󰁶
㾖	疒日土󰀌
䜢	言宀三心
雚	艹口口󰁷
蛚	虫一夕刂
盚	一氺丶皿
曚	日艹冖󰀓
䛚	三丨刀言
㺛	犭󰁥󰀋廾
蒶	艹糹八刀
䖥	󰁻乛亅虫
乲	冫⺈人乙
㚱	女丘󰀝
挶	扌尸𠃌口
匶	匚艹亻臼
䫷	王口口貝
菆	艹耳又󰁧
㿟	白白󰀝
钇	钅乙󰁀
蒇	艹厂贝丶
璇	王方𠂉󰁾
撇	扌丷冂夂
崀	山丶艮󰁧
㑇	亻⺈彐󰀝
䵀	木人人貝
乭	石乙󰀅
嚬	口止󰀤貝
䟢	口止⺈小
㾣	疒金󰀌
蚬	虫ㄇ󰁜󰁀
鹭	口止夂一
䯝	󰀾月月
䄕	礻󰁶水田
㰆	一口丨木
㶲	火用󰀢
䕱	艹一口貝
垈	亻󰀁丶土
垖	土丿󰃧󰀝
䞢	土󰁾𠂉二
䰖	󰂞彡丿貝
鑶	釒艹戈丨
垜	土乃木󰁶
䒅	丿󰁪丷目
垟	土羊󰀢
㔱	匚󰀗人󰀦
僜	亻癶一䒑
垥	土人一口
䟺	口止貝󰁶
垳	土彳一丁
鵀	亻丿士灬
㯖	木十罒心
瑇	王母󰁶
赀	止匕贝󰁧
嵀	山木丶王
摇	扌爫󰅎山
庀	广匕󰁫
痬	疒曰勹󰁤
眇	目小丿ノ
満	氵󰁺冂山
中	口丨󰀵
蜇	扌斤虫󰁧
渭	氵田月󰀝
嗬	口艹亻口
埅	阝方土󰀘
㗱	口亻󰁷木
埈	土厶八夂
䨧	󰀙立人󰁻
㞞	尸彳人󰁾
埜	木木土󰀘
䅷	禾艹人朩
腷	月一口田
煷	火󰁸冖几
䪖	󰁆口㐄夂
䵲	󰀹土灬木
埧	土󰀣八󰁶
埬	土木曰󰀝
埵	土丿士󰁺
埶	土八土丶
㕅	厂甲󰀵
堁	土曰木󰁶
堄	土臼儿󰁀
堅	匚丨󰁃土
浀	氵ㄇ󰁺󰀝
張	弓󰀍󰀖󰁶
㲲	又又又毛
㺀	犭󰁥勹心
䲲	八厶󰁟灬
什	亻十󰀢
囇	口一冂匕
滀	氵亠幺田
盇	大丶皿󰀘
㘬	土勹厶󰁶
雇	丶尸亻󰁷
嘬	口日耳又
昬	󰁂󰀁日󰀘
醷	西一立心
䤖	西一日氺
堛	土一口田
堜	土木󰀹󰀝
堢	土亻口木
䐱	月亠丷古
堬	土人一刂
報	土䒑十又
㓅	冫丁󰀢
䶅	臼󰁐󰁦口
塅	土丿丨又
映	日ㄇ大󰁶
䇢	⺮古󰀘
㦣	彳󰁆口心
伇	亻几又󰁶
塕	土八厶羽
䴞	󰀥囗󰁘󰁷
塝	土亠丷方
塟	艹一夕土
塡	土匕目八
塢	土󰁞灬󰁶
塤	土口貝󰁶
䌕	糹广木木
㻀	王日乂󰁶
薆	艹爫冖夂
鵇	𠂉㐄󰁟灬
浇	氵弋丿儿
疆	弓土一一
㧣	扌丿未󰁶
䧣	阝覀二小
熷	火丷󰀺日
旉	甫方󰁣
㚽	工一ㄅ女
吱	口十又󰁶
塻	土艹曰大
墄	土戊上小
䖆	艹西一󰀔
喆	士口士口
㝳	一⺗󰀦
㵇	氵丿古甘
䜳	一口䒑󰄃
圳	土川󰀢
朳	木八󰁶
眳	目夕口󰀝
蜳	虫󰁸子󰀝
霳	󰀙阝夂一
㕚	又󰁦󰀦
殄	一夕人彡
䲇	󰁢灬木辶
牷	牜人王󰀝
鉷	釒󰁺八󰁶
㥰	忄臼丨又
剷	立丿丿刂
䥰	釒亠󰄃虫
䜉	言木人氺
冧	冖木木󰁧
镆	钅艹日大
蕆	艹戊貝󰁧
畆	亠田厶󰁶
涇	氵一巛工
墛	土尸二寸
䩣	廿󰀜人朩
丼	二󰀯丶󰀦
墠	土口口十
墡	土羊䒑口
萋	艹一󰁬女
䚽	言毛󰁀
隲	阝小丿灬
转	车二󰁓丶
皲	冖车󰅌又
暲	日立早󰀢
㜳	女亠罒󰀔
鈷	釒古󰀝
珣	王勹日󰀝
䝉	〢丷冖󰀓
䗆	虫宀󰃧󰀝
㤳	忄丆卜口
䵬	󰀹土灬日
丗	一〣一󰀌
㗖	口爫臼󰀝
霰	󰀙󰁺月夂
傧	亻宀󰅍八
壂	尸󰁺八土
壆	󰀗乂乂土
䃷	石󰄹月丶
㷗	丿󰃧巳火
胷	勹乂凵月
惷	三人日心
鐆	阝䒑󰀓金
䬖	几丿虫王
䝆	勹󰁤一󰀓
㽊	言火火丶
寇	宀二儿又
搆	扌󰀀冂土
篇	⺮丶尸艹
诇	讠冂口󰀝
蚉	文虫󰁧
隉	阝臼工󰀝
㐆	⺁彐𠃌󰁫
䐆	月爫木󰁶
纳	纟冂人󰁶
辬	辛文辛󰀢
庳	广白丿十
曲	ㄇ󰁺󰀌
佬	亻土丿匕
㚲	女󰀥口󰀝
壛	土門⺈臼
九	九丿󰁊
壥	土厂󰀹土
㽇	󰀗乂乂丶
壦	土艹口󰁷
䭣	人良󰀴󰀳
抷	扌丆卜一
惛	忄󰁚󰀁日
䊷	糹󰀛丿󰁥
劷	⺶力󰁥
㛉	女西󰀝
䛉	言󰁂󰀁󰁀
囉	口罒糹󰁷
盉	禾皿󰀘
䆅	禾冫⺈貝
鰇	󰁢灬󰁻木
夅	夂㐄󰀬
夆	夂三丨󰀬
揆	扌癶一大
叆	二厶爫又
谇	讠亠人十
簇	⺮方𠂉大
夊	ク󰂃󰀦
鹳	艹口口一
䰇	󰂞彡土日
㰇	木十戈󰀞
湳	氵十冂十
嘲	口十日月
蘲	艹田田土
翬	羽冖車󰀬
㺳	王󰀥又󰁶
侬	亻冖󰀔󰁶
䡰	士󰁅几車
⺳	冖丿󰁏󰀅
㡰	广一󰀛󰀵
踝	口止日木
夒	丆目止夂
耖	三󰅇小丿
䤆	西一癶大
夛	󰁭夕󰁧
姿	冫⺈人女
夝	夕丿󰀝
亇	⺈亅󰀬
夦	󰀎八󰄃夕
夲	大十󰀬
夳	大二󰀘
劆	广䒑󰁬〢
橇	木丿二乚
㩇	扌󰁬土一
䩇	丆囗〢口
㢰	弓皮󰁶
䢰	羽亻󰁷辶
入	丿󰂃󰀦
夶	大大󰁶
鸳	夕⺋勹一
㙖	土丿口丶
㹇	牜日勹󰄃
夻	大口󰀘
銆	釒丆日󰀝
渳	氵弓耳󰀝
穇	禾厶厶彡
芆	艹又丶󰁧
偙	亻亠丷丨
㞚	尸丿十臼
乳	爫孑乚󰁀
㘲	土尸九󰁀
䞚	土󰁾十又
䰣	丿田儿乂
㱣	一夕爫女
奊	土土󰁕󰂃
㹗	牜士乛寸
奐	⺈ㄇ八大
䟆	土󰁾日󰀟
這	言辶󰀌
瀙	氵立朩儿
㓢	夂口刂󰀢
奜	丨三丨大
釷	釒土󰀝
扆	丶尸亠󰀔
剆	丶󰁮刂󰀢
䪇	廿󰀜艹寸
㪇	丿土儿攵
燷	火亠囗小
凷	土凵󰀵
䧰	阝󰁢灬小
奦	󰁻乛亅大
閲	門丷口儿
跳	口止儿󰀪
疲	疒󰅌又󰀦
淳	氵󰁸子󰀝
䠆	口止󰀍󰀖
鉆	釒󰀥口󰀝
艆	丿󰁪丶艮
牆	爿土人口
㠆	山口口十
奫	大氵󰀲一
㙲	土亠󰁲󰁷
䙲	覀大󰁧
䠖	口止冫口
㿗	疒禾几貝
㒢	亻人一艹
奱	言糹糹大
谠	讠⺌冖儿
歼	一夕丿十
歇	日勹人人
䜚	言罒󰀫辶
圚	囗口丨貝
朚	亠󰄃日月
儅	亻⺌冖田
䬛	几丿虫󰀟
攆	扌夫夫車
糇	米亻ユ大
蔆	艹氵土夂
鳇	󰁢󰀞白王
獚	犭󰁥󰁺八
䴣	󰁙󰁴󰁴󰀛
㬛	日人一羽
怶	忄皮󰁶
足	口󰁾󰁧
闲	门木󰀦
旲	曰大󰁧
痲	疒十儿儿
倶	亻目一八
㔆	󰀄󰁜󰀄刂
䳇	母󰁟灬󰁶
唆	口厶八夂
妑	女巴󰁀
妔	女亠几󰁀
㖖	辛口󰀘
妡	女斤󰀢
巳	巳󰁈一乚
䖲	虫勹日󰀝
㖲	女口口匕
妢	女八刀󰁥
銚	釒儿󰀪󰁶
犚	尸二小󰀟
缐	纟白水󰁶
蠷	虫目目󰁷
頷	人丶乛貝
䠷	丿󰀽三󰀪
妿	力口女󰀘
䫇	彡冂二貝
瓆	王斤斤貝
擆	扌艹土日
铆	钅󰁚丿卩
蓆	艹广廿丨
䑲	丿󰁪󰀥早
姉	女一冂丨
䡖	車一八土
倕	亻丿士󰁺
甲	甲丨󰁈丨
攲	大丁口又
锲	钅三丨大
赳	土󰁾󰁐丨
㓆	冫人匕󰁀
姖	女匚󰁃󰀝
崇	山宀二小
䓆	艹扌斤󰀬
苚	艹用󰀬
狚	犭󰁥日一
勚	廿󰄃贝力
䪛	󰁆口㐄田
䶳	人一口几
嗲	口八乂夕
㪛	󰀎八󰄃又
㶳	󰁬󰀟火󰁧
姟	女亠ㄥ人
傶	亻戊上小
悶	門心󰀦
䪽	口一ㄅ貝
䟅	車斤土󰁾
䲳	亠几󰁟灬
㲳	󰁚󰀁丶夫
姵	女几一丨
隧	阝䒑󰀓辶
㭇	木厶儿󰁀
姷	女月󰀝
䨇	亻󰁷又又
掆	扌冂䒑山
玆	亠幺亠幺
䭇	人良勹口
历	厂力󰀏
敲	󰁸冂口又
畲	人二小田
蕲	艹丷󰅐斤
魇	厂犬白厶
㳳	氵十口儿
䳳	凵山二灬
㹛	牜丆目夂
嘚	口彳曰寸
蘚	艹󰁢灬羊
娍	女戊𠃌󰁀
娕	女木口󰀝
娖	女口󰁾󰁶
㵳	氵宀羽彡
娚	女田力󰁥
唲	口臼儿󰁀
䔲	艹癶一䒑
䴳	木人人八
䓶	艹木口刂
娝	女丆卜口
蔶	艹貝󰁧
甶	丿田󰀌
娡	女士心󰁶
娢	女人丶口
㙚	土丷王󰀟
㮇	木一大⺗
癚	疒⺈厂言
娦	女丘八󰁶
陚	阝一󰀁丶
箇	⺮囗古󰀘
钲	钅一止󰀝
宇	宀一󰀛󰀬
䮇	󰀋灬󰁬󰀟
䍆	𠂉十凵丁
䥽	钅ㄥ丿丶
鮇	󰁢灬未󰁶
荆	艹一廾刂
娬	女一󰀁丶
娯	女口󰁕八
䵳	󰀹土灬日
娰	女亻󰁐人
㔲	匚人良九
娷	女丿士󰁺
湔	氵䒑月刂
蓶	艹口亻󰁷
哶	口丨一干
㕲	口木󰁶
䕲	艹广亠小
啲	口白勹丶
擶	扌⺮䒑刂
㷛	亻口木灬
蛛	虫󰅎󰅇󰁶
䦽	阝󰁻乛亅
薚	艹一夕󰁤
閚	門立󰀌
䟽	口止亠󰀸
婋	女虍几󰁀
㧇	扌冂一󰀝
䧇	阝亠󰀔󰁶
姇	亻寸女󰀘
戆	立早夂心
铲	钅立丿ノ
婓	丨三丨女
瓲	一󰁐󰁊乚
蓲	艹匚口口
婖	女一大⺗
婘	女丷夫⺋
㕶	口五󰀝
迵	冂一口辶
秇	禾九丶󰁶
觇	󰀥口ㄇ󰁜
駇	󰀋灬攵󰁶
営	󰀧冖口口
薶	艹豸曰土
懊	忄丿ㄇ大
㶛	氵方𠂉八
藚	艹士罒貝
痚	疒土丿子
旚	方𠂉覀小
丳	口口󰀯󰀵
項	工丆貝󰁶
泳	氵丶𠃌󰀩
峳	山亻丨攵
䒲	艹女丿七
㒲	丿󰂃日󰀘
䠅	口止囗禾
㠅	山彳𠂉夂
闚	門夫目儿
婰	女ㄇ󰁺八
䇆	立󰁦十󰀢
㨇	氵皮手󰀬
懆	忄口口木
娇	女丿大󰀯
萲	艹爫一又
米	米丶丿󰂃
䡽	車丿土貝
鐲	釒罒勹虫
傼	亻廿口夫
㿬	皮巴󰁀
媁	女󰁆口㐄
媂	女亠丷丨
訇	勹言󰀌
稇	禾囗木󰁶
㿰	六乂皮󰁶
騇	󰀋灬人口
㵛	氵羊䒑口
䔚	艹厂二月
媊	女䒑月刂
亾	人󰄃󰁫
䣣	⺌冖口阝
媜	女󰀥貝󰁶
逄	夂󰀂丨辶
嗶	口曰艹󰀟
哲	扌斤口󰀘
蟅	虫广廿灬
倄	亻乂月
怄	忄匚乂󰁶
㟅	山乂凵儿
䀄	宀心丿皿
㸷	三丨刀󰀟
卷	䒑大⺋󰀅
䯇	󰀾月力󰁥
蘶	艹禾女厶
瘶	疒木口人
䤣	釒丿丷󰀛
瑲	王人丶口
葲	艹白水󰁧
鑲	釒亠口󰀔
媱	女爫𠂉凵
㕆	厂古󰀌
䶇	臼󰁐󰁦月
㖥	口囗禾󰁶
䥗	釒士二人
邚	女阝󰀢
嚶	口貝貝女
䥣	臼工几金
挗	扌一弓人
嫅	女⺶工󰀝
痶	疒ㄇ󰁺八
嫐	女田力女
嫕	女匚𠂉心
凣	丨几󰁫
⺷	丷王󰀘
㙶	󰁸⺌冖土
㼮	一󰁬丨丶
䐲	月羽白󰀝
㱳	艹日大夕
汳	氵⺁又󰁶
屳	丿󰂃山󰀬
氇	丿二乚日
嫢	夫目儿女
皶	木日󰀞皮
暶	日方𠂉󰁾
㜇	女土土心
嫧	女貝󰁶
鯳	󰁢灬广丶
诳	讠犭ノ王
嫲	女广木木
嫳	㡀攵女󰀘
嫵	女𠂉一灬
㱛	一夕一夕
䱛	󰁢灬戈󰀞
搚	扌力力月
萚	艹扌又󰀟
鐚	釒一󰀚心
㹭	犭󰁥日丿
嫾	女米夕㐄
嬅	女艹一󰀟
嬆	女人一羽
嬇	女口丨貝
嬊	廿口丬女
嬋	女口口十
虶	虫一󰀛󰀢
嬔	女⺈口
㒖	亻艹日丶
珊	王󰀼󰀼一
摚	扌⺌冖土
㑲	亻十冂十
䰳	󰁢灬丁󰀢
尳	乚󰀾月
摲	扌車斤󰀢
呚	口攵󰁶
勶	彳亠厶月
䋶	糹丆貝󰁶
嬜	立日⺈女
嬞	女艹丿土
嬟	女丷王丶
讳	讠二𠃌丨
鮳	󰁢灬土ㄅ
䌆	糹白󰁜厶
嫇	女冖曰六
挆	扌几木󰁶
猆	丨三丨三
茆	艹󰁚丿卩
錆	釒月󰀝
嬤	女广木幺
嬥	女羽亻󰁷
㒇	亻𠂉一灬
䴀	立日土灬
嬧	女󰁬丨皿
嬰	貝貝女󰀘
猶	犭󰁥丷一
㷐	火臼土󰀝
㔬	匕早󰀬
抵	扌󰁚󰀁丶
瑕	王󰁃丨又
嬺	女匚艹心
嬾	女木口貝
嬿	女廿口灬
㯳	木艹勹攵
孄	女門木󰀹
孆	女貝貝女
孉	女艹口󰁷
玲	王人丶󰁻
掲	扌曰勹匕
厲	厂艹曰丶
䎲	耳乙󰁀
録	釒󰁭氺󰁶
茲	艹幺幺󰁧
㬇	日⺈ㄇ大
孊	女广木三
勆	丶󰁮力󰁥
䬇	丷口儿虫
笇	⺮亠卜󰁧
欇	木耳耳耳
鋆	土勹冫金
苆	艹七刀󰁣
㘗	口目目󰁷
㓬	丷夫刀刂
鋶	釒亠厶󰀸
狶	犭󰁥乂丨
㮗	󰁻乛亅木
孞	子心󰁧
㖬	口臼又󰁶
䝇	八儿一󰀓
孧	幺力子󰀘
孭	孑貝󰁶
孯	匚丨󰁃子
玶	王一丷十
厖	厂乚丶
孷	未攵厂子
孾	孑貝貝女
㮳	木月䒑大
䌚	糹覀米󰁶
猚	犭󰁥亻󰁷
揲	扌廿󰄃木
箳	⺮尸䒑廾
䮳	󰀋灬丿田
史	口乂󰀦
荲	艹曰土󰀘
鍲	釒󰁂󰀁日
鬭	丨王王斤
埝	土人丶心
昰	曰一止󰀘
胵	月一厶土
㐬	亠厶󰀸󰀅
䣇	一氺丶阝
䓗	艹八厶心
㻐	王厶八夂
獶	犭󰁥丆夂
荶	艹口人乛
鍶	釒田心󰁶
䤇	西一宀又
䭰	禾日三󰀟
摷	扌巛曰木
䦆	钅目目又
僅	亻廿口
䔗	艹礻󰁶羊
㦆	忄虍丿󰀛
覆	覀彳𠂉夂
郅	一厶土阝
情	忄主月󰀝
烅	火丿皿󰀝
宧	宀匚丨丨
雛	勹凵丿󰁷
㭳	木土丿子
霐	󰀙氵弓厶
孳	䒑ㄠㄠ子
䭳	禾女白日
筳	⺮丿士廴
鋳	釒三丿寸
宱	宀亻𠂉二
宲	宀口木󰁧
奤	大丆囗二
䵐	󰁺由八十
㱭	一夕丿又
㙗	土田一󰀖
䱭	󰁢灬忄一
佀	亻󰃧󰀝
搷	扌十󰀣八
琷	王⺶乚󰁀
䐷	月口口十
寋	宀󰀀八⺋
眛	目未󰁶
䴐	宀王𠂉灬
㸔	丿丷目
寘	宀十󰀣八
奆	大匚󰁃󰀘
䄅	丷夫二小
㥆	忄󰁬氺󰁶
㚗	大󰀐一󰀘
鄅	丿口冂阝
脅	力力力月
祆	礻󰁶一大
愅	忄廿󰀜󰀢
㚇	乂凵八夂
伀	亻八厶󰁶
寛	宀艹目儿
㬳	月𠂉十󰀢
䬳	人良丷󰀟
卲	刀口卩󰀢
欳	󰀥冂艹人
笳	⺮力口󰀘
箬	⺮艹口
讬	讠丿七󰁀
劳	艹冖力󰁣
抳	扌尸匕󰁀
㮬	木八厶羽
䊳	米广木三
寜	宀心皿亅
寢	宀爿彐又
寣	宀爿言󰀘
寧	宀心皿丁
寫	宀臼勹灬
寭	宀一曰心
遅	尸羊辶󰀵
勷	亠口口力
恾	忄艹亠󰄃
䟗	口止󰁚󰀁
偅	亻丿一土
濇	氵土人口
灅	氵田田土
聅	耳𠂉大󰁶
㟗	山八刀刀
寲	宀匕𠂉󰁾
㿇	疒羽白󰀌
䁅	目子皿󰀝
寳	宀王⺈貝
寶	宀王𠂉貝
尃	甫寸󰁧
將	爿󰁝寸󰁶
䠗	口止丿犬
鉳	釒丬匕󰁀
蒷	艹口貝󰁧
䫬	󰀄󰁜󰀄貝
譬	尸口立言
狳	犭ノ人木
拳	䒑大手󰀬
孬	丆卜女子
䭬	匕日巛目
㭬	木一󰀓󰁶
䬰	人良刀口
喧	口宀一一
䩛	廿󰀜心丿
爚	火人一艹
㬰	日人󰀦
暛	日⺶工󰀝
嚛	口白幺木
韆	廿󰀜覀辶
䚛	⺈用丿口
㺔	犭󰁥爫灬
悅	忄八口儿
埆	土⺈用󰀢
蟆	虫艹日大
炅	日火󰁧
䎬	二木罒厶
尠	󰀎八󰄃丿
䂅	目言糹虫
㟆	山亻ヒ十
尡	⺌一儿匕
尣	八儿󰀅
尦	八儿勹丶
匳	匚人一人
䬬	人良ㄇ大
䍬	⺶一丷十
鮬	󰁢灬大ㄅ
牚	⺌冖口丿
刳	大二ㄅ刂
戳	羽亻󰁷戈
爳	爫丿乛了
谬	讠羽人彡
䦇	󰂞八ㄅ󰁀
䩱	廿󰀜人刂
㰬	勹日⺈人
䈳	⺮日羽󰀘
戰	口口曰戈
鈰	釒亠冂丨
湀	氵癶一大
䩬	廿󰀜三󰀟
䫀	󰁮丆貝󰁶
屇	尸田󰀌
䪬	立日十子
屖	尸辛󰀵
仸	亻丿大󰁶
憷	忄木木󰁾
屗	尸毛寸󰀦
䪀	廿󰀜宀心
熚	火曰艹󰀟
憚	忄口口十
屜	尸彳廿󰄃
屝	尸丨三三
鹇	门木勹一
屢	尸󰀻女󰀌
皆	󰁴匕白󰀘
蹇	宀󰀀八󰁾
嚆	口艹亠口
湇	氵立月󰀝
㚆	亠日夂󰁧
乇	丿七󰁫
扳	扌⺁又󰁶
寬	宀艹目丶
诬	讠工人人
篬	⺮人丶口
層	尸丷󰀺日
屫	尸爿丿口
䯬	󰁸囗口十
㯬	木木󰁬廴
䡆	車八厶󰁶
㧬	工几丶手
䑳	丿󰁪人艹
鏷	釒业䒑夫
㦛	󰀗一ㄅ心
㯰	木罒十󰀣
燚	火火火火
懚	忄爫工心
凚	冫木木小
筭	⺮王廾󰀬
屷	山乃󰁥
釚	釒九󰁀
劰	白力󰁥
吳	口󰁕大󰁧
䐳	月󰁢灬󰁶
岄	山月󰀝
㢗	广丿大口
陆	阝󰀟凵󰀢
躇	口止艹日
癆	疒火火力
溇	氵米女󰀝
噆	口󰀄󰁜日
䙆	衤󰁧癶大
㙆	土宀厶
䲬	󰁟灬󰁚󰀁
决	冫ユ人󰁶
䢗	ㄇ󰁺辶󰀌
㲬	亻󰁷灬毛
膳	月䒑󰀟口
鲬	󰁢󰀞󰁻用
憳	忄彐工寸
粬	米ㄇ󰁺󰀝
偖	亻土丿日
岊	巴山󰀬
鄚	艹曰大阝
䨱	󰀙彳𠂉夂
审	宀日丨󰀬
牰	牜由󰀝
岝	山𠂉丨二
凗	冫山亻󰁷
岤	山宀八󰁶
㤆	忄⺁又󰁶
䅅	禾土土󰀝
充	亠厶儿󰀅
椆	木󰀼土口
煅	火亻三又
腅	月火火󰁶
酅	山亻󰁷阝
岥	山皮󰁶
岦	山立󰀘
磊	石石石󰀘
䦐	門手󰀵
䣬	西一戈󰁶
啳	口丷夫⺋
鄰	米夕㐄阝
䩀	丨三丨貝
屬	尸氺罒虫
䇳	⺮二戈󰁧
㱬	一夕田󰀖
㟭	山󰁂󰀁日
釳	釒𠂉乙󰁀
至	一厶土󰀘
燳	火日刀灬
懳	忄三丨心
䄰	禾󰀄亅丿
履	尸彳𠂉夂
谧	讠心丿皿
峅	山厶廾󰀢
峆	山人一口
峇	山人一口
峈	山夂口󰀝
峉	山夂口󰀘
㣆	弓一八王
峊	丿󰃧山󰀬
内	冂人󰀦
䣆	一巛工阝
磆	石󰀾月󰀝
憅	丿一曰心
醅	西一立口
裆	衤󰁧⺌彐
弛	弓也󰁀
峤	山丿大󰀯
䨀	丿丶米󰁷
崮	山囗古󰀘
峛	山一夕刂
䪱	󰁁丆貝󰁶
峟	山月󰀘
巅	山十󰀣贝
峢	山一夕刂
㴬	氵丿󰀽寸
䴬	木人人丶
儳	亻⺈口丶
愳	目目心󰁧
焳	火亻󰁷󰀝
贬	贝丿之󰁶
鴬	󰀧冖󰁟灬
䔛	艹󰁴丆貝
峱	犭󰁥󰁈山
耚	二木皮󰁶
㳀	氵戈󰁶
島	󰁟山󰀵
峷	山辛󰀬
醰	西一覀早
憰	忄󰁻乛口
㡛	冂丨艹󰀸
䡛	車車󰀢
峔	山土丿匕
㧱	人一口手
崄	山人一一
㞆	乚大口
获	艹犭󰁥犬
崊	山木木󰁶
潇	氵艹󰁬󰀯
瞆	目口丨贝
佇	亻宀丁󰀢
垆	土󰀥尸ノ
䄗	礻󰁶󰀲一
崋	山一艹󰀟
螆	虫䒑幺幺
鞆	廿󰀜一人
㳬	氵𠂉乛󰁾
搐	扌亠ㄠ田
关	䒑大󰁧
䳬	廿󰀜󰁟灬
煳	火古月󰀝
慳	忄匚丨土
鳬	󰁟几󰀅
腳	月八人卩
晆	日土土󰀝
徙	彳止󰁾󰁶
崘	山人一艹
崙	山人一艹
崚	山土八夂
崜	山丿士󰁺
䭀	人良⺄辶
則	貝刂󰀢
煰	火口口口
䅰	禾囗大心
忡	忄口丨󰀢
䠬	口止癶阝
㝆	孑士口口
㿭	斤丶皮󰁶
崬	山木曰󰀘
崯	山金󰀝
睆	目宀二儿
杆	木干󰀢
徇	彳勹日󰀝
侇	亻一弓人
崱	山貝刂󰀬
韛	󰁆口㐄用
龇	止人凵匕
辇	二人二车
䤐	西一󰀄日
䠼	丿󰀽三刂
䝬	貝丶王󰀝
嵔	山田一󰀖
赭	土󰁖土日
䀰	目八人口
倰	亻土八夂
耰	二木丆夂
鶬	人丶彐灬
㾽	疒丿󰃧辶
炳	火一冂人
肳	月勹󰁤󰁥
傳	亻一曰寸
涬	氵土䒑十
㶬	火一木󰁶
䂳	石人人土
侽	亻田力󰁥
嵐	山几丿虫
䞬	土󰁾禾乃
㚳	女力口󰀝
嵅	山戊一口
嵕	山乂凵夂
灚	氵󰀗乂儿
嵗	山戊一󰀤
瘆	疒厶大彡
蘆	艹虍田皿
阆	门丶彐󰀖
遚	臼丨又辶
㘆	口士口土
䘆	虫宀三心
巇	山虍一戈
淇	氵艹三八
嵜	山立口亅
臰	丿目一匕
䠛	口止爫凵
㽽	疒古󰀌
䶀	士口䒑口
嵡	山八厶羽
嵥	山夕㐄木
嵰	山䒑󰁬八
啇	亠丷冂古
鵬	月月󰁟灬
胳	月夂口󰀝
烳	火甫󰁶
想	木目心󰁧
僳	亻覀米󰁶
䃳	石巛囗󰁒
㵬	氵月乃皿
蝛	虫戊一女
嶈	山爿󰁝寸
䪥	󰀥冖一一
杛	木弓󰁀
嶊	山扌亻󰁷
㨐	扌亻口木
悰	忄宀二小
摼	扌匚丨土
藆	艹宀󰀀手
痆	疒尸匕󰁫
䣱	西一勹口
鸇	亠囗口灬
万	一󰁡󰀏
㗆	口廿󰀜󰀢
渇	氵曰勹匕
帇	󰁬冂丨󰀵
肰	月犬󰁶
䘭	衤󰁧一土
钆	钅乚󰁀
唀	口禾乃󰁥
璆	王羽人彡
豇	一口䒑工
咆	口勹巳󰁀
汇	氵匚󰁀
㱇	土人人人
耳	耳一丨一
逳	亠厶月辶
嶕	山亻󰁷灬
㸬	牜一冂丨
丬	丬丶󰀞丨
帬	󰁬丿口丨
怳	忄口儿󰁀
嶗	山火火力
瞛	目彳人󰁾
勗	曰󰀐󰀞力
䘽	衤󰁧臼儿
嘽	口口口十
䞛	土󰁾一ㄅ
㞛	尸彳匕日
荡	艹氵ㄋ󰁤
恀	忄夕夕󰁶
聰	耳丿囗心
䗭	虫口口心
嶦	山⺈厂言
䕀	艹士二人
㕀	由⺋󰀅
嶫	山业䒑未
嶬	山丷王丶
嶭	山丿󰃧辛
嶮	山人一人
䌗	糹𠂉一灬
鑆	釒业丷寸
葆	艹亻口木
瑆	王日丿
摆	扌罒土厶
岇	山󰁚卩󰀬
跬	口止土土
㑆	亻口儿󰁀
嶰	山⺈用󰀟
遳	艹人人辶
䁳	目艹犬廾
㷬	火艹日大
淬	氵亠人十
偳	亻山丆〢
嶲	山亻󰁷𠃌
職	耳亠丷日
䚭	⺈用艹󰁷
嶾	山爫工心
灷	火廾󰀬
恷	亻木心󰁧
㚭	女乚丶
鋛	釒口口丨
狛	犭󰁥白󰀝
伟	亻二𠃌丨
勛	口貝力󰁥
缟	纟󰁸冂口
巊	山貝貝女
䚀	丿󰁪目儿
䑗	臼日一󰁤
巋	山丿󰃧丨
巐	山󰁸冂廾
巔	山十󰀣貝
巕	山䒑丿女
䙭	衤󰁧宀󰁾
巖	山口口攵
㺬	王几丶󰁶
怷	十儿丶心
瀷	氵羽田八
溬	氵⺶乚厶
纬	纟二𠃌丨
京	󰁸小󰁧
庬	广乚丶
䀷	目土厶力
倷	亻大二小
躬	丿󰀽三弓
麬	木人人皮
忝	一大⺗󰁧
䛿	言一口丨
巭	工力夫󰁧
巰	一巛工󰀸
礀	石門月󰀝
䥮	釒覀匚卩
辟	尸口辛󰀢
㻇	王人王󰀝
仇	亻九󰁀
圆	囗口贝󰀦
滇	氵十󰀣八
织	纟口八󰁶
蜆	虫目儿󰁀
霆	󰀙丿士廴
馾	󰀋灬冖󰁜
墈	土󰀎八力
㘀	口臼米󰁶
榮	火火冖木
䙛	衤󰁧六󰀔
抁	扌厶儿󰁀
㹬	犭󰁥一乂
䜿	匚丨󰁃䒑
臷	十戈一土
噀	口巳巳八
繬	糹土人口
湬	禾火水󰁧
幬	冂丨士寸
乬	匚󰁃乙󰀅
䙀	衤󰁧月月
㙀	土宀八九
鹬	󰁻乛亅一
蹬	口止癶䒑
㖭	口丿大⺗
䜰	八人口十
悷	忄丶尸犬
㽱	疒󰁐丨󰀵
犛	未攵厂󰀟
䊛	米乂朩又
㛆	女乃木󰁶
藛	艹宀臼灬
囆	口艹曰虫
䛆	言由󰀝
缇	纟日一󰁾
曆	厂禾禾曰
集	亻󰁷木󰁧
輇	車人王󰀝
嗛	口䒑󰁬八
旛	方𠂉丿田
䕷	艹广木小
柞	木𠂉丨二
蕷	艹󰁻乛貝
長	󰀍󰀖󰁧
帣	丷夫冂丨
㖽	口丆貝󰁶
䕭	艹土八火
䗐	方𠂉也虫
疅	田一田一
斅	󰀗乂乂又
鳆	󰁢󰀞𠂉夂
薅	艹女厂寸
㟀	禾山󰀬
厗	厂辛󰀵
㽔	业󰀓丿
䕽	艹口止虫
昛	日匚󰁃󰀝
蘛	艹󰀎八月
㔐	⺮一丨刂
䜀	言刀丶止
䓅	艹氵斤󰀬
哅	口勹乂凵
㐽	亻几乂󰁶
㶆	氵言土日
幊	冂丨工貝
幋	丿󰁪几丨
幏	冂丨宀󰀓
幐	月丷夫丨
姾	女人王󰀝
㘛	口人一三
䏭	月丿未󰁶
幘	冂丨貝
幝	冂丨口十
幟	冂丨亠日
幠	冂丨𠂉灬
幣	㡀攵冂丨
幨	冂丨⺈言
蟰	虫󰁬十󰀲
矰	𠂉大丷日
幱	冂丨門󰀹
洆	氵了󰀩一
畅	日丨ㄋ󰁤
蕅	艹氵曰丶
鴆	冖󰁜󰁟灬
疛	疒寸󰀦
幷	丿一干
閷	乂朩門人
庁	广丁󰀵
庈	广人丶乛
䛐	𠃌一口言
䖛	虍几十小
㾔	疒口口󰀌
㳆	氵󰁦十󰀢
㵰	氵󰀗一八
喅	口曰立󰀝
䳆	白󰁟灬󰁶
駒	󰀋灬勹口
䵰	󰀹土灬󰁤
䑽	丿󰁪日羽
庘	广甲󰀵
癷	癶干󰀬
虷	虫干󰀢
䱔	󰁢灬亻攵
僛	亻󰀎八人
䘐	丿皿刀八
匬	匚人一刂
庨	广土丿子
塳	土夂三辶
䆇	禾几󰁟灬
驆	󰀋灬曰󰀟
舅	臼田力󰁣
穆	禾白小彡
磮	石山人艹
磁	石䒑ㄠㄠ
䙐	衤󰁧一丨
蘷	艹丆日夂
昷	曰皿󰀘
瘷	疒木口攵
焛	門火󰀦
鄛	巛曰木阝
乮	󰁚丿卩乙
庽	广曰冂丶
儛	亻𠂉一㐄
樒	木宀心山
勽	勹人󰀦
㴆	氵彐冖丨
䴆	业䒑夫灬
啅	口󰀥早󰀢
廁	广貝刂󰀵
兇	乂凵儿󰀅
䅇	覀禾󰁧
㞐	尸立󰀌
廄	广󰁮几又
䎭	二木丿辶
蓷	艹扌亻󰁷
擷	扌士口貝
䀇	古𠂉十皿
䟐	土󰁾厂止
廘	广󰁙󰁴匕
廙	广田󰁺八
骆	󰀊󰀞夂口
朽	木一ㄅ󰁀
窆	宀八丿之
臅	月罒勹虫
䣔	⺌貝阝󰀢
摛	扌亠乂厶
鑛	釒广󰁺八
䚷	言八一ㄅ
䍽	⺶厂禾止
廡	广𠂉一灬
廣	广󰁺由八
䂗	石ヒ󰁀
皷	士口䒑皮
蚷	虫匚󰁃󰀝
隷	士二小氺
晅	日一曰一
暑	日土丿日
䈬	⺮氵甫󰁧
㹾	犭󰁥夂口
㝐	宀八厶󰁧
戅	立早工心
婆	氵󰅌又女
䈅	⺮戈口󰀞
㩆	扌󰁸小丶
獷	犭󰁥广八
弅	八刀廾󰀬
弇	人一口廾
湠	氵山火
凬	几一日󰀌
䇬	⺮丿未󰁧
䍷	⺶󰁆口㐄
恧	丆冂〢心
弔	弓丨󰀵
弖	弓一󰀘
弙	弓一󰀛󰀢
弜	弓弓󰁀
鏛	釒⺌冖丨
钅	钅丿一󰁐
傾	亻󰁴丆貝
珛	王月󰀝
撅	扌厂䒑人
密	宀心丿山
蒅	艹氵九木
篆	⺮彑󰀓󰁧
㲆	士󰁅几󰁻
䲆	󰁢灬󰁢灬
菛	艹門󰀘
弡	弓匚󰁃󰀝
䊬	禾日木米
䂆	󰁻乛亅丶
匷	匚目目󰁷
斗	󰁦十󰀵
弮	丷夫弓󰀅
䤔	氵車斤一
选	丿土儿辶
㷰	火亠乂厶
葵	艹癶一大
彃	弓曰艹󰀟
彆	㡀攵弓󰀅
䈀	⺮󰀼󰀼刂
彉	弓󰁺由八
藷	艹言土日
彑	彑ㄥ乛一
䄬	禾也󰁀
潭	氵覀早󰀢
鍛	釒丿丨又
彙	彑冖日木
彚	󰁭冖曰木
鑅	釒火火木
䧔	阝人丶心
卛	言糹糹十
捛	扌口口󰀝
将	丬夕寸󰁶
摅	扌󰅋七心
瑅	王日一󰁾
谆	讠󰁸子󰀝
獛	犭󰁥业夫
㥿	󰁡攵心
䯆	󰀾月乚󰁀
㒅	亻亠夕󰀔
厷	厶󰁧
彧	戈口󰀞󰁤
彨	一冂丶彡
䎛	土丿匕口
鶨	彑󰀓󰁟灬
鎛	釒甫寸󰁶
殆	一夕厶口
䆾	宀八匚皿
沒	氵󰁡又󰁶
廼	西廴󰀌
滼	氵木木丶
䚔	宀一󰀤儿
彾	彳人丶󰁻
彿	彳弓󰀯󰀢
冶	冫厶口󰀝
匰	匚口口十
猰	犭󰁥三大
徃	彳丿󰀝
徆	彳西󰀝
徎	彳口王󰀝
锅	钅口冂人
赆	贝尸󰂃󰁦
甅	一󰁐󰁊土
浆	丬夕水󰁧
徏	彳止󰀤󰁥
泃	氵勹口󰀝
崽	山田心󰁧
徚	彳木󰀹󰀝
徛	彳大丁口
徟	彳󰀼土口
㑅	亻𠂉上󰀝
䑅	月艹罒夕
徠	彳木人人
徣	彳󰁺日󰀝
䌀	糹禾󰁦十
徥	彳日一󰁾
徦	彳󰁃丨又
徧	彳丶尸艹
䄐	凵山二巳
徫	彳󰁆口㐄
徬	彳亠丷方
籸	米⺄十󰀢
湼	氵臼工󰀝
悁	忄口月󰀝
蓉	艹宀八口
徯	彳爫幺大
㷕	丷西一火
㡢	冂丨日󰁡
䡢	車丶尸艹
傡	亻立立󰀝
桢	木󰀥贝󰁶
炡	火一止󰀝
股	月几又󰁶
鶆	木人人灬
涆	氵日干󰀢
瓅	王白幺木
鎰	釒䒑八皿
㫔	日上󰀘
㯱	一口丨木
艛	丿󰁪󰀻女
鉛	釒几口󰀝
區	匚口口口
徺	彳土土儿
徻	彳人一日
嵆	禾乚山
䔅	艹丁口口
㵆	氵日丿口
徿	彳立月三
忀	彳亠口󰀔
忁	彳曰凵氺
㽮	田田田
㺕	犭󰁥丿田
忊	忄丁󰀢
矂	目口口木
獰	犭󰁥宀丁
欱	人一口人
鎅	釒田人󰀯
莅	艹亻立󰀘
㠢	山白󰁜󰀔
镬	钅艹亻又
僡	亻一曰心
䃡	石󰀄󰁜日
砢	石丁口󰀝
栢	木丆日󰀝
郡	󰁬丿口阝
蠢	三人日虫
忕	忄大󰁶
䂬	工几丶石
㓀	冖卜󰁧
忚	忄也󰁀
忞	文心󰁧
忟	忄文󰁶
忢	五心󰁧
䋐	糹戈󰁐󰁀
忩	八厶心󰁧
䁬	目丷󰀺日
沟	氵勹厶󰁶
祝	礻󰁶口儿
忬	忄󰁻乛亅
臛	月󰀙亻󰁷
釛	釒力󰁥
㮆	木人羊󰀢
忷	忄乂凵󰀢
嵬	山白󰁜厶
担	扌日一󰀝
箆	⺮ㄇ人󰁴
䋅	糹丿󰀟󰀢
宆	宀弓󰀅
荅	艹人一口
鬆	󰂞彡木厶
剱	人一口丶
牱	牜丁口󰀝
怡	忄厶口󰀝
瀡	氵阝辶
䀡	目󰀥口󰀝
壢	土厂禾止
艱	廿口夫艮
揰	扌丿一土
裢	衤󰁧车辶
逡	厶八夂辶
䬔	几丿虫刂
䮱	󰀋灬一辶
㮱	木艹丿儿
爛	火門木󰀹
鈛	釒戈󰁶
寱	宀爿丿木
䃾	礻󰁶󰁴匕
囥	囗亠几󰁫
實	宀毌貝󰁧
䛬	言勹𠂉凵
揞	扌立曰󰀝
㰡	人󰀯⺈人
慛	忄山亻󰁷
酛	西一二儿
㫆	方人小󰁶
锥	钅亻󰁷󰀝
嫆	女宀八口
䎅	白羽󰀝
玅	亠幺小丿
櫆	木白󰁜十
蟄	土䒑十虫
矄	目丿一灬
柄	木一冂人
埄	土夂三丨
䟄	土󰁾貝
恡	忄乂厶
墢	土癶弓又
䁡	目門人󰁶
從	彳人人󰁾
㙇	土一󰀓󰁶
遡	䒑凵丿辶
袢	衤󰁧丷󰀟
墣	土业䒑夫
怴	忄戈󰁐󰁀
徝	彳十󰀣󰀝
厐	厂ヒ丶
䗀	虫土八夂
㶁	氵爫寸几
䋱	糹木人人
嗀	士冖一又
勱	艹曰冂力
趁	土󰁾人彡
鋱	釒󰀁心丶
熛	火覀二小
䭄	人良一亅
㿮	ㄇ大皮󰁶
䞭	土󰁾厶夂
㬆	日󰁂󰀁日
䍅	𠂉十凵󰁻
卅	一川󰀵
捅	扌󰁻月丨
笆	⺮巴󰀅
㥢	忄丷西一
䥢	士口䒑金
奢	大土丿日
楢	木丷西一
篓	⺮米女󰀘
㡯	广丿七󰁫
龆	止人凵口
䁮	目󰀄󰁜日
忛	忄几丶󰁶
㷯	火土三󰀟
嘮	口火火力
灞	氵󰀙廿月
祢	礻󰁶⺈小
膡	月丷夫目
饢	人良一󰀔
恴	亠曰心󰁧
犱	犭󰁥九丶
距	口止匚󰁃
嗁	口⺁虍几
巀	山小亻戈
䌐	糹爫目儿
悈	忄戈廾󰀢
㸯	牜󰁦十󰀢
㶂	氵氵󰁺八
䕁	艹丨三木
灛	氵門口十
㗼	口业丷未
䭞	人良罒十
卐	󰁕一丨一
煱	火ㄇ󰁈口
㓔	冫丿󰀽寸
韄	廿󰀜艹又
䇡	⺮宀丁󰀬
㤢	忄月󰀝
椢	木囗王丶
夢	艹罒冖夕
视	礻󰁶ㄇ󰁜
秆	禾干󰀢
媙	女戊一女
駆	󰀋灬匚乂
咮	口丿未󰁶
㒮	二儿一󰀓
㼿	立日土丶
䛾	言幺小
褢	亠白󰁜󰀔
燡	火罒土十
䶝	止󰀆大人
餢	人良立口
悺	忄宀󰃧󰀝
㿕	疒門⺈臼
宝	宀王丶󰁧
惁	木斤心󰁧
䧲	干亻󰁷󰀝
呮	口口八󰁶
䜾	一口䒑日
㛁	女一丷十
媆	女丆冂大
檆	木火火口
㪆	󰁚󰀁丶又
䪆	廿󰀜ㄇ䒑
㓐	冫土八土
庣	广儿󰀪󰀦
䬐	几丿虫女
停	亻󰁸冖丁
姢	女厶月󰀝
槢	木羽白󰀝
㧢	扌囗大󰁶
䧢	阝匚口口
稆	禾口口󰀝
艅	丿󰁪人朩
騆	󰀋灬󰀼口
㪝	木󰀹󰀥又
勂	丿土口力
臱	丿目宀方
釱	釒大󰁶
懱	忄艹罒人
駢	󰀋灬䒑廾
燱	火立曰心
無	𠂉一󰀷灬
觢	三丨刀用
䇱	⺮囗夕󰁧
凱	山一口几
㤲	大人人心
墲	土𠂉一灬
㼯	木日一丶
㐐	女又乙󰀅
惻	忄貝刂󰀢
䲄	󰁢灬𠂉攵
䊅	米夕口󰀝
㧆	扌冂丨󰀢
槆	木艹勹日
劅	罒勹虫刂
幾	幺幺戈人
䛮	言夂卜口
䘁	十戈亻虫
閔	門文󰀦
慡	忄大乂乂
兡	古儿丆日
䦢	門氵土厶
㦢	忄⺮󰁮卩
㴽	氵丿米心
䑐	匚丨󰁃小
醱	西一癶又
膱	月亠丷日
熱	土八土灬
憱	忄󰁸小丶
䆱	宀八氵火
㥲	十󰀣八心
㵕	氵厶厶⺗
馢	禾日戈戈
覢	火火目儿
煡	火󰁬󰀟廴
䞈	貝爫丿灬
㵒	氵弓󰀯貝
嶅	󰁡攵山
單	口口曰十
㵯	氵几一灬
䙁	衤󰁧戈戈
噁	口一󰀚心
㣬	彳口耳󰀝
㨆	扌木木󰁶
䉅	⺮土䒑丶
剅	一口䒑刂
扅	丶尸夕夕
䨓	󰀙囗口󰀘
恱	忄八厶儿
灱	火刀󰁥
遱	󰀻女辶󰀌
橢	木阝月
犡	牜厂艹丶
芡	艹⺈人󰁧
驢	󰀋灬虍皿
旔	方󰁬󰀟廴
㱥	一夕土夂
䄔	礻󰁶丿丶
愻	孑丿幺心
嘦	口八覀女
夗	夕⺋󰁀
㕮	口八乂󰁶
䨿	一大丨三
徾	彳山言攵
㩢	扌艹罒人
䊡	米日罒又
婢	女白丿十
媬	女亻口木
䀱	目夂三丨
㣲	彳山一攵
怱	勹󰁤󰂃心
卦	土土卜󰁶
䚾	言丿士󰀝
䐮	月立丿
潮	氵十日月
㭆	乃一木󰁧
倛	亻󰀎八󰁶
埁	土山人乛
䟁	土󰁾巛木
猅	犭󰁥丨三
歆	立日⺈人
包	勹巳󰁫
䭆	匚丨󰁃艮
稢	禾戈口󰀞
拡	扌广厶󰁶
騢	󰀋灬󰁃又
苡	艹󰁐丶人
嵭	山亠丷方
崠	山木曰󰀝
㯽	木宀󰁅貝
僱	亻丶尸󰁷
䁓	目乂凵夂
烱	火冂八口
䏮	月力󰀪󰁶
揂	扌丷西一
㨢	扌厶月匕
㕔	厂耳王心
勡	覀二小力
䋡	糹人一朩
恬	忄丿古󰀝
䜁	言土土大
圁	囗言󰀌
憃	三人臼心
憄	彳十󰀣心
庩	广人一朩
㙜	󰁸冂口土
䛱	言口丨心
㦅	忄廿儿丨
䯋	󰀾月丶
兄	口儿󰀅
䦅	钅羊䒑口
煄	火丿一土
慄	忄覀木󰁶
馅	⺈󰁐⺈臼
覅	覀女勹󰁤
舡	丿󰁪工󰀝
鈡	釒口丨󰀢
戡	艹三八戈
竢	立厶𠂉大
䚑	罒貝目儿
㹒	牜业䒑夫
嫰	女木口人
憥	火火冖心
㱽	冖󰁜几又
憲	宀三丨心
憴	忄黽󰀝
銔	釒丆卜十
䈡	⺮勹󰁤心
刡	󰁂󰀁刂󰀢
犔	牜气米󰁶
㫢	日土厶󰁶
抔	扌丆卜󰁶
劔	人一口󰂃
㩕	扌󰀙人󰁻
䛑	言心丿󰁥
暹	日亻󰁷辶
東	木曰󰀌
懄	忄廿口力
銲	釒曰干󰀢
芲	艹人ヒ󰀅
㥅	忄爫冖又
櫳	木立月三
奅	大󰁚丿卩
䊲	覀米立
熄	火丿目心
膄	月臼丨又
饅	人良曰又
骢	󰀊󰀞丿心
艡	丿󰁪⺌田
牡	牜土󰀝
扡	扌也󰁀
㲦	十早人毛
䬟	几丿虫刂
㑼	亻田夂口
搿	人一手
䛔	言丆冂〢
雔	亻󰁷亻󰁷
匼	匚人一口
㳯	氵辛󰀢
媢	女󰀰目󰀝
䉡	⺮亠囗一
㪢	臼丨又又
㘑	口士二氺
槹	木白󰀪十
鹆	八人口一
蘅	艹彳󰁢丁
瘅	疒丷󰅐󰀵
昅	日乃󰂃󰁶
嘅	口󰁮󰀄󰁜
䘅	厶月匕虫
㹆	牜冖車󰀢
狲	犭ノ孑小
苲	艹𠂉丨二
勲	丿一曰灬
拲	󰁺八手󰀬
㪳	󰁦十口󰀘
䋲	糹口日乚
弐	一󰀁二丶
䌭	糹艹亻灬
鎡	釒䒑幺幺
䋾	糹大夕夕
勼	勹九󰁫
㺒	犭󰁥羽彡
厡	厂白水󰀦
採	扌爫木󰁶
玡	王󰀄亅丿
莡	艹口󰁾󰁧
䓮	艹󰁻乛攵
彇	弓󰁬十󰀲
㭢	木一廾刂
䎡	丆冂〢火
债	亻主贝󰁶
勭	立曰土力
戔	戈戈󰁧
䎮	二木亠古
闅	門目󰀥又
䡁	丿󰀽三三
病	疒一冂人
藅	艹罒言刂
嗅	口丿目犬
鈲	釒⺁厶󰂃
㗅	口古月󰀝
䗅	虫󰀍󰀖󰁶
戲	虍一口戈
刲	土土刂󰀢
舲	丿󰁪人󰁻
爲	爫丿乛灬
堆	土亻󰁷󰀝
㮤	宀八人木
䩳	廿󰀜宀又
㩳	扌亻󰁷又
䒆	丿󰁪亠攵
鬢	󰂞彡宀貝
廸	由廴󰀌
䇀	宀八廿耳
握	扌尸一土
嬢	女六󰀀󰀔
菡	艹了󰀪凵
珡	王王人󰁧
㦁	車辶心󰁧
艔	丿󰁪广又
䏡	月二小󰁶
㬢	日丷王丶
牔	丿丨一寸
蚣	虫八厶󰁶
杂	九木󰁧
俲	亻六乂力
哟	口纟勹丶
㽕	由󰀊󰀅
螔	虫⺁虍几
瞔	目貝󰁶
鉲	釒上卜󰁶
遄	山丆冂辶
潕	氵𠂉一灬
垔	覀土󰀘
娳	女禾刂󰀢
忆	忄乙󰁀
聄	耳人彡󰁥
碅	石囗禾󰁶
䟑	土󰁾人艹
婣	女󰀲一󰀝
䁄	目土䒑十
䨳	󰀙目儿儿
圑	囗甫寸󰀦
䜑	言一󰀚心
錡	釒大丁口
䃠	石方𠂉󰁾
猡	犭ノ罒夕
茡	艹宀子󰀘
匡	匚王󰀌
挡	扌⺌彐󰀝
㯢	木巳巳八
䌡	糹ㄇ󰁺䒑
㸮	牜八刀󰁥
䭠	人良广八
㝦	宀亻󰁷乃
䳽	山亻󰁷灬
悇	忄人一朩
㞱	山日󰀘
豿	豸勹口󰀝
暨	彐厶󰀂一
䝑	一󰀓立土
扲	扌人丶乛
還	罒一口辶
肾	〢又月󰀘
顿	一凵󰁐贝
鶧	艹ㄇ大灬
姳	女夕口󰀝
悄	忄⺌月󰀝
硅	石土土󰀝
衅	丿皿丷󰀟
駳	󰀋灬丿廴
觳	士冖一又
㡅	冂丨夕夕
䂄	目目目又
崳	山人一刂
䚼	言󰁈丨一
䁇	宀心丿目
鮢	󰁢灬丿未
订	讠丁󰀢
箢	⺮宀夕⺋
捡	扌人一一
卡	上卜󰁧
䍡	罒󰁙󰁴匕
㮢	木亻ユ大
䊁	米丿土儿
鞱	廿󰀜爫臼
螱	尸二小虫
瞱	目艹一󰀟
䞱	土󰁾八口
皰	皮勹巳󰁀
嚰	口广木石
暰	日彳人󰁾
罠	罒󰁂󰀁󰀅
䊽	糹ユ人󰁶
眔	罒󰀫󰁧
勁	一巛工力
僐	亻羊䒑口
㹶	犭󰁥丿廴
䦳	門󰁲丿阝
䃄	石󰁸小󰁶
㤅	󰀄󰁜心󰁧
㦳	十戈土󰀌
臲	丿目木⺋
胄	由月󰀘
榳	木广丿廴
椅	木大丁口
䉽	米丷󰀟󰀢
姅	女丷󰀟󰀢
䇮	⺮亻丿士
䚰	言匕󰁀
䈁	⺮人一艹
噰	口亠󰁲󰁷
虰	虫丁󰀢
癰	疒巛口󰁷
㾕	疒辛󰀵
侕	亻丆冂〢
勪	丿大口力
睔	目人一艹
坔	水土󰀘
靔	月气󰁀
儭	亻立朩儿
傐	亻󰁸冂口
拑	扌甘󰀝
䉁	⺮耳人󰁻
僽	亻禾火心
䃽	礻󰁶十又
㐲	亻大󰁶
㣫	彳丿一土
䯦	󰀾月艹人
㱢	一夕丶艮
㥳	忄厂白小
壅	亠󰁲丿土
女	女女女女
䥳	釒丆󰀐夂
焲	火亠亻丶
鄄	覀土阝󰀢
饳	⺈󰁐凵山
焄	󰁬丿口灬
㜬	女⺈厂言
攰	十又力󰀏
蔰	艹丶尸巴
䋼	糹乃又皿
侺	亻山人乛
䖖	虍几甲󰀵
嗚	口󰁞灬󰁶
䉠	⺮彳山攵
䆽	宀八虍󰀓
䎁	古羽󰀝
徤	彳󰁬󰀟廴
䵱	󰀹土灬口
䱕	󰁢灬𠂉母
㾆	疒冂土󰀌
盰	目干󰀢
庱	广土八夂
廆	广白󰁜厶
仆	亻卜󰁶
细	纟田󰀝
枅	木一廾󰀢
鞅	廿󰀜ㄇ大
螅	虫丿目心
㰢	一廾⺈人
挒	扌一夕刂
尢	乚󰁫
䓡	艹𠂉大口
簢	⺮門文󰁧
擡	扌士口土
铡	钅贝刂󰀢
蓡	艹氵彐又
腲	月田一󰀖
酲	西一口王
挕	扌耳󰀝
雰	󰀙八刀󰁣
嶳	山一󰀓土
䅽	士󰁅几禾
偹	亻丨夂田
冑	由月󰀘
蕔	艹土䒑又
栃	木⺁一󰁡
郔	丿󰀥󰄃阝
䴘	⺁虍几一
們	亻門󰀝
䅭	禾亠丷方
䛰	言日󰁴匕
䂟	力口石󰀘
㻆	王厶月󰀝
妋	女夫󰁶
伆	亻勹󰁤󰁥
弆	土厶廾󰀬
育	亠厶月󰀘
炲	火厶口󰀝
棳	木又又又
㳢	氵丿大󰀯
䂲	土厶力石
㣳	彳𠂉一灬
搡	扌又又木
琡	王上小又
䐡	󰀴冂人人
吡	口󰁴匕󰁀
䌁	糹覀女󰀝
㛝	女貝󰁶
萡	艹氵白󰀘
鐡	釒十戈䒑
閰	門臼󰀌
䀭	目亠ㄥ人
庫	广車󰀵
徸	彳立曰土
佱	人二止󰀘
䄑	礻󰁶󰁚日
䖰	虫⺁󰀕󰁶
㯕	木󰀎八斤
哰	口宀丿󰀟
壐	一八冂土
䞮	土󰁾人朩
鱆	󰁢灬立早
萅	艹一凵日
琅	王丶彐󰀖
搅	扌󰀧冖󰁜
㼆	王火火丶
郲	木人人阝
㽯	田山亻口
烲	扌斤火󰁧
胲	月亠ㄥ人
㑡	亻󰁮卩󰀢
惲	忄冖車󰀢
㢳	弓𠂉󰀕󰁶
䃲	石丿󰁪皿
粢	冫⺈人米
摡	扌󰁮󰀄󰁜
呡	口󰁂󰀁󰁀
䑡	丿󰁪又丶
異	田󰁺八󰁧
咁	口甘󰀝
鲢	󰁢󰀞车辶
葡	艹勹一丶
䒁	丿󰁪羽白
㭟	󰁺八木󰁧
䵝	󰀹土灬乚
㼫	日木一丶
廝	广󰀎八斤
㕰	口毛󰁀
鑔	釒宀󰁯小
泓	氵弓厶󰁶
㷉	尸二火寸
䲩	尸󰁟灬󰀦
鏅	釒亻丨月
蓾	艹󰀥囗󰁘
珅	王曰丨󰀢
貆	豸一曰一
岆	山丿大󰁶
揅	石一廾手
䐅	月尸𠂉大
硳	石土󰁖󰁶
辎	车巛田󰀝
顳	耳耳耳貝
䀲	目𠂉母󰁶
㡳	广󰁚󰀁󰁫
桳	木厶大十
倲	亻木曰󰀝
疡	疒ㄋ󰁤󰀏
薡	艹目󰁕󰁈
鵢	丿󰀽三灬
䊞	米亠丷古
㵢	氵󰀙田󰀝
䖡	虫󰁈丨一
嵢	山人丶口
浢	氵一口䒑
萰	艹木󰀹󰀘
㓁	冖八󰁧
圐	囗罒方󰀏
冔	󰀰口一󰀛
䥕	釒㡀攵󰁶
猴	犭ノ亻大
睜	目爫󰁬亅
䱱	󰁢灬亠丨
㭘	木人一口
㒋	亻󰀎八斤
帰	丶丿彐丨
㜭	女⺌冖田
䆙	宀八一止
噾	口宀八日
㽑	甘覀早󰀢
夰	大󰀯󰀬
跆	口止厶口
緆	糹曰勹󰁤
頳	土󰁖丆貝
鷆	匕目󰄃灬
㠳	丿󰂃冂丨
㷆	火丿󰃧十
堳	土󰁅目󰀝
巆	山火火口
财	贝󰀛丿ノ
索	十冖ㄠ小
臔	月匚丨貝
鴢	幺力󰁟灬
䗡	虫一止灬
㗡	艹亻乃匕
旡	󰀄󰁜󰁫
崢	山爫󰁬亅
釔	釒乙󰁀
橸	木曰曰曰
䗰	虫毌貝󰁶
禅	礻󰁶丷十
徳	彳十罒心
秂	禾人󰁧
叭	口八󰁶
㜢	女󰀻女󰀝
䛭	言土䒑十
蒰	艹丿󰁪又
䑁	󰀗乂乂月
媔	女丆囗二
粘	米󰀥口󰀝
愔	忄立日󰀝
揈	扌勹言󰀝
䧷	夂󰁦亻󰁷
石	石一丿一
虅	艹月丷灬
鸆	虍口一灬
䟳	口󰁾羽󰀌
㙅	土口木󰁶
丆	丆一丿
噅	口爫丿灬
渆	氵䒑廾刂
鷢	厂䒑凵灬
墬	阝彑󰀓土
甡	丿丿
蔡	艹󰁯二小
唡	口一冂人
淢	氵戈口󰀞
㔡	丿囗乂力
䔡	艹󰁢灬󰁧
惧	忄󰀣八󰁶
蟨	厂䒑凵虫
胿	月土土󰀝
䱘	禾刂󰁢灬
鑰	釒人一艹
揥	扌亠丷丨
揦	扌木口刂
揧	木口刂手
慔	忄艹曰大
阅	门丷口儿
䑰	丿󰁪止󰀤
摰	土八土手
㟳	山覀木󰁶
徑	彳一巛工
妟	曰女󰀘
㘙	口口口攵
眅	目⺁又󰁶
朅	土厶日󰄃
圅	󰁻囗䒑十
但	亻日一󰀝
㿳	皮巛田󰀝
揷	扌丿一丨
齆	丿目田巴
鞳	廿󰀜艹口
䠮	口止丷灬
镡	钅覀早󰀢
蕡	艹十艹貝
畡	田亠ㄥ人
敡	日勹󰁤又
嶢	山土土儿
䶢	止󰀆戊口
㕡	󰀥冖一又
㿯	人一口皮
堮	土口口ㄅ
䫍	丨三丨貝
蒱	艹扌甫󰁧
璱	王王王丿
䑿	丿󰁪宀日
㑿	亻巛日木
丄	丨一󰀌
傑	亻夕㐄木
呯	口一丷十
䱲	󰁢灬彑󰀓
癕	疒亠󰁲󰁷
㜅	女亠幺田
㞳	山󰁦十󰀢
媡	女木󰀹󰀝
嫶	女亻󰁷灬
澆	氵土土儿
㚡	大丁口口
來	木人人󰀦
杳	木日󰀘
靳	廿󰀜斤󰀢
皡	白白󰀪十
蛅	虫󰀥口󰀝
雅	󰀂亅丿󰁷
匑	勹丿󰀽弓
䌑	糹匚丨土
䘿	衤󰁧尸山
㘯	土𠂉力󰁥
㿓	疒大人󰁾
㜻	女言糹心
荱	艹尸毛󰀅
搤	扌䒑八皿
诓	讠匚王󰀝
㬕	日礻󰁶羊
䋔	糹丆卜一
勔	丆囗〢力
狔	犭󰁥尸匕
暕	日木󰀹󰀝
帷	冂丨亻󰁷
憯	忄󰀄󰁜日
搩	扌夕㐄木
䤤	釒亠ㄥ人
䄁	礻󰁶廿󰄃
䟒	土󰁾艹󰁷
㾧	疒日木󰀦
㐒	刀口乙󰀅
嚖	口三丨心
蓤	艹冫土夂
㛡	女宀二儿
涅	氵日土󰀝
囡	囗女󰀌
丢	丿土厶󰁧
盡	󰁬丨一皿
曡	日日日一
鸢	弋勹丶一
踢	口止日󰁤
䌱	糹󰄹月丶
㯲	木木木小
處	虍夂几󰁫
嗕	口厂二寸
㕄	厂一幺󰀦
亖	二二󰀘
啄	口一󰀓丶
䕄	艹了󰀩皿
旕	方人󰁦匕
㗳	口⺮人口
㺖	犭󰁥乛攵
䇁	宀八󰁢羊
㸸	牜⺁一口
䜒	言丿ㄇ大
㽓	丿丿
摌	扌立丿
䃺	石广木三
褶	衤󰁧羽白
㒯	⺌一儿󰀟
隕	阝口貝󰁶
摜	扌毌貝󰁶
摝	扌󰁙󰁴匕
摟	扌󰀻女󰀝
㵸	氵人一艹
仢	亻勹丶󰁶
廢	广癶弓又
泅	氵囗人󰁶
甄	覀土一丶
転	車二厶󰁶
黢	󰀹土灬夂
滢	氵艹冖丶
瘡	疒人丶口
䝒	一󰀓耳乑
㝒	宀古󰀘
㽨	田⺶工󰀝
䃫	石⺈厂言
䔄	艹爫𠂉凵
唄	口貝󰁶
㛳	亠丷冖女
㔄	覀米刂󰀢
厱	厂人一人
䎱	二木罒匕
㭲	木八人口
玔	王川󰀢
掔	匚丨󰁃手
䜯	八人口米
㶨	丆卜灬󰁧
䚒	立日土儿
嚒	口广木幺
墥	土立曰土
䑑	匚丨󰁃夫
撈	扌火火力
㔎	凵人󰃧刀
匭	匚車九󰁫
揔	扌勹󰁤心
鏔	釒宀一八
庢	广一厶土
凄	冫一󰁬女
䇄	立𠂉乙󰁀
㨅	扌艹冂人
陡	阝土󰁾󰁶
虡	虍业八󰀦
红	纟工󰀝
晡	日一月丶
㗯	土丿日匕
䏔	月󰁈丨一
鍔	釒口口ㄅ
巟	亠󰄃󰀸󰀅
䛒	工一ㄅ言
騅	󰀋灬亻󰁷
臄	月虍一󰀓
燄	⺈臼火火
囒	口艹門󰀹
撟	扌丿大口
撡	扌厶厶⺗
撨	扌亻󰁷灬
幰	冂丨宀心
伽	亻力口󰀝
誊	䒑大言󰀘
猔	犭󰁥宀小
㔅	󰁬十󰀲刂
䉿	米丿丷󰀛
傁	亻臼丨又
忥	气心󰀦
鞡	廿󰀜扌立
擄	扌虍田力
擈	扌业䒑未
僄	亻覀二小
垡	亻戈土󰀘
枡	木丿廾󰀢
赅	贝亠ㄥ人
螡	文虫虫󰁧
䝓	一󰀓巛󰁒
噒	口米夕㐄
㽢	田大日乚
佢	亻匚󰁃󰀝
䙒	衤󰁧亠田
㸓	爫日󰀘
㪸	󰀎八󰁦十
䊮	米羽亻󰁷
擔	扌⺈厂言
㖄	口丶丿丨
䖄	艹廿口灬
善	䒑󰀟䒑口
嘪	口罒貝󰁶
據	扌虍一󰀓
獔	犭󰁥白十
協	十力力力
擟	扌一八乂
铝	钅口口󰀝
擥	匚丨󰁃手
䟂	土󰁾日又
㟂	山母󰁶
剮	ㄇ󰁈冂刂
擧	󰀗一󰁕手
䋿	糹田一󰀖
徢	彳一󰁬󰁾
鼢	臼󰁐󰁦刀
瓕	弓一八丶
菨	艹立女󰀘
柡	木二水󰁶
弢	弓凵丨又
蟡	虫爫丿灬
缢	纟䒑八皿
沅	氵二儿󰁀
岅	山⺁又󰁶
伢	亻󰀂亅丿
粅	米勹󰁤󰁥
堫	土乂凵夂
䌮	糹󰀙木目
䑄	月丿目󰀯
㲅	宀三丨又
䊿	糹夫󰁶
䴺	木人人口
婠	女宀󰃧󰀝
峼	山丿土口
幀	冂丨󰀥貝
攔	扌門木󰀹
擠	扌󰀴󰀳󰀝
甕	亠󰁲丿丶
攜	扌山亻口
䄱	禾方󰁥
攤	扌廿口󰁷
攧	扌十󰀣貝
攪	扌󰀗乂儿
䀐	目彡󰁥
偔	亻口口ㄅ
垬	土󰁺八󰁶
䍯	⺶⺈厂⺋
㴓	氵田心󰁶
霡	󰀙月丶󰀩
邔	󰁁阝󰀢
眡	目󰁚󰀁丶
蜡	虫󰁺日󰀝
鯅	󰁢灬丿廴
濢	氵羽亠十
㿢	日月白󰀘
俢	亻夂彡󰁥
各	夂口󰀘
搄	扌忄一一
㯅	木广白十
䐄	月⺈臼󰀝
肔	月也󰁀
嶨	󰀗乂乂山
㻽	王亻󰁷𠃌
㔿	一󰁐丨󰀵
堥	󰁻乛亅土
偛	亻丿十臼
敋	夂口攵󰁶
㛨	女⺶乚󰁀
幙	冂丨艹大
䔯	艹西一古
叿	口工󰀝
䏿	丶尸攵月
囂	口口丆口
䛂	言丿廾󰀢
䳅	󰁟灬口八
敜	人丶乛攵
達	土羊辶󰀵
㢡	爿󰁝寸廾
䢡	廿󰄃木辶
僠	亻丿米田
梡	木宀二儿
碡	石主母󰁶
胠	月土厶󰁶
郠	一曰乂阝
条	夂木󰁧
洅	氵一冂土
䝡	豸廿冂丶
㝡	宀耳又󰁧
敟	ㄇ󰁺八攵
䌖	糹亻󰁷木
敤	曰木󰀥又
䏯	月士心󰁶
嘂	口口󰁐口
敮	丿十臼又
崅	山⺈用󰀢
䓄	艹犭󰁥斤
㓄	厶厶厶󰁜
㘂	口䒑幺心
㹤	犭󰁥土厶
敶	阝木曰攵
敿	丿大口攵
䎯	二木廿夫
㓋	冫󰁺八󰁶
斄	未攵厂人
厯	厂木木丶
䆀	禾󰀹土灬
䙂	衤󰁧八心
斊	文耳󰀘
䟷	口止扌斤
㺿	王匚丨丨
帗	冂丨丶
斒	文丶尸艹
㕕	厶厶󰁧
妝	爿女󰀝
鱅	󰁢灬广丨
䗲	虫米夕㐄
僰	木冂木人
䅀	禾一夕刂
咄	口凵山󰀢
汅	氵一ㄅ󰁀
璄	王立曰儿
蒄	艹冖二寸
傮	亻一ㄇ日
斞	臼人󰁦十
㒄	亻󰁝犬灬
䱅	󰁢灬一木
厒	厂𠂉十凵
㷝	火宀八犬
嚜	口󰀹土土
斦	斤斤󰀢
帒	亻󰀁丶丨
喕	口丆囗二
斕	文門木󰀹
㖕	口辛󰀢
䖕	虍几󰀐一
䄀	礻󰁶戈󰁶
儀	亻丷王丶
䏒	月丿丨󰁈
乁	一󰂃󰀦
㠡	山亠󰀋󰀔
嗂	口爫𠂉凵
帠	臼冂丨󰀬
恠	忄丨土
砡	石王丶󰁶
䁠	目䒑󰁬八
偠	亻覀女󰀝
镕	钅宀八口
蕕	艹犭󰁥一
辜	古辛󰀬
遠	土口󰀔辶
卄	艹一丨丨
䍄	𠂉十凵口
箅	⺮田一󰀯
捄	扌一氺丶
鍄	釒󰁸小󰁶
荄	艹亠ㄥ人
畕	田田󰀘
㰋	木止󰀤貝
㣯	彳尸⺌月
䄮	禾夫󰁶
䌒	糹󰁙󰁴匕
匒	勹艹人口
㓕	冫戊一火
擕	扌亻󰁷𠃌
嶖	山人一羽
旊	方𠂉一丶
䅶	禾厂二寸
師	丿󰃧一丨
㔂	米夕㐄刂
靋	󰀙氵厂止
迄	𠂉乙辶󰁫
翄	羽十又󰁶
㿜	疒丿目艹
忄	忄丶丨丶
壡	󰀥冖一土
㿄	疒匚𠂉又
翜	羽大人人
棡	木冂䒑山
飡	冫人丶艮
远	二儿辶󰁫
墷	土艹一󰀟
䋮	糹金󰀝
挄	扌⺌一儿
猄	犭󰁥󰁸小
䌄	糹一冂又
匄	勹亠󰄃󰁫
䉖	⺮車人󰁻
䰟	二厶丿厶
茄	艹力口󰀘
髅	󰀾月米女
旜	方𠂉亠一
旝	方𠂉人日
䍒	罒木󰁧
疕	疒匕󰁫
薕	艹广䒑八
㕂	厂人丶乛
傱	亻彳人󰁾
䡲	車口口十
撓	扌土土儿
攢	扌丿土貝
䫓	立口丆貝
䜕	言艹日丶
㼜	ㄇ大一丶
䇠	⺮丶王󰀘
几	几丿󰁊
榡	木幺小
曕	日⺈厂言
蛕	虫月󰀝
盕	氵几丶皿
嫹	女󰁺由八
峬	山甫󰁶
䒂	丿󰁪爿寸
䝳	󰀥夕又貝
螲	虫宀八土
燠	火丿ㄇ大
輜	車巛田󰀝
鼜	士口䒑虫
瞲	目󰁻乛口
䗢	虫丿土辶
㗢	口丿一力
藢	艹彳山攵
㓵	口口二刂
㞧	山乃󰁣
䠂	木木口󰁾
壉	土虍一󰀓
䈒	⺮十冂十
侞	亻女口󰀝
坶	土母󰁶
䟲	口止亠儿
柲	木心丿󰁥
㷣	火丷王󰀟
斢	󰁺由八十
牕	丿丨一󰁈
払	扌厶󰁶
㽜	夕⺋田󰀘
剕	丨三丨刂
銰	釒艹乂󰁶
㱃	人丶乛人
硡	石宀厶
桡	木弋丿儿
倠	亻亻󰁷󰀝
䡡	車󰁴匕白
腴	月臼人󰁶
叧	口刀󰁣
造	丿土口辶
耠	三󰅇人口
䎄	刀口羽󰀝
孅	女人人󰀞
歅	覀土⺈人
玄	亠ㄠ󰁧
莄	艹一曰乂
鎄	釒󰁸󰀔󰁶
媐	匚丨口女
㡹	广󰀐一󰀌
癢	疒䒑夫艮
䜲	八人口󰁒
盥	󰀗水皿󰀘
芕	艹夕󰁧
犕	牜󰁺丿用
舒	人干口亅
嶠	山丿大口
晄	曰⺌一儿
䆒	宀八九丶
䫑	大丁口貝
㹯	犭󰁥亻木
㺸	亻几丶丶
夡	夕夕士口
慠	忄󰁡攵
㤡	忄一夕刂
䤡	釒冂土󰀝
㑯	亻丆貝󰁶
䘢	衤󰁧宀丁
嘢	口曰土亅
䝲	貝尸󰂃󰁦
䉄	⺮阝土夂
㪅	一冂人又
扄	丶尸丿口
剄	一巛工刂
麜	󰁙󰁴匕木
嫩	女一口夂
煠	火廿󰄃木
腠	月三人大
耜	三󰅇丨󰁃
晜	曰丷弓丿
晝	󰁬土曰一
剳	艹人一刂
艄	丿󰁪⺌月
牄	爿人丶口
䚮	言乃󰁥
骅	󰀊󰀞亻十
㙮	土⺮人口
晧	日丿土口
䛹	言彑󰀓󰁶
離	亠乂凵󰁷
骥	󰀊󰀞丬八
巗	山口口攵
毪	丿二乚󰀟
䫡	䒑󰁬〢貝
仜	亻工󰀝
㻜	王人人󰁾
槡	木又又木
廜	广尸土日
䄒	礻󰁶人心
䟤	口止心丿
䝕	一󰀓耳耳
㝕	宀心又󰁧
刄	刀󰂃󰀦
戄	忄目目又
㧅	扌刀󰁥
䈄	⺮了󰀪凵
膠	月羽人彡
秡	禾又丶
㞕	尸八月󰀌
黜	󰀹土灬山
䙱	衤󰁧尸虫
癱	疒廿口󰁷
匂	勹匕󰁫
䌂	糹尸一土
鈄	釒󰁦十󰀢
幁	冂丨丆貝
秅	禾丿七󰁀
觅	爫ㄇ󰁜󰀅
蚢	虫亠几󰁀
㤯	忄冂八口
戛	丆目戈󰁧
唪	口三人󰀟
䃮	石土羊辶
㪡	宀三丨又
䪡	丿ㄅ丨一
帜	冂丨口八
寚	宀王𠂉凵
屡	尸米女󰀌
暊	日丆貝󰁶
蝕	人良虫󰁶
杕	木大󰁶
坹	土宀八󰁶
蘱	艹米犬貝
瘱	疒大人心
㬅	日罒方󰁣
奍	丷夫󰀯󰀬
䍂	𠂉十凵󰀛
寗	宀心丿土
笅	⺮乂乂󰁧
拄	扌丶王󰀝
勄	𠂉母力󰁥
䋄	糹冂乂󰁶
渜	氵丆冂大
狠	犭ノ彐󰀖
鬅	󰂞彡月月
苄	艹亠卜󰁧
㝢	宀丿口丶
蝢	虫丆貝󰁶
杢	木工󰀘
坢	土丷󰀟󰀢
䘲	衤󰁧󰁬又
暣	日气米󰁶
吩	口八刀ノ
㽺	疒丿󰁈又
曱	ㄇ干󰀵
嶽	山犭󰁥犬
雱	󰀙方󰁣
䞾	土󰁾⺁几
湜	氵日一󰁾
幜	冂丨日小
乜	𠃌乚󰁫
㥡	忄尸匕木
圢	土丁󰀢
朢	匚丨󰁃王
聋	ヒ丶耳
僕	亻业䒑夫
㩅	扌一〢田
䩅	丆囗〢皮
婅	女勹米󰁶
抄	扌小丿ノ
烕	戊一火󰀦
鄠	󰀙二ㄅ阝
脠	月丿󰀥廴
焠	火亠人十
郕	戊𠃌阝󰀢
斔	文虫臼人
曄	日艹一󰀟
斥	斤丶󰀦
穅	禾广󰁬氺
芄	艹九丶󰁧
驅	󰀋灬匚口
萸	艹臼人󰁧
㥄	忄土八夂
䆸	宀八癶䒑
奄	大日乚󰀅
䥄	釒厂󰁺日
䨡	󰀙了󰀪凵
嶜	山󰀄󰁜日
饄	人良⺌土
㶜	氵尸䒑刂
曊	日弓󰀯貝
隱	阝爫工心
䑼	丿󰁪勹丿
冮	冫工󰀝
觫	⺈月丨󰅇
蟢	虫士口口
蝥	󰁻乛亅虫
儕	亻󰀴󰀳󰀝
暄	日宀一一
汶	氵文󰁶
曞	日厂艹丶
﨡	虫丿󰀝
䤀	西一艹口
曣	日廿口灬
畱	一〢匚田
鑕	釒斤斤貝
艠	丿󰁪癶䒑
騡	󰀋灬白水
扠	扌又丶󰁶
稡	禾亠人十
葕	艹彳氵丁
䑕	臼几󰀟󰀬
䏆	耳一ㄇ日
䆂	禾广䒑八
䤄	西一丆二
处	夂卜󰀦
䐨	士冖一又
㤄	忄一冂丨
㫡	日夂󰁦󰁧
餄	人良人口
椄	木立女󰀝
䊠	󰁮󰀄󰁜米
㐨	󰁻乛亅亅
䩌	丆囗〢灬
醭	西一󰅊人
暬	土八土日
咾	口土丿匕
䞠	土󰁾石󰀌
嵸	山彳人󰁾
蔱	艹乂朩又
䒕	艹小󰁧
䏨	月丿󰃧󰀝
瓷	冫⺈人丶
㢠	冂口廴󰀌
䈪	⺮一口丨
㓏	冫冂八口
䗱	虫业䒑夫
扈	丶尸口巴
竡	立丆日󰀝
櫡	木⺮土日
髡	󰂞彡一儿
芠	艹文󰁧
㑾	亻󰁝言󰀝
䑾	丿󰁪亻又
嚄	口艹亻又
朙	囗八ㄇ月
䵢	󰀹土灬未
藱	艹疒白厶
㮡	火匚󰁃木
䮡	󰀋灬𠂉夂
㝓	宀人一口
䢇	宀几厂寸
朣	月立曰土
朥	月火火力
釕	釒了󰀢
闄	門覀女󰀌
腋	月亠亻丶
煋	火曰丿
清	氵主月󰀝
嗄	口丆目夂
䅋	禾⺈口󰁜
㸅	火⺮󰁮卩
㔾	⺋𠃌乚
懕	厂曰月心
㵲	氵𠂉一㐄
朮	十儿丶󰀦
㿝	白厶󰁧
朰	木乙󰀅
閱	門八口儿
斱	土丿日斤
鴜	止匕󰁟灬
䑨	丿󰁪𠂉也
脡	月丿士廴
鈕	釒󰁈丨一
叠	又又又一
揠	扌匚日女
珠	王󰅎󰅇󰁶
计	讠十󰀢
媤	女田心󰁶
㦄	广木木心
䦄	钅一日󰀔
妄	亠󰄃女󰀘
榄	木〢𠂉󰁜
䵜	禾人氺󰀖
㩡	扌石石石
馄	⺈󰁐日匕
爕	言火火火
瑱	王十󰀣八
㵅	氵人丶貝
䥐	󰁻乛亅金
䳞	三人󰀟灬
杊	木川󰀢
杋	木几丶󰁶
臧	厂󰄃丆丶
鄁	丬匕月阝
䛓	〢𠂉丶言
䂂	目目目󰁷
傂	亻⺁虍几
䜨	讠口口心
酕	西一毛󰁀
煕	匚丨󰁕灬
鐱	釒人一人
驡	立月一灬
赜	匚丨口贝
絜	三丨刀小
浜	氵󰅍一八
䬞	几丿虫寸
杝	木也󰁀
䅂	禾夂口󰀝
杣	木山󰀢
㲜	火火毛󰁀
塄	土罒方ノ
衄	丿皿󰁈二
硄	石⺌一儿
谲	讠󰁻乛口
兂	󰀄󰁜󰁫
䡄	車几󰁀
㡄	冂丨勹日
䛨	言辛󰀢
㺩	王󰁐丨󰀢
䞸	土󰁾二口
宠	宀ヒ丶
䆕	宀八ユ人
醕	西一󰁸曰
㷒	火日冂丶
熕	火工貝󰁶
瓱	一󰁐󰁊毛
㟽	山覀二小
倂	亻丿一干
擱	扌門夂口
㓱	人一月刂
䰲	󰁢灬乚󰁀
動	丿一曰力
凢	丿几󰁫
枂	木月󰀝
鋕	釒士心󰁶
鍠	釒白王󰀝
䭽	󰀋灬丿󰀟
粜	凵山米󰁧
貜	豸目目又
嬡	女爫冖夂
次	冫⺈人󰁶
砄	石ユ人󰁶
蠄	虫人亠厶
䎠	九丶丆〢
㳜	氵亻木󰁶
㠄	山羽白󰀘
俅	亻一氺丶
㘾	土宀一󰀛
㚓	大木󰁧
焢	火宀八工
䝨	〢又貝󰁧
嶣	山亻󰁷灬
偓	亻尸一土
䆢	宀八扌大
㹝	犭󰁥󰁚󰀁
䏾	月三人󰀟
枦	木丶尸󰁥
䱌	󰁢灬匚丨
奬	爿󰁝寸大
臢	月丿土貝
燢	󰀗乂乂火
釢	釒乃󰁥
䟈	土󰁾十王
㗰	口彳人󰁾
䨃	日宀女󰁷
嵞	人一朩山
鎠	釒罒一止
䊾	糹木󰁶
廵	巛廴󰁫
泜	氵󰁚󰀁丶
峜	山人止󰀘
诡	讠⺈厂⺋
玠	王人󰀯󰀢
䓠	艹水日󰀘
尜	小大小󰁧
㣄	弓氵匚木
粡	米冂一口
谜	讠米辶󰁶
铠	钅山己󰁀
磄	石广󰁬口
棄	亠厶廿木
䰂	󰂞彡爫木
剢	一󰀓丶刂
捶	扌丿十一
偂	亻䒑月刂
釜	八乂干䒑
䁂	匚丨󰁃目
䘓	丿皿⺈臼
㰌	木󰀙亻󰁷
圎	囗厶貝󰀦
晽	日木木󰁶
噽	士口䒑一
熢	火夂三辶
膢	月󰀻女󰀝
勯	亠囗口力
䋯	丶尸戈小
柕	木󰁻乛丿
㒨	亻󰀗丿巳
倾	亻󰁴丆贝
躯	丿󰀽三乂
刢	人丶󰁻刂
浠	氵乂丨
嚽	口󰁡貝
暽	日米夕㐄
㓠	󰀥口刂󰀢
䭡	人良爫心
梄	木西一󰀝
碄	石木木󰁶
袄	衤󰁧丿大
䜂	言白大十
囙	囗󰁃󰀌
㢄	广一口䒑
䢄	厶口木木
䊯	米广󰁺八
滂	氵亠丷方
珕	王力力力
揕	扌󰀎八󰄃
鏕	釒󰁙󰁴匕
菕	艹人一艹
怦	忄一丷十
䵼	爿󰁝寸󰁈
海	氵𠂉母󰁶
勢	土八土力
蒂	艹亠丷丨
䲡	󰁢󰀞丷一
㴿	氵丁丆貝
鈢	釒木󰁶
爢	广木木灬
犒	牜亠口口
祧	礻󰁶儿󰀪
柶	木四󰀝
弋	弋一󰁒丶
錠	釒宀一󰁾
茠	艹亻木󰁧
籜	⺮扌罒十
汜	氵巳󰁀
孡	孑厶口󰀝
氡	󰅎⺄夂󰁦
簡	⺮門日󰀘
䮜	󰀋灬廿木
呠	口木一󰀝
㐕	由乙󰀅
䱖	󰁢灬一󰁃
㝄	󰁸孑一乚
鰡	󰁢灬󰁚田
待	彳土寸󰁶
䝄	一口䒑又
睄	目⺌月󰀝
杄	木丿十󰀢
龅	止人凵巳
辅	车一月丶
浃	氵一丷大
䫣	爫幺大貝
栂	木母󰁶
狢	犭󰁥夂口
苢	艹󰃧󰀘
瘖	疒立日󰀌
昖	日八厶󰁶
驹	󰀊󰀞勹口
券	䒑大刀󰁣
藓	艹󰁢󰀞󰀟
箧	⺮匚一大
砰	石一丷十
乃	乃ㄋ丿
荕	艹月力󰁣
獕	犭󰁥山󰁷
㑠	亻〢又土
䓨	艹冖𠂉凵
䬣	人良𠂉乙
咠	口耳󰀘
䯜	󰀾月日󰁤
篜	⺮了󰀩灬
撠	扌十早戈
钠	钅冂人󰁶
㻅	王人二厶
犢	牜士罒貝
栙	木夂㐄󰀢
怋	忄󰁂󰀁󰁀
眄	目一丨𠃌
䀋	土𠂉󰀥皿
個	亻囗古󰀝
栛	木力力力
栜	木木冂󰁀
耋	土丿匕土
霄	󰀙⺌月󰀘
卾	口口二卩
矶	石几󰁀
䫖	󰀎八󰄃貝
哿	力口丁口
玕	王干󰀢
掕	扌土八夂
䌢	糹󰀙人󰁻
荢	艹宀一󰀛
獢	犭󰁥丿口
栥	冫⺈人木
鍢	釒一口田
徲	彳尸氺󰀟
㑞	亻火廾󰀢
栵	木一夕刂
㳡	氵寸辶󰁶
䶃	臼󰁐󰁦乛
笜	⺮凵山󰀬
藠	艹白白白
鶡	曰勹人灬
䁯	目人一羽
㬜	一厶土日
䶡	止󰀆貝刂
嶡	山厂䒑人
欜	木一口󰀔
㭎	木冂乂󰁶
䐍	月士口䒑
茢	艹一夕刂
徰	彳一止止
哖	口𠂉㐄󰀢
䓖	艹宀八力
麓	木木广匕
䁿	󰀹土灬目
䏓	󰀼冫二儿
䱑	󰁢灬扌斤
䋳	糹丬匕月
鏄	釒一曰寸
谅	讠󰁸小󰁶
簅	⺮立丿
揄	扌人一刂
尅	古儿寸󰀦
䰅	󰂞彡丆貝
㰅	木亠丷辶
缓	纟爫一又
僦	亻亠口丶
㯣	木艹八木
䯣	󰀾月口貝
揢	扌宀夂口
叢	业䒑十又
籡	⺮扌人人
歜	罒勹虫人
孜	孑夂󰁶
䭜	人良大小
珢	王艮󰁶
鏢	釒覀二小
鐠	釒䒑业日
萠	艹月月󰀘
䞄	方𠂉也貝
彅	弓䒑月刀
构	木勹厶󰁶
瞄	目艹田󰀝
轅	車土口󰀔
鞄	廿󰀜勹巳
桙	木厶丿󰀟
䴝	󰀥囗󰁘又
䈯	⺮十󰀣八
䐓	月丆貝󰁶
攖	扌貝貝女
唖	口一口一
䳗	󰁟灬丿丶
㔖	力口乛󰀅
攌	扌囗罒󰀔
㐓	丁口乙󰀅
桝	木夕㐄󰀢
䢸	󰀐󰀞阝󰀢
沤	氵匚乂󰁶
樵	木亻󰁷灬
㭜	木戈󰁥
虖	虍丿丷󰀛
陖	阝厶八夂
亗	山二󰀘
镠	钅羽人彡
噖	口王王乛
窜	宀八口丨
贡	工贝󰁧
崡	山了󰀪凵
敠	又又又又
㴡	氵禾日󰀝
䕠	艹广癶又
胋	月󰀥口󰀝
烋	亻木灬󰁧
羊	䒑󰀟󰀬
郋	丿目阝󰀢
亅	亅亅〇〇
㙄	土󰁴匕土
惋	忄宀夕⺋
庅	广丿厶󰀦
套	大󰂞󰁧
嫡	女亠丷古
桭	木厂二󰀖
桮	木丆卜口
䃿	礻󰁶夫󰁶
僿	亻宀󰀀土
鑢	釒虍田心
摢	扌虍丿󰀛
䑢	丿󰁪一儿
隖	阝󰁞灬󰁶
䠨	口止⺈言
傯	亻丿囗心
乗	禾󰁺󰀌
砺	石厂一󰁡
桻	木夂三丨
赛	宀󰀀八贝
薠	艹火丆貝
竜	立曰乚󰀅
梀	木木口󰀝
閠	門王丶󰀦
䫜	山幺幺貝
㷡	目匚󰁃火
斠	󰀀冂土十
喠	口丿一土
鷅	覀木󰁟灬
䱣	󰁢灬亠十
瘄	疒󰁺日󰀌
脋	刀刀刀月
嘄	口󰁟木󰁶
淅	氵木斤󰀢
㷅	耳又火󰁧
䄋	礻󰁶大乚
吢	心口󰀘
䂕	𠂉大彑󰀓
棵	木日木󰁶
骂	口口󰀊一
橪	木󰁝犬灬
梑	木犭󰁥火
梒	木人丶口
梕	木刀丶心
梖	木貝󰁶
䲣	虍󰁢一攵
懺	忄人人󰀞
妻	一󰁬丨女
䅿	禾艹一󰀟
䋓	糹⺈彐󰀝
梛	木𠃌󰀠阝
條	亻丨夂朩
梞	木己心󰁶
違	󰁆口㐄辶
聕	耳丿土口
灕	氵亠乂󰁷
㛄	女亠󰀔󰁶
䌿	纟一口田
䌯	糹艹口󰁷
匯	匚氵亻󰁷
灋	氵󰁙一厶
㨜	扌虍文󰁶
偋	亻尸䒑廾
庡	广亠󰀔󰀦
溡	氵日土寸
纡	纟一󰀛󰀢
雄	厶亻󰁷
騜	󰀋灬白王
瓮	八厶一丶
唾	口丿十一
梣	木山人乛
梤	木山八刀
竼	⺮几丶󰁧
諼	言爫一又
駻	󰀋灬日干
罴	罒土厶灬
咢	口口二ㄅ
璢	王一〢田
梮	木尸𠃌口
験	󰀋灬人人
䶗	止󰀆丁口
䪯	火火冖日
梹	木丘八󰁶
宎	宀丿大󰁧
䨻	󰀙田󰀙田
锠	钅日曰󰀝
蔠	艹糹夂󰁦
甠	日丿󰀝
橜	厂䒑凵木
唠	口艹冖力
䩜	廿󰀜由󰀝
㩜	扌匚丨皿
的	白勹丶󰁶
肋	月力ノ
隄	阝日一󰁾
䇯	⺮耳󰀘
㚄	士冖田󰁾
䚄	󰁭氺目儿
傋	亻󰀀冂土
悋	忄文口󰀝
䕢	艹石⺶工
蕢	艹口丨貝
畢	曰艹󰀟󰀵
薖	艹ㄇ󰁈辶
閖	門水󰀦
䖬	虫甲󰀢
棅	木禾󰁬󰀝
棇	木八厶心
棊	󰀎八木󰁧
讽	讠几乂󰁶
斖	文󰀗ㄇ一
棐	丨三丨木
棑	木丨三三
䤸	釒彑󰀓󰁶
棗	木冂木冂
棙	木丶尸犬
棜	木方人󰁦
浍	氵人二厶
㛖	女厶八夂
驸	󰀊󰀞亻寸
蛖	虫乚丶
㶄	氵門⺈臼
䶄	臼󰁐󰁦十
嶄	山車斤󰀬
両	一冂山󰀵
妜	女ユ人󰁶
希	乂冂丨
㙠	匚𠂉大土
虠	六乂虍几
馜	禾日尸匕
榜	木亠丷方
癠	疒󰀴󰀳󰀌
棬	木丷夫⺋
䙯	衤󰁧戊󰁾
棯	木人丶心
唭	口󰀎八󰁶
㻗	丨三丨丶
救	一氺丶夂
懼	忄目目󰁷
燼	火󰁬丨皿
涄	氵由一ㄅ
熋	厶月匕火
膋	火火冖月
鶄	月󰁟灬
䨽	丨三丨己
劼	士口力󰁥
芼	艹毛󰀅
犼	犭󰁥孑乚
棽	木木人乛
棾	木木冖几
棿	木臼儿󰁀
椃	木虍几󰁀
䚸	言人󰀯󰀢
椇	木󰀣八󰁶
少	小丿󰀏
穷	宀八力󰁣
㻡	王廿󰄃木
啋	口爫木󰁶
姜	丷王女󰀘
䚠	⺈用日匕
秜	禾尸匕󰁀
满	氵艹一人
黡	厂犬󰀹灬
觜	止匕⺈用
䙣	衤󰁧一三
䊼	糹止󰀝
牼	牜一巛工
艼	艹丁󰀬
椓	木一󰀓丶
駄	󰀋灬大丶
蕋	艹止止止
畋	田夂󰁶
椕	木八刀木
椖	木丶尸方
椘	木木之󰁧
検	木人一人
椝	夫冂󰁜木
兜	白󰁚󰁃儿
驳	󰀊󰀞乂乂
㛯	女⺈口力
幌	冂丨日儿
苏	艹力八󰁧
䉼	米斤󰀢
椣	木ㄇ󰁺八
䈋	⺮水日󰀘
刋	丿刂󰀢
臖	󰀗冂一月
㴄	氵囗八ㄇ
夜	亠亻夂丶
澡	氵口口木
羡	丷王冫人
褜	月勹巳󰀔
釖	釒刀󰁥
懖	釒丿古心
㟠	山冂䒑山
䤜	釒丿七󰁀
凖	冫亻󰁷十
椫	木丷曰十
椯	木山丆〢
狐	犭ノ⺁󰂃
椳	木田一󰀖
䚯	言刂󰀢
㚯	女几乂󰁶
椶	木乂凵夂
舋	󰀗ㄇ一一
鈋	釒亻ヒ󰁀
戋	一戈󰀦
爋	火丿一力
像	亻⺈口󰀓
㣽	女心󰁧
䛣	言由一ㄅ
椾	木䒑月刂
鈖	釒八刀󰁥
舖	人干口甫
楄	木丶尸艹
楅	木一口田
㵄	氵戈口大
楇	木ㄇ󰁈口
嵄	山丷王大
䇋	立夕夕󰁶
嘠	口丆󰀐戈
䥜	釒門木󰁶
㥜	忄田月󰀝
䝸	貝艹十又
鹡	󰀪人月一
蘠	艹爿土口
瘠	疒󰀪人月
楜	木古月󰀝
䣓	一口冂阝
㞨	山子󰀝
䞨	土󰁾土土
儯	亻丷夫灬
惼	忄丶尸艹
䃼	礻󰁶卜󰁶
㚣	女女󰀘
楋	木木口刂
燋	火亻󰁷灬
浄	氵⺈󰁬亅
釋	丿米罒十
资	冫⺈人贝
楍	木口口口
勐	子皿力ノ
拐	扌口力ノ
愯	忄亻󰁷又
䄿	禾日󰁒丿
楘	󰁻乛亅木
㲄	士冖王又
䊋	米爿士󰀝
楙	木󰁻乛木
楡	木人一巜
颜	立丿彡贝
睖	目土八夂
碜	石厶大彡
袜	衤󰁧一木
墜	阝䒑󰀓土
漡	氵𠂉曰󰁤
㝠	宀日六󰁧
䝠	豸厂白小
䆼	宀八ㄇ辶
坣	⺌冖土󰀘
憼	艹勹口心
楤	木勹󰁤心
䥻	钅二󰁜󰁀
業	业䒑未󰁧
䡓	彳車一丁
䛸	言广󰀥口
惒	禾口心󰁧
僒	亻宀八口
銋	釒亻丿士
楰	木臼人󰁶
蓂	艹冖曰六
楳	木甘木󰁶
劋	口口口刂
沄	氵二厶󰁶
粄	米⺁又󰁶
貄	豸󰁬󰀟󰀢
楶	冫⺈人木
㽗	田人󰁶
䜣	讠斤󰀢
慼	戊上小心
剋	古儿刂󰀵
䳄	止󰁴󰁟灬
㳄	氵⺈人󰁶
惖	曰勹󰁤心
枠	木九十󰀢
壜	土曰󰀙厶
螠	虫䒑八皿
瞠	目⺌冖土
舀	爫臼󰀘
䤗	立早夂一
信	亻言󰀝
㞠	尸大丷小
圸	土山󰀢
䦌	門土󰀌
侾	亻土丿子
㣠	彳丨夂󰁦
䃧	阝夂一石
壠	土立月三
棠	⺌冖口木
磠	石󰀥囗󰁘
裠	󰁬丿口󰀔
郧	口贝阝󰀢
牋	丿丨一戈
泄	氵廿󰄃󰁀
点	󰀥口灬󰁧
逌	󰀥囗󰁃辶
蟍	虫禾刂木
瀌	氵󰁙󰁴灬
㰄	木貝戈戈
䰄	󰂞彡田心
赵	土󰁾乂󰀦
辛	辛丶一丨
壗	土󰁬丨皿
䄖	礻󰁶人刂
解	⺈月丨󰀟
鄖	口貝阝󰀢
榑	木甫寸󰁶
䖹	虫丨一干
㹺	犭󰁥水日
勌	丷夫⺋力
榓	木心丿皿
蠽	小亻󰁷虫
頽	禾几丆貝
砽	石用󰀢
䠽	丿󰀽三䒑
榙	木艹人口
牵	大冖丿󰀟
篾	⺮罒厂丶
广	广丶一丿
饺	⺈󰁐亠乂
堣	土曰冂丶
䁢	目方𠂉󰁾
呩	口二小󰁶
榝	木乂朩又
錋	釒月月󰀝
榢	木宀一󰀓
猋	犬犬犬󰁧
茋	艹󰁚󰀁丶
射	丿󰀽三寸
挋	扌匚丨丨
榣	木爫𠂉凵
榤	木夕㐄木
䱄	󰁢灬⺁󰂃
㱄	󰀹土灬人
噹	口⺌冖田
錩	釒日曰󰀝
怢	忄丿夫󰁶
齡	止󰀆人󰁻
轡	糹車糹口
硜	石一巛工
桜	木󰀧女󰀝
彡	彡丿丿丿
佡	亻人山󰀢
㽡	田白丿十
婗	女臼儿󰁀
㡣	亠丷冖三
犖	火火冖󰀟
䈌	⺮氵󰀐一
墀	土尸氺󰀟
㐩	二󰀯二󰀯
榰	木土丿日
䢽	󰁺八口巴
聼	乛耳十心
融	一口冂虫
䢣	夕言辶󰀌
鋋	釒丿󰀥廴
䛩	言一󰀚一
䉌	⺮阝䒑󰀓
拋	扌乚力
勋	口贝力ノ
苋	艹ㄇ󰁜󰀅
狋	犭󰁥二小
珖	王⺌一儿
嗟	口䒑󰀠工
壞	土亠罒󰀔
蛽	虫貝󰁶
曽	丷田日󰀘
槄	木爫臼󰀝
槅	木一口丨
雽	󰀙丿丷󰀛
槉	木疒𠂉大
傢	亻宀一󰀓
簚	⺮罒戈丨
㮄	木二勹方
䮄	󰀋灬亠幺
宄	宀九󰀅
掋	扌广󰁚丶
箄	⺮白丿十
蜊	虫禾刂󰀢
鎋	釒宀三口
朊	月二儿󰁀
圊	囗主月󰀌
佋	亻刀口󰀝
栠	亻丿士木
堠	土亻ユ大
依	亻亠󰀔󰁶
鐖	釒幺幺人
萖	艹臼儿󰀅
靜	月爫亅
辝	厶口辛󰀢
搖	扌󰁝𠂉凵
嚩	口糹甫寸
庆	广大󰀦
眽	目⺁󰀕󰁶
霽	󰀙󰀴󰀳󰀘
䎌	羽口󰁾󰁶
槙	木十󰀣八
差	䒑󰀠工󰀘
戊	厂󰅅丶󰀦
槜	木亻󰁷乃
䒹	艹二木󰁧
郌	土土口巴
灹	火丿七󰁀
僌	亻車攵󰁶
援	扌爫一又
⺪	乛止󰀌
䏌	八月󰀘
衔	彳钅一丁
憖	木人人心
愢	忄田心󰁶
㧠	扌厶小󰁶
䧠	阝一日寸
圜	囗罒一󰀔
槠	木讠土日
鞙	廿󰀜口月
䄢	礻󰁶󰀴󰀳
槯	木山亻󰁷
槰	木夂三辶
影	曰󰁸小彡
㘩	土󰁴匕󰁀
㲺	氵七󰁀
䞽	土󰁾十小
眜	目一木󰁶
軝	車󰁚󰀁󰁀
駠	󰀋灬󰁚卩
槳	爿󰁝寸木
腢	月曰冂丶
䜩	讠廿口灬
㻪	王亻󰁷乃
槵	木口口心
屲	丿山󰀬
樀	木亠丷古
樁	木三人臼
䋖	糹󰁬󰀟󰀢
樂	白幺幺木
㬄	日厂土󰁖
狖	犭󰁥宀八
懣	氵廿冂心
搋	扌⺁󰅋几
琋	王乂丨
䐋	月八厶心
吋	口寸󰁶
樄	木阝木曰
樅	木彳人󰁾
㟜	山弓⺈小
鐋	釒氵日󰁤
儧	亻夫夫貝
䢠	火廾辶󰀵
碠	石󰁸冖丁
愧	忄白󰁜厶
鄧	癶一口阝
脧	󰀼冫厶夂
唹	口方人󰁦
䔹	艹阝䒑󰀓
樌	木毌貝󰁶
㺽	王丆卜一
發	癶弓几又
谫	讠䒑月刀
雼	󰀙石󰀘
樓	木󰀻女󰀝
樔	木巛曰木
旤	冂󰁈冂󰁜
僩	亻門月󰀝
樕	木木口人
樖	人一口口
䆣	宀八厂󰀖
樚	木󰁙󰁴匕
坺	土又丶
㭄	木⺄十󰀢
㹽	犭󰁥戈戈
友	又󰁧
䏋	󰁬丨八巳
珋	王󰁚丿卩
揋	扌田一󰀖
鏋	釒廿冂丶
㡠	冂丨癶䒑
暼	㡀攵曰󰀘
皼	士冖一皮
桠	木一󰅊一
硠	石丶艮󰁶
佝	亻勹口󰀝
內	冂丿󰂃󰀦
獫	犭󰁥人人
䥪	釒日幺灬
腧	月人一刂
鞜	廿󰀜水日
摖	扌󰁯二小
瑖	王丿丨又
葖	艹宀八犬
鑖	釒艹罒人
觚	⺈用⺁󰂃
䲗	󰁢灬彳丁
厹	九厶󰁧
樬	木丿囗心
樮	木覀火󰁶
樲	木󰀁二丶
羆	罒厶月灬
樸	木业䒑夫
㪄	弓󰀯攵󰁶
䒋	ㄇ大⺈巴
咋	口𠂉丨二
撋	扌門王󰀝
樺	木艹一󰀟
䓌	艹士心󰁧
凨	几二厶󰀦
钖	钅ㄋ󰁤󰁥
椠	车斤木󰁧
夠	夕夕勹口
䂧	石⺈小󰁶
㤠	一夕刂心
璋	王立早󰀢
蒋	艹丬夕寸
钋	钅卜󰁶
蒖	艹十󰀣八
呹	口丿夫󰁶
橅	木𠂉一灬
橆	𠂉一󰀷木
凵	凵󰄃丨
橋	木丿大口
陜	阝大人人
肧	月丆卜󰁶
癜	疒尸󰁺又
䐌	ㄇ󰁺八月
㯍	木爿󰁝寸
䰤	木日白厶
橓	木爫冖㐄
科	禾󰁦十󰀢
䐹	月󰁬十󰀲
㯺	匚丨󰁃木
橖	木⺌冖木
㑋	亻ㄇ󰁺󰀝
㗪	口止匕小
藗	艹木口辶
菎	艹曰󰁴匕
瑋	王󰁆口㐄
櫄	木丿一灬
嫄	女厂白小
䑋	月亠口󰀔
拧	扌宀丁󰀢
章	立早󰀬
蘜	艹廿󰀜米
葋	艹月勹口
橞	木一曰心
機	木幺幺人
䑌	月門木󰀹
邘	一󰀛阝󰀢
橤	心心心木
㲍	十又毛󰁫
䋹	糹一口田
䨩	󰀙礻󰁶丨
橦	木立曰土
㫠	日丷󰀟󰀢
䋧	糹尸古󰀝
川	川丿丨丨
橧	木丷󰀺日
橨	木十艹貝
橩	木火火几
灘	氵廿口󰁷
芣	艹丆卜󰁧
昗	曰六󰁧
䘗	彳山丿丁
嘗	⺌冖口日
娄	米女󰀘
攋	扌木口貝
㨄	扌󰀼土口
䔋	艹糹小丿
橯	木火火力
妴	夕⺋女󰀘
橲	木士口口
橳	木月丷力
伝	亻二厶󰁶
㛜	亻丨攵女
榠	木冖日六
妠	女冂人󰁶
騄	󰀋灬󰁭氺
橷	木白丬儿
甋	亠丷冂丶
蔋	艹氵上又
䒩	艹禾󰁧
㵌	氵彳⺁目
䊹	糹丿十󰀢
橽	木土羊辶
覠	󰁬丿口儿
盜	氵⺈人皿
獖	犭󰁥十貝
馠	禾日人口
荖	艹土丿匕
鍖	釒󰀎八󰄃
檂	木ㄇ󰁺󰀖
檅	木止戊󰀤
檇	木亻󰁷𠃌
檋	木󰁺八車
檌	木罒丨三
檍	木立曰心
䓋	艹氵󰁚󰀁
㩄	扌山田心
橄	木乛耳夂
婄	女立口󰀝
㲪	癶一口毛
䍹	⺶丿目犬
䲻	亠幺󰁟灬
檒	木木几虫
偧	亻大夕夕
湝	氵󰁴匕白
㥠	忄乛󰁾月
䚜	⺈用白十
蓋	艹土厶皿
瓋	王亠丷辶
檓	木臼工又
铋	钅心丿ノ
檔	木⺌冖田
蘪	艹󰁙󰁴米
䎖	丷󰀺日羽
鎖	釒⺌貝󰁶
障	阝立早󰀢
檚	木木木󰁾
灧	氵山三巴
蚜	虫󰀂亅丿
檛	木ㄇ󰁈辶
檜	木人一日
檞	木⺈用󰀟
檟	木覀貝󰁶
檢	木人一人
檥	木丷王丶
䔩	艹木口攵
㳪	氵丆卜口
䔌	艹白木一
㖋	人󰀯口匕
䖋	虍几人󰁶
喋	口廿󰄃木
斋	文丆冂〢
疋	乛󰁾󰀦
薋	艹冫⺈貝
開	門一廾󰀵
騠	󰀋灬日󰁾
莧	艹目儿󰀅
稠	禾󰀼土口
樠	木廿冂丶
檦	木覀二刂
檧	木艹勹心
瓗	王山亻口
檱	木⺮󰀎八
纫	纟刀丶󰁶
檳	木宀一貝
檷	木一八乂
檺	木󰁸冖󰀓
嶝	山癶一䒑
䕜	艹羽亠十
㨠	扌冖日六
䏩	月人一口
檽	木󰀙丆〢
鄊	󰁲丿耳阝
跄	口止人⺋
焊	火日干󰀢
淄	氵巛田󰀝
巄	山立月三
䥋	釒󰁸了灬
㷄	火日木󰁶
櫀	木󰀎八小
㣘	彳勹口󰀝
蘒	艹禾丿󰁵
甗	虍一口丶
櫃	木匚口貝
㸺	氵小丿󰀟
䗹	虫䒑幺心
櫅	木󰀴󰀳󰀝
锜	钅大丁口
櫇	木皮丆貝
唗	口土󰁾󰁶
㺐	犭󰁥巛木
峝	山冂一口
泝	氵斤丶󰁶
糝	米厶厶彡
蔜	艹󰁡攵
锈	钅禾乃ノ
櫊	木門夂口
㳝	氵亻丿士
䯠	󰀾月日皿
櫍	木斤斤貝
櫒	木艹󰁯小
櫓	木󰁢灬日
櫔	木厂艹丶
櫕	木夫夫貝
犷	犭ノ广ノ
櫗	木艹罒人
櫘	木三丨心
櫜	一口丨木
虗	虍丘󰀌
嚌	口󰀴󰀳󰀝
塺	广木木土
䘋	虫人人󰀞
嘋	口土丿攵
揙	扌丶尸艹
㘋	口匚丨貝
蘋	艹止󰀤貝
阋	门臼儿󰁫
昋	一大日󰀘
瘋	疒几丿虫
窠	宀八日木
檠	艹勹口木
鸝	一冂丶灬
茧	艹虫󰁧
䑣	丿󰁪彡󰁥
䜪	八人口九
捞	扌艹冖力
櫢	木󰀻女攵
櫤	木⺮䒑刂
櫧	木言土日
櫫	一󰀓土木
櫬	木立朩儿
㗜	口亠幺田
櫯	木󰁢灬禾
匧	匚大人人
䗜	虫󰁚丶田
櫱	凵丿丿木
櫲	木󰁻乛󰀓
櫵	木艹亻灬
囌	口艹󰁢禾
际	阝二小󰁶
釻	釒九丶󰁶
臙	月廿口灬
䐣	月口貝󰁶
㗋	口⺈厂大
珆	王厶口󰀝
嗋	口力力月
䗋	虫甘木󰁶
痋	疒虫󰀦
旋	方𠂉乛󰁾
闋	門癶一大
藋	艹羽亻󰁷
薜	艹尸口辛
驠	󰀋灬廿灬
橠	木亠夕󰀔
穠	禾ㄇ󰁺󰀖
櫸	木󰀗一󰀟
櫾	木爫𠂉小
欄	木門木󰀹
瀖	氵󰀙亻󰁷
權	木艹口󰁷
䊨	󰄹月米几
㘌	口虍一刂
欋	木目目󰁷
䩠	廿󰀜丿廴
嵝	山米女󰀝
埗	土止󰀤󰁥
㖜	󰁸口匕󰀅
瞫	目覀早󰀢
楟	木󰁸冖丁
欒	言糹糹木
欓	木⺌冖灬
隋	阝工月
欗	木艹門󰀹
蠗	虫羽亻󰁷
頗	皮丆貝󰁶
嚋	口士乛寸
暋	󰁂󰀁攵日
皋	白大十󰀬
蚋	虫冂人󰁶
旸	日ㄋ󰁤󰁥
㿪	皮九丶󰁶
㚋	夕夕󰀼口
䚋	口貝目儿
欦	人丶乛人
板	木⺁又󰁶
㼵	日一󰁾丶
鬠	󰂞彡人日
葜	艹三丨大
笠	⺮立󰀘
欠	⺈人󰁧
嬠	女口口木
䑜	丿古廿木
㑜	亻扌斤󰀢
堗	土宀八犬
剻	山月月刂
㾐	疒一夕刂
㺍	犭󰁥宀八
䙌	衤󰁧口贝
欫	𠂉一止人
欬	亠ㄥ丿人
欮	䒑凵丿人
蕗	艹口止口
畗	󰁸田󰀘
㽍	甘一󰁐丶
匨	匚爿士󰀌
欸	厶𠂉大人
㳠	氵大辶󰁶
䓧	艹了口一
峠	山上一卜
泠	氵人丶󰁻
篝	⺮󰀀冂土
萜	艹冂丨口
鐜	󰁸孑攵金
癋	疒一󰀚心
晋	一󰅊一日
哙	口人二厶
牺	牜西󰀝
驻	󰀊󰀞丶王
㹐	彳人人󰀟
敗	貝攵󰁶
啗	口⺈臼󰀝
欿	⺈臼⺈人
歀	木二小人
歁	󰀎八󰄃人
歄	ㄇ󰁈冂人
歊	󰁸冂口人
歋	⺁虍几人
歍	󰁞灬⺈人
歎	廿口夫人
勨	⺈口󰀓力
歒	亠丷冂人
歓	𠂉一亻人
䢫	阝工辶
㷚	火󰁸冖丁
䲺	甘󰁟灬󰁶
㸐	廿口夫灬
䖗	虍戊一口
霋	󰀙一󰁬女
棓	木立口󰀝
看	目󰀘
蜋	虫丶艮󰁶
國	囗戈口󰀞
朋	月月󰀝
㜋	女䒑八皿
䜋	言口丨貝
麇	广󰁃〢禾
歗	󰁬十󰀲人
歚	羊䒑口人
鴝	勹口󰁟灬
歛	人一口人
崏	山󰁚󰀁日
洝	氵宀女󰀝
哜	口文󰀯󰀢
讠	讠丶󰁉
爧	火󰀙口人
橴	木止匕小
歟	󰀗一󰁕人
䈧	⺮爫丿灬
㴝	禾刂人水
昹	日丶𠃌󰀩
陇	阝ヒ丶
冨	冖一口田
歫	止匚󰁃󰀝
歬	止丿󰁪󰁧
圌	囗山丆〢
䜌	言糹糹󰁶
蜸	匚丨󰁃虫
瑄	王宀一一
雋	亻󰁷丨𠃌
歳	止戊一小
歵	止貝󰁶
曋	日覀早󰀢
囋	口丿土貝
蛋	乛󰁾虫󰁧
盋	又丶皿
䪼	凵山丆貝
脯	月一月丶
䛋	言戊󰁶
㛋	女人⺗󰁶
隔	阝一口丨
躁	口止口木
钜	钅匚󰁃󰀝
歸	丿󰃧止丨
筠	⺮土勹冫
蒜	艹二小小
孠	𠃌一口子
撜	扌癶一䒑
㒜	亻󰀗一八
䉧	⺮󰁚丶刂
歽	一夕斤󰀢
歾	一夕勹󰁤
歿	一夕󰁡又
䝌	一󰀓又又
卨	󰀥ㄇ󰁈口
䍨	⺶一冂丨
侄	亻一厶土
型	一廾刂土
澄	氵癶一䒑
羄	罒糹󰀥早
㖧	口󰁚󰀁日
龄	止人凵󰁻
殀	一夕丿大
㖍	󰁦十口匕
箝	⺮扌艹二
捜	扌曰丨又
卜	卜丨丶
䖧	虫日一󰀝
殅	一夕丿
㹩	犭󰁥又土
鍜	釒󰁃丨又
薧	艹󰁸冖匕
邖	山阝󰀢
殏	一夕一丶
殐	一夕木口
殔	一夕󰁬氺
殕	一夕立口
殗	一夕大乚
懪	忄曰󰁺氺
廚	广士口寸
攘	扌亠口󰀔
况	冫口儿󰁀
㡗	冂丨⺁几
塗	氵人一土
䡗	工几丶車
殜	一夕廿木
殝	一夕三禾
㞋	尸又󰀦
䯄	󰀊󰀞口人
㯄	木木⺁巴
殞	一夕口貝
殟	一夕曰皿
䘨	衤󰁧六乂
殠	一夕丿犬
恖	丿囗乂心
灖	氵广木三
猜	犭ノ主月
菧	艹广󰁚丶
鷠	󰁢灬󰁟灬
菝	艹扌丶
㫝	日󰁚󰀁丶
䏧	月夕夕󰁶
巠	一巛工󰀘
淠	氵田一󰀯
殥	一夕宀八
殦	一夕󰁟灬
殧	一夕󰁸丶
殨	一夕口貝
殩	一夕󰀥米
殫	一夕口十
殬	一夕罒土
殭	一夕一一
砎	石人󰀯󰀢
鲮	󰁢󰀞土夂
瘁	疒亠人十
鯄	󰁢灬一丶
荋	艹丆冂〢
範	⺮車⺋󰀅
捋	扌爫寸󰁶
寄	宀大丁口
漄	氵山厂土
缄	纟厂一丶
伄	亻弓丨󰀢
弄	王廾󰀬
旭	九日󰀌
殲	一夕人󰀞
蠋	虫罒勹虫
鼄	丿未黽󰀘
叜	宀火又󰁧
䔧	艹禾刂木
簝	⺮大丷小
沠	氵⺁丨󰂃
锧	钅⺁十贝
蔧	艹三丨彐
殶	丶王几又
䗨	虫󰁢灬󰁶
殺	乂朩几又
殼	士冖一又
殽	乂月又
殾	土丿日又
毀	臼土几又
毃	󰁸冂口又
軚	車大丶󰁶
䠌	口止水月
皙	木斤白󰀘
毇	臼米几又
釗	釒刂󰀢
䇗	⺮八厶󰁧
㐡	九丆冂大
㼄	王幺幺田
趟	土󰁾⺌口
毌	毌󰄃󰁈丨
彄	弓匚口口
佄	亻甘󰀝
罄	士󰁅几山
潄	氵木口攵
齄	丿目田一
轄	車宀三口
䣩	西一一乚
㸩	牜干󰀢
歝	罒土䒑人
籠	⺮立月三
䕧	艹󰀾月乂
啧	口主贝󰁶
毐	土󰄃𠃌
毑	母也󰁀
莜	艹亻丨夂
镧	钅门一󰅇
穫	禾艹亻又
攸	亻丨夂󰁶
毝	毛彡󰀏
毞	󰁴匕毛󰀅
㦼	三人臼戈
爗	火曰艹一
妐	女八厶󰁶
客	宀夂口󰀘
毢	毛西󰀌
毤	八厶儿毛
毥	毛勹日󰀌
毦	耳毛󰁀
毧	毛戈󰀏
䙨	衤󰁧日󰀔
㟋	山丷口儿
毩	毛米󰀦
碋	石山丁口
袋	亻󰀁丶󰀔
颋	丿士廴贝
儨	亻斤斤貝
㢋	广亻夕夕
䃊	石艹󰀐一
墋	土厶厶彡
梋	木口月󰀝
愨	士冖一心
鴠	日󰀞󰁟灬
艜	丿󰁪廿丨
窝	宀八口人
撧	扌糹⺈巴
媝	禾火女󰀘
䴠	󰁙󰁴匕大
㴠	氵了口凵
急	⺈彐心󰁧
孿	言糹糹子
命	人一口卩
媫	女󰀥󰁬󰁾
毬	毛一氺丶
毮	扌小丿毛
婧	女主月󰀝
毱	毛勹米󰀦
毲	又又又毛
淘	氵勹󰅎山
屻	山刀丶󰁶
⺄	⺄⺄〇〇
毸	毛田心󰀦
毺	毛人一刂
䥩	釒彳山攵
毿	厶厶厶毛
组	纟󰀐一󰀝
滄	氵人丶口
䈜	⺮亻彐又
仄	厂人󰀦
槝	木󰁟山󰀢
盧	虍田皿󰀌
軠	車丿士󰀝
鈜	釒厶󰁶
僨	亻十艹貝
驫	󰀋灬󰀋灬
蓄	艹亠ㄠ田
氀	󰀻女毛󰁀
䪿	丿囗乂貝
㠃	山亠丷古
恓	忄西󰀝
氉	口口口毛
烺	火丶艮󰁶
梻	木亻弓󰀯
氊	毛亠囗一
氋	艹冖二毛
氌	毛󰁢灬日
気	气乂󰀦
默	󰀹土灬犬
嬫	女火火木
氞	气一冂人
惗	忄人丶乛
溏	氵广󰁬口
䫐	木木丆貝
㡋	冂丨大乚
癎	疒門日󰀌
烗	火亠ㄥ人
氣	气米󰀦
酊	西一丁󰀢
氥	气西󰀌
礋	石罒土十
腊	月󰁺日󰀝
帄	冂丨丁󰀢
椋	木󰁸小󰁶
㸄	火󰀴󰀳󰀝
䅊	禾广丿七
苜	艹目󰀘
笝	⺮囗又󰁧
氫	气一巛工
鐧	釒門日󰀝
䬝	几丿虫八
㐧	丶乛亅丿
欝	木乂乂寸
嬝	女󰁟亠󰀔
氬	气一󰀚一
氭	气木曰󰀌
鷪	目目冖灬
㿤	白三人日
孫	孑丿幺小
濤	氵士乛寸
愗	󰁻乛亅心
階	阝󰁴匕白
䤻	釒工月
鄗	󰁸冂口阝
焗	火尸𠃌口
氷	丶水󰀦
荪	艹孑小󰁧
街	彳土土丁
崩	山月月󰀘
松	木八厶󰁶
蹄	口止亠丨
繄	匚𠂉大小
醂	西一木木
邊	丿目宀辶
䣋	丿米阝󰀢
㣋	二󰀯丶彡
湄	氵󰁅目󰀝
幄	冂丨尸土
驝	󰀋灬士木
汃	氵八󰁶
穝	禾曰耳又
芜	艹二󰁜󰀅
呧	口󰁚󰀁丶
橝	木覀早󰀢
㑧	亻禾子󰀝
䊜	米一日寸
汄	氵人󰁶
艗	丿󰁪䒑皿
䚹	言󰁴匕󰁀
埚	土口冂人
牗	丿丨一丨
佤	亻一󰁐丶
㽤	田勹米󰁶
嬃	彡丆貝女
㺺	王目󰀝
写	冖一ㄅ一
獂	犭󰁥厂小
嘸	口𠂉一灬
㹹	犭󰁥广人
䘸	衤󰁧亠丶
汖	山水󰁧
汙	氵一󰀛󰀢
攊	扌厂禾止
䦝	門土󰁖󰀦
䔊	艹王䒑廾
㔊	亠囗口刂
鸠	九󰁠一󰀝
覝	干火目儿
煜	火日立󰀝
枧	木ㄇ󰁜󰁀
㿽	八一ㄅ皿
犗	牜宀三口
汢	氵土󰀝
兘	二儿厶口
䱃	󰁢灬丿夫
锊	钅爫寸󰁶
蔊	艹火曰干
甊	󰀻女一丶
㯹	木覀二寸
嗸	󰁡攵口
珗	王丿土儿
䏗	月气󰁀
汬	二󰀯水󰁧
迟	尸󰂃辶󰀦
㴃	氵丶尸水
汱	氵犬󰁶
汵	氵人丶乛
拂	扌弓󰀯󰀢
劍	人一口刂
鴇	匕十󰁟灬
汸	氵方󰁥
萗	艹宀二小
宐	宀丨乛一
㐗	土丿匕乙
榋	木彐彐彐
愜	忄匚大人
磝	石󰁡攵
藧	艹糹爫又
瞼	目人一人
鞼	廿󰀜口貝
㿠	白⺌一儿
俠	亻大人人
沀	水󰁻乛亅
垼	彳几又土
䞼	土󰁾彑󰀓
䦹	阝十󰀢
腣	月亠丷丨
㦋	忄大土日
䦋	󰂞󰁡攵
凊	冫月󰀝
珞	王夂口󰀝
黩	󰀹土灬大
沋	氵乚丶
䇍	立口󰁾󰁶
沑	氵󰁈丨一
慗	木口攵心
㺃	犭󰁥艹口
㸹	牜爫寸󰁶
沚	氵止󰀝
獿	犭󰁥丆夂
菜	艹爫木󰁧
沜	氵丿丨󰁈
沝	水水󰁶
怺	忄丶𠃌󰀩
䭎	人良廿木
沞	氵一冂丨
㜧	女厂䒑人
構	木󰀀冂土
駋	󰀋灬刀口
䜧	讠刀丶止
稝	禾月月󰀝
樝	木虍󰀐一
騝	󰀋灬󰁬廴
臜	月丿土贝
䜼	󰁻乛亅䒑
幤	⺌冂口丨
憗	木人人心
朼	木匕󰁀
㧋	扌犬󰁶
圼	曰土󰀘
始	女厶口󰀝
䧋	阝目儿󰁀
嵮	山十󰀣八
㵮	氵大廿󰀟
橙	木癶一䒑
㵁	氵艹亠󰀸
夎	人人土夂
甀	丿士󰁺丶
㔸	匚⺁虍几
沨	氵几乂󰁶
沬	氵未󰁶
沯	水石󰀘
沰	氵石󰀝
䰎	󰂞彡口貝
溤	氵󰀋灬󰁶
庤	广土寸󰀦
㗭	口丿米心
卍	󰁎丨一丨
习	𠃌冫󰀌
鉊	釒刀口󰀝
樋	木󰁻用辶
㥝	忄弓耳󰀝
蝧	虫艹ㄇ大
鹠	󰁚丶刀一
憜	忄阝月
睧	目󰁚󰀁日
㴁	氵一大󰀯
敀	白攵󰁶
蕀	艹木冂冂
沺	氵田󰀝
䉊	⺮厶大車
娋	女⺌月󰀝
䲹	丆卜󰀞灬
㨋	扌土丿日
䳸	广木木灬
泆	氵丿夫󰁶
泇	氵力口󰀝
泈	氵夂󰁦󰁶
隭	阝󰀙丆〢
泑	氵幺力󰁥
䵸	禾火黽󰀘
隀	阝丿一土
暀	日彳丶王
皀	白匕󰀅
㚀	土虍一戈
虭	虫刀󰁥
䱒	󰁢灬口巴
癭	疒貝貝女
泩	氵丿󰀝
泬	氵宀八󰁶
驋	󰀋灬癶又
皧	白爫冖夂
爊	火󰁙󰁴灬
嚧	口虍田皿
䁜	目日⺌儿
㼠	宀匕一丶
勍	󰁸小力󰁥
䋍	糹丁口󰀝
盀	卜皿󰀘
㺁	犭󰁥巛乂
慁	囗一󰀓心
䕸	艹󰀹土口
刊	干刂󰀢
䩋	丆囗〢木
㩋	扌󰁬十󰀲
攍	扌󰄹月丶
䱎	󰁢灬一一
䱮	󰁢灬三大
樯	木十䒑口
儺	亻廿口󰁷
䭒	人良丿心
擭	扌艹亻又
䓭	艹乂朩刂
㲮	毛⺮人口
洐	氵彳一丁
虀	艹󰀴丨一
晀	日儿󰀪󰁶
㟝	山立口󰀝
䀜	勹󰁤目󰀘
儦	亻󰁙󰁴灬
棧	木戈戈󰁶
焦	亻󰁷灬󰁧
骋	󰀊󰀞由ㄅ
犑	牜目犬󰁶
洓	氵木冂󰁀
洕	氵八月󰀝
媋	女三人日
拊	扌亻寸󰁶
狊	目犬󰁧
苊	艹厂⺋󰀅
洘	氵土丿ㄅ
䤾	釒爫臼󰀝
㪋	日干󰀥又
䪋	廿󰀜口辶
荏	艹亻丿士
閭	門口口󰀌
洜	夂口水󰁧
洠	氵厶丿󰀟
䮹	󰀋灬止󰀤
䒍	亠丷冖巴
䍏	冂〢一󰀌
枀	八厶木󰁧
䞀	貝亻ユ大
洣	氵米󰁶
憺	忄⺈厂言
䆺	宀八丿田
㽹	疒⺁又󰀦
蕭	艹󰁬十󰀲
畭	田人一朩
洬	氵几一夕
䫹	几丿虫工
柀	木皮󰁶
侁	亻丿土儿
遜	孑丿幺辶
昧	日二󰅇󰁶
髋	󰀾月宀󰁜
辠	丿目辛󰀬
烜	火一曰一
把	扌巴󰁀
嫋	女弓冫冫
䃜	匚𠂉大石
㤝	忄亠厶儿
矀	目彳山攵
䉺	米工󰀝
䊊	米尸毛󰁀
㫋	方𠂉冂土
㼴	日冂丨丶
剺	未攵厂刀
殖	一夕十󰀣
洸	氵⺌一儿
㭮	木巛一夕
萭	艹丿口丶
孮	孑宀二小
圀	囗八方󰀏
眀	目月󰀝
䰹	󰁢灬戈󰁶
浉	氵リ一丨
戺	丶尸巳󰁀
弒	乂木丶丶
㼁	王丷王丶
蝀	虫木曰󰀝
靀	󰀙艹冖󰀓
闧	門土口辶
匸	匚一󰄃
䵍	󰁺由八子
浛	氵人丶口
硝	石⺌月󰀝
轠	車田田田
彠	彐工口又
悜	忄口王󰀝
㽠	田大人人
荊	艹一廾刂
半	丷󰀟󰀵
捊	扌爫子󰀝
㬋	日亻ユ大
䬋	几丿虫夂
浝	氵乚丶
浫	氵冖八干
浬	氵曰土󰀝
脇	月力力力
䯤	󰀾月人日
䚓	覀早目儿
掘	扌尸凵山
牝	牜匕󰁀
浶	氵宀丿󰀟
鑭	釒門木󰀹
䑭	丿󰁪氵工
浿	氵貝󰁶
喸	甫口匕󰀅
旑	方大丁口
涊	氵刀丶心
䲎	󰁢灬乛攵
㲎	毛毛󰁀
塙	土󰁸冂口
錬	釒木曰󰀝
阧	阝󰁦十󰀢
棝	木囗古󰀝
䌬	糹立月三
憇	丿古甘心
熇	火󰁸冂口
鞝	廿󰀜⺌口
腦	月巛丿乂
膇	月丿󰃧辶
表	主󰀔󰁧
䬹	人良一土
啌	口宀八工
䩺	廿󰀜八羽
䛍	言弓󰀯󰀢
苬	艹囗人󰁧
嬭	女一八乂
慇	⺁彐𠃌心
酇	丿土󰁜阝
藼	艹宀三心
腰	月覀女󰀝
蕘	艹土土儿
宑	宀二󰀯󰀬
鎭	釒匕目八
䜍	言大丷小
圍	囗󰁆口㐄
煎	䒑月刂灬
琗	王亠人十
右	口󰀘
㺞	犭󰁥󰀗八
䛝	言󰁈丨山
囝	囗子󰀌
溞	氵又丶虫
㝿	乚皮󰀦
瀇	氵广󰁺八
耇	土丿勹口
妀	󰁁女󰀝
怇	忄匚󰁃󰀝
䁩	目󰁢灬󰁶
膦	月米夕丨
饧	⺈󰁐ㄋ󰁤
䏊	耳立月三
宋	宀木󰁧
残	一夕二丶
箋	⺮戈戈󰁧
菊	艹勹米󰁧
鏊	主󰁡夂金
偩	亻⺈貝󰁶
㿫	󰁴匕皮󰁧
淃	氵丷夫⺋
䰮	白󰁜厶丶
輶	車丷西一
尮	乚乃木
戹	丶尸乙󰁫
䧺	口亻󰁷
塋	火火冖土
嫖	女覀二小
䙍	衤󰁧⺄丨
怫	忄弓󰀯󰀢
逫	又又又辶
貙	豸匚口口
㞝	戊上小尸
䀩	目夂口󰀝
㟪	山田一󰀖
淓	氵艹方󰁥
翞	羽󰁸小󰁶
枝	木十又󰁶
兦	丿󰂃󰄃󰁫
䅦	禾艹田󰀝
郦	一冂丶阝
胦	月ㄇ大󰁶
㯋	匕木丆貝
淚	氵丶尸犬
厊	厂󰀄亅丿
䎊	夂口羽󰀝
篋	⺮匚大人
掊	扌立口󰀝
鯋	󰁢灬氵丿
诋	讠󰁚󰀁丶
淛	氵𠂉一刂
姭	力力力女
瘘	疒米女󰀌
淟	氵ㄇ󰁺八
㚍	夕夕口貝
䚍	貝目儿
嚍	口󰁬丨皿
淣	氵臼儿󰁀
淥	氵彑氺󰁶
淧	氵宀心丿
淩	氵土八夂
釬	釒干󰀢
淭	氵丶尸木
燬	火臼工又
淰	氵人丶心
㝝	宀木木󰁧
淲	氵虍几󰁀
勩	廿󰄃貝力
楧	木艹ㄇ大
睝	禾勹丿目
䝝	豸大丁口
坝	土贝󰁶
蟝	虫氵匚木
㑊	亻亠󰁖󰁶
淵	氵󰀲一󰀝
懬	广󰁺由心
摊	扌又亻󰁷
簋	⺮艮皿󰀘
䰋	󰂞彡日女
尋	彐工口寸
渙	氵⺈ㄇ大
傹	亻立曰儿
谋	讠艹二木
鰋	󰁢灬匚女
悹	宀󰃧心󰁧
怌	忄丆卜一
䀌	󰁬󰀟丆皿
㾎	疒丨󰁎一
芀	艹刀󰁣
銀	釒艮󰁶
龤	人一口白
劀	󰁻乛亅刂
銬	釒土丿ㄅ
婭	女一󰀚一
悆	人一朩心
㩭	扌󰀗乂子
炆	火文󰁶
慹	土䒑十心
㤧	忄⺁一口
㽎	󰀎八󰄃󰁜
彞	󰁭米幺廾
佞	亻二女󰀝
礧	石田田田
惦	忄广󰀥口
㱋	󰀙亻󰁷人
䠍	口止󰁃又
苀	艹亠几󰀅
狀	爿犬󰁶
琊	王󰀂亅阝
隝	阝󰁟灬󰁶
蚝	虫毛󰁀
皝	白王⺌儿
呏	口丿廾󰀢
抴	扌廿󰄃󰁀
鐊	釒阝日󰁤
豋	󰁯一口䒑
㪁	人丶乛又
鉬	釒目󰀝
䪭	立日立日
㢇	广言󰀌
遆	亠丷冖辶
渘	氵󰁻乛木
減	氵戊一口
䍩	⺶攵󰁶
愬	䒑凵丿心
㗝	口䒑王灬
䫧	白大十貝
嶞	阝工山
龁	止人凵乙
婁	󰀻女󰀘
戀	言糹糹心
儹	亻丿土貝
䣺	西一口月
嗘	口爫幺大
渦	氵ㄇ󰁈口
渧	氵亠丷丨
㓊	冫冂一口
䓊	艹五口󰀘
岋	山乃󰂃󰁶
擊	車凵几手
陝	阝大丿丶
渨	氵田一󰀖
硧	石󰁻用󰀢
輞	車冂䒑󰄃
測	氵貝刂󰀢
壭	士卩󰀬
齻	止󰀆十八
齺	止󰀆勹丿
瓊	王⺈ㄇ夂
貋	豸曰干󰀢
铊	钅宀匕󰁀
渰	氵人一廾
挩	扌八口儿
䌩	糹艹罒人
艀	丿󰁪爫子
䨁	󰁻乛亅󰁷
牀	爿木󰁶
釫	釒二ㄅ󰁀
渹	氵勹言󰀝
㿎	疒十艹貝
梧	木五口󰀝
偦	亻乛󰁾月
䚝	⺈用亠十
㚝	大亻土土
渿	氵木二小
湁	氵扌人口
湂	氵口口ㄅ
凩	几木󰀦
䳋	虫󰁟灬󰁶
㒊	亻刀丶止
泋	氵十廾󰀢
峋	山勹日󰀝
蠧	士冖石虫
眝	目宀丁󰀢
玀	犭󰁥罒󰁷
鹞	爫󰅎山一
莀	艹厂二󰀖
湋	氵󰁆口㐄
膬	月毛毛毛
䖩	虫心丿󰁥
蒊	艹亻ヒ匕
璊	王廿冂丶
醬	爿󰁝寸一
钊	钅刂󰀢
㰚	木亠乂󰁷
䡺	車三丨心
䥭	一氺丶金
儌	亻白方攵
腬	月󰁻乛木
湞	氵󰀥貝󰁶
揀	扌木󰀹󰀝
䏀	耳木口刂
噝	口糹幺小
漞	氵爫目儿
㡧	冂丨宀䒑
䙝	亠土䒑󰀔
齘	止󰀆人󰀯
愙	宀夂口心
儙	亻口丨辶
䏪	月耳󰀝
啊	口阝丁口
敊	上小󰀥又
㴋	氵󰁬丨八
䴋	󰁟灬罒󰀔
矧	𠂉大弓丨
耦	三󰅇日丶
韧	二𠃌丨丶
㣚	彳冂一口
䅬	禾䒑八皿
㿻	干皿󰀘
湡	氵曰冂丶
惌	宀夕⺋心
镊	钅耳又又
䤍	西一廿丶
畊	田二󰀯󰀢
蕊	艹心心心
猀	犭󰁥氵丿
瀬	氵木口貝
怬	忄四󰀝
湥	氵宀八犬
湦	氵日丿
湧	氵󰁻用力
逬	丿一辶
湩	氵丿一土
乞	𠂉乙󰀅
㹞	犭󰁥斤󰀢
朝	十早月󰀝
堧	土丆冂大
湪	氵彑󰀓󰁶
塜	土冖二󰀓
齋	󰀴󰀳小󰁧
锋	钅夂三丨
湰	氵夂一
慙	車斤心󰁧
䎪	二木日寸
嘩	口艹一󰀟
㢚	广虍田力
㾻	疒阝人朩
獀	犭󰁥臼又
彮	宀八人彡
鷞	大乂乂灬
讧	讠工󰀝
疝	疒山󰀵
淞	氵木八厶
栭	木丆冂〢
頭	一口䒑貝
怹	亻也心󰁧
倹	亻人一人
湸	氵󰁸冖几
湹	氵厂曰土
㲞	亠人人毛
䓝	艹子皿󰀘
䬁	几丿虫匕
鼮	臼󰁐󰁦廴
捀	扌夂三丨
湺	氵亻口木
䚫	白方攵用
養	䒑夫丶艮
褊	衤󰁧丶艹
烉	⺈ㄇ八火
椊	木亠人十
僉	人一口人
䃉	石󰁂󰀁日
㤊	忄乂乂󰁶
溂	氵木口刂
溄	氵山夂󰀟
佮	亻人一口
䒀	丿󰁪⺮寸
㰫	丿土儿人
肬	月乚丶
䑪	丿󰁪人口
溋	氵乃又皿
蕝	艹糹⺈巴
鎦	釒󰁚丶田
渞	氵䒑丿目
畝	亠田ク󰂃
撀	士󰁅几手
溑	氵⺌貝󰁶
䤪	釒几木󰁶
媄	女丷王大
溕	氵冖二󰀓
㗊	口口口口
䗊	虫火火󰁶
嶋	山󰁟灬󰁶
涋	氵宀犬󰁶
䮧	十早人灬
㷞	火厂日子
鶋	尸古󰁟灬
湨	氵目犬󰁶
䲁	󰁢灬尸寸
鼉	口口田黽
聬	耳八厶羽
遬	木口⺈辶
㱫	一夕木󰀹
䐪	月亻󰁷乃
僙	亻󰁺由八
瓀	王󰀙丆〢
㼻	彳人人丶
䈍	⺮亠󰄃目
䝺	文文貝󰁧
溠	氵⺶工󰀝
凍	冫木曰󰀝
悩	忄󰀧乂凵
㱁	凵山二人
瘝	疒罒󰀫󰀦
浞	氵口󰁾󰁶
阝	阝󰁋丨
苦	艹古󰀘
䱁	󰁢灬木一
溩	氵󰁞灬󰁶
琀	王人丶口
萀	艹虍几󰀅
㷋	火火火󰁶
鐀	釒口丨貝
喊	口厂一丶
䖊	乂虍几󰁀
䕝	艹禾爫土
帞	冂丨丆日
鷋	艹人一灬
跋	口止丶
溮	氵丿󰃧丨
䚺	言攵󰁶
䢪	丿大口辶
霬	󰀙田󰁺八
眬	目ヒ丶
廭	广禾貝
㛬	女土八土
㳫	水臼󰀘
瑀	王丿口丶
摀	扌󰁞灬󰁶
蛬	󰁺八虫󰁧
雬	󰀙木󰁧
盬	匚丨󰁃皿
䖀	艹口口口
滊	氵气米󰁶
巁	山厂艹丶
挦	扌彐寸󰁶
痝	疒乚丶
茦	艹木冂󰀅
髧	󰂞彡冖󰁜
㩚	扌艹冖󰀓
滌	氵亻丨朩
滐	氵夕㐄木
㠪	一上󰀌
下	一卜󰀦
帋	󰁚󰀁冂丨
滖	氵亠口󰀔
㸋	󰁝火丿田
㬧	日凵山小
陊	阝夕夕󰁶
晊	日一厶土
癊	疒阝人厶
滙	氵匚亻󰁷
嫈	火火冖女
筴	⺮大人人
瞭	目大丷小
旀	方厶小󰁶
噐	口口工口
闀	門󰁺八巳
滪	氵󰁻乛贝
嵳	山⺶工󰀘
滭	氵曰艹󰀟
滮	氵虍几彡
糟	米一ㄇ日
婾	女人一巜
愪	忄口貝󰁶
滳	氵亠丷口
滸	氵言𠂉十
䰏	󰂞彡十󰁷
収	󰁐丨又󰁶
昮	曰工力󰁣
鉦	釒一止󰀝
蒝	艹厂白小
牦	牜丿二乚
撝	扌爫丿灬
㳧	氵耳乚󰁀
嘊	口山厂土
之	之之之之
㹋	牜亻丨彡
䜽	一口䒑刂
鹋	艹田勹一
蘊	艹糹囗皿
瘊	疒亻ユ大
昊	日一大󰁧
闁	門門󰀌
漀	士󰁅几水
漁	氵󰁢灬󰁶
挙	󰀧一八手
䫚	ㄇ󰁈冂貝
㷫	士󰁅几火
漇	氵彳止󰁾
漈	氵󰁯二小
漊	氵󰀻女󰀝
漋	氵阝夂一
丯	彡丨󰀵
藮	艹木亻灬
蘐	艹言爫又
攁	扌䒑夫艮
巂	山亻󰁷口
甁	丿一丶
罪	罒丨三三
漗	氵丿囗心
銦	釒囗大󰁶
漘	氵厂二月
瑝	王白王󰀝
贞	󰀥贝󰁧
崞	山󰁸子󰀝
抦	扌一冂人
䉦	⺮覀大辶
㳞	氵亻口丨
益	䒑八皿󰀘
蛊	虫皿󰀘
蒮	艹冖亻󰁷
⺋	⺋𠃌乚
㺋	犭󰁥八羽
事	一口󰁬亅
䒮	艹冖几丶
䥘	釒人人日
卙	󰀎八󰄃十
漜	氵木木土
漟	氵⺌冖土
漢	氵廿口夫
㹂	匚丨󰁃󰀟
畁	由一󰀯󰀬
漥	氵宀八土
漦	未攵厂水
漨	氵夂三辶
葮	艹丿丨又
䝤	豸大丷小
䲯	乃丶󰁟灬
麠	󰁙󰁴匕一
﨧	釒土丿子
㲯	匚丨󰁃毛
騧	󰀋灬ㄇ口
劙	彑󰀓虫刂
䭚	人良立土
樧	木乂木又
隊	阝䒑󰀓󰁶
臦	󰁃丨匚丨
稧	禾三丨大
㩧	扌日󰁺氺
䊦	米士冖䒑
蚊	虫文󰁶
绋	纟弓󰀯󰀢
皁	白十󰀬
嚁	口羽亻󰁷
介	人󰀯󰀬
㚊	夕夕亠人
漴	氵山宀小
瀚	氵十日羽
㘪	土毛󰁀
漵	氵人一攵
倻	亻耳阝󰀢
䭏	人良丶艹
䟿	口止󰁭氺
漽	氵尸氺󰀟
漿	爿󰁝寸水
潀	氵罒亻丶
潁	匕水丆貝
霮	󰀙氵󰀎󰄃
廯	广󰁢灬羊
䬏	几丿虫口
裏	亠曰土󰀔
勎	土八土力
駧	󰀋灬冂口
潅	氵𠂉一󰁷
潈	氵罒󰀓󰁶
潊	氵人一又
哝	口冖󰀔󰁶
擝	扌日月皿
粞	米西󰀝
蓝	艹〢𠂉皿
睊	目口月󰀝
蝊	虫宀一󰁾
䇦	⺮ㄇ大󰁧
㨧	扌厶大田
㼋	古⺁厶󰂃
伋	亻乃󰂃󰁶
潌	氵宀八土
潎	氵㡀攵󰁶
潏	氵󰁻乛口
潐	氵亻󰁷灬
潒	氵⺈口󰀓
潓	氵一曰心
搙	扌厂二寸
曮	日口口攵
昁	日一冂丨
㺂	犭󰁥戊口
䫏	󰀎八丆貝
潚	氵󰁬十󰀲
潝	氵人一羽
錊	釒亠人十
茊	艹丘󰀘
猊	犭ノ臼儿
挊	扌上一卜
孋	女一ㄇ匕
䭋	人良亻木
㭋	木三丨󰀢
潟	氵臼勹灬
潠	氵巳巳八
䵯	󰀹土灬土
敽	丿大口又
庂	广人󰀦
潨	氵丿罒乑
篞	⺮氵曰土
掝	扌戈口󰀞
厝	厂󰁺日󰀌
䯞	󰀾月ㄇ口
潩	氵田󰁺八
潫	氵丷夫小
镦	钅󰁸孑攵
莝	艹人人土
䉎	⺮⺌冖木
潬	氵口口十
潰	氵口丨貝
唺	口ㄇ󰁺八
攺	󰁂攵󰁶
嶯	山口耳丶
㽂	人一口丶
鞁	廿󰀜皮󰁶
䝪	貝乛󰁾󰁶
厙	厂車󰀵
潾	氵米夕㐄
潿	氵囗󰁆㐄
劎	人一口刀
䊎	米丷夫⺋
澅	氵󰁬土一
澇	氵火火力
㯯	木夂㐄貝
寯	宀亻󰁷𠃌
萮	艹人一刂
㼂	󰀗一ㄅ丶
㶧	火冂人󰁶
锞	钅日木󰁶
矁	目禾火心
澑	氵一〢田
浧	氵口王󰀝
疦	疒ユ人󰀦
䖦	虫凵山󰀢
嵧	山󰁚丶田
澒	氵工丆貝
澓	氵彳𠂉攵
赧	土󰁖卩又
㾋	疒亻木󰀦
例	亻一夕刂
倉	人丶彐口
澋	氵曰󰁸小
矊	目糹白丨
辋	车冂䒑󰄃
龋	止人凵丶
唙	口犭󰁥火
㔙	䒑廾力󰁥
澔	氵白丿口
澕	氵艹一󰀟
澘	氵木木曰
懻	忄丬匕八
䝴	一口丨貝
澙	氵臼一灬
澚	氵丿冂ㄅ
鸁	󰄹月󰁟丶
珮	王几一丨
鷾	立日心灬
澥	氵⺈用󰀟
澦	氵󰁻乛貝
澩	󰀗乂乂水
㰞	山⺈人󰁶
澪	氵󰀙人󰁻
澫	氵艹曰丶
吝	文口󰀘
䴧	󰁙󰁴󰁴女
筞	⺮宀木󰁧
搝	扌丿目犬
鐝	釒厂䒑人
货	亻ヒ贝󰁧
㿋	疒口口木
澬	氵冫⺈貝
垊	土󰁂󰀁󰁀
俋	亻口巴󰁀
瞊	目广󰁬口
枊	木󰁚卩󰀢
鞊	廿󰀜士口
聉	耳凵山󰀢
䟫	⺌冖口󰁾
啙	止匕口口
澭	氵亠󰁲󰁷
㲚	氵小丿毛
澮	氵人一日
澰	氵人一人
䞴	土󰁾󰀼口
蚹	虫亻寸󰁶
㝁	勹日子󰀘
蝁	一󰀚一虫
澷	氵曰罒方
澸	氵戊一心
澺	氵立曰心
㲀	厂二󰀖又
澽	氵虍一󰀓
澾	氵土羊辶
㐝	扌勹口乙
澿	氵木木小
䔦	艹木𠂉母
峧	山六乂󰁶
攦	扌一ㄇ匕
甦	一曰乂
蔦	艹󰁟灬󰁧
鏝	釒曰罒又
濄	氵ㄇ󰁈辶
偪	亻一口田
桊	䒑大木󰁧
硊	石⺈厂⺋
䡊	車⺁又󰁶
塊	土白󰁜厶
惀	忄人一艹
䢁	车月󰀝
衊	丿皿艹人
顊	丿󰃧十貝
濈	氵口耳丶
䛴	言大丁口
濋	氵木木󰁾
濍	氵艹勹心
濏	氵王王丿
濓	氵立丿八
濔	氵一八乂
濛	氵艹冖󰀓
䔮	艹󰀎八斤
㴚	氵䒑󰀓󰁶
濟	氵󰀴󰀳󰀝
戻	丶尸大󰀦
猭	犭󰁥彑󰀓
鵜	丷弓丨灬
濨	氵䒑幺心
濩	氵艹亻又
擮	扌十戈󰁷
銝	釒亻木󰁶
芝	艹之󰁧
粧	米广土󰀝
抝	扌幺𠃌󰁀
岧	山刀口󰀘
䲧	土󰁟灬󰁶
㫞	日凵丨又
砊	石亠几󰁀
栊	木ヒ丶
堊	一󰀚一土
䠊	口止丨三
聀	耳戈󰁶
䠁	口止厶二
頊	王丆貝󰁶
蠊	虫广䒑󰁗
䶎	丿目田口
濰	氵糹亻󰁷
旍	方𠂉人󰁻
濱	氵宀一貝
濳	氵丿土日
䘙	彳󰁆口丁
苭	艹幺力󰁣
鴹	⺶󰁟灬󰁶
䪮	立日勹丿
濹	氵曰土土
莮	艹田力󰁣
濽	氵夫夫貝
䴏	廿口丬灬
鎮	釒十󰀣八
濾	氵虍田心
濿	氵厂艹丶
鬞	󰂞彡ㄇ󰀖
㴏	氵宀八王
璦	王爫冖夂
艝	丿󰁪󰀙彐
咦	口一弓人
汧	氵一廾󰀢
㒦	亻田田土
䒦	艹丿之󰁧
焉	一止一灬
裊	󰁟亠󰀔󰁧
鄉	󰁲丿丶阝
䵎	󰁺由八〢
㣊	夂彡󰁣
䣊	⺌冂口阝
壊	土十罒󰀔
愉	忄人一刂
瀁	氵䒑夫艮
瀃	氵貝曰󰁤
嘍	口󰀻女󰀝
䙙	衤󰁧尸󰀟
䲃	󰁢灬巛木
䕅	艹女臼又
惪	十󰀣心󰁧
僪	亻󰁻乛口
㮯	木囗一󰀓
䍮	⺶儿󰀪󰁶
䳮	月丶𠃌灬
獮	犭󰁥一乂
燀	火口口十
宯	宀土丿子
䔎	艹木口辶
鍮	釒人一刂
菦	艹斤辶󰁧
珦	王丿冂口
釀	西一亠󰀔
鰧	月丷夫灬
䏦	月丿古󰀝
㩞	扌火火木
挝	扌寸辶󰁶
婞	女土䒑十
腉	月臼儿󰁀
碊	石戈戈󰁶
㕍	厂亻󰁷󰀌
酉	西一󰀌
䅉	禾一业󰀝
㢊	广大丁口
梊	扌斤木󰁧
墊	土䒑十土
敍	人一朩又
瀕	氵止󰀤貝
廋	广臼丨又
䅪	禾口丨贝
㖙	力口口匕
悪	一口〢心
圤	土卜󰁶
䪙	󰁆口㐄寸
䲏	󰁢灬火力
櫋	木丿目方
濻	氵阝口貝
湤	氵方𠂉也
䝂	匚丨󰁃䒑
䄳	禾止󰀝
兪	人一月巜
瀲	氵人一攵
琦	王大丁口
萦	艹冖ㄠ小
鋝	釒爫寸󰁶
䕐	艹礻󰁶田
㪞	󰀰目󰀥又
䐦	月土厶皿
媞	女曰一󰁾
拝	扌三十󰀢
邉	丿目宀辶
䪓	󰁆口㐄口
炉	火丶尸ノ
肉	冂人人󰀦
傉	亻厂二寸
楊	木曰一󰁤
㥊	忄月月󰀝
䥊	釒貝󰁶
鱹	󰁢灬艹󰁷
鱸	󰁢灬虍皿
奮	大亻󰁷田
㢕	广󰁲丿󰁷
逇	土也辶󰁫
䱏	󰁢灬一䒑
㒎	亻丿大三
凪	几止󰀌
䜙	言日幺灬
瀻	氵十戈八
釭	釒工󰀝
柂	木𠂉也󰁀
䱪	󰁢灬󰀔
㼇	王山亻𠃌
鱟	󰀗乂乂灬
懭	忄广󰁺八
奀	丆卜大󰁧
䇭	⺮土丿匕
㦮	二戈󰀦
鱞	󰁢灬罒󰀔
脄	月火󰁶
氄	󰁻乛亅毛
䠎	口止尸土
㠎	山亻󰁷木
姞	女士口󰀝
䧞	阝󰀋灬󰁶
㧞	扌丿又
䧫	阝󰁸冖󰀓
駞	󰀋灬𠂉也
辧	辛刀辛󰀢
睦	目土八土
澧	氵ㄇ󰁺䒑
㺚	犭󰁥土辶
屽	山干󰀢
灙	氵⺌冖灬
䏢	月皮󰁶
亯	󰁸曰󰀘
㝱	宀爿艹夕
䫮	彐工口貝
抭	扌宀几󰁀
䉜	⺮𠂉大󰁷
揺	扌爫干凵
拁	扌力口󰀝
䨂	禾火亻󰁷
摬	扌立曰儿
灡	氵艹門󰀹
抲	扌丁口󰀝
㠝	山夫夫貝
催	亻山亻󰁷
灦	氵日幺貝
欕	木口口攵
応	广心󰀦
䨫	󰀙木人夕
㝎	宀之󰁧
䝎	一󰀓山〢
婐	女曰木󰁶
佧	亻上卜󰁶
娞	女爫女󰀝
艭	丿󰁪亻又
㽧	田䒑幺幺
腝	月丆冂大
齧	三丨刀󰀆
樞	木匚口口
煝	火󰁅目󰀝
䬮	人良󰁐人
牭	牜四󰀝
吿	丿󰀟口󰀘
灳	勹火󰀦
㬮	日廿口󰁷
芁	艹几󰀅
岈	山󰀂亅丿
戁	廿口夫心
䋸	糹⺁十目
䰻	󰁢灬攵󰁶
厺	大厶󰁧
灻	土火󰁧
䡮	車彳人󰁾
鰦	󰁢灬䒑幺
濝	氵󰀎八小
鰤	󰁢灬丿丨
炃	八刀火󰁧
炄	火󰁈丨一
鄭	丷西一阝
愭	忄土丿日
焭	火火冖几
鰟	󰁢灬亠方
牁	爿丁口󰀝
䏅	耳󰁯二小
㼧	󰁻用一丶
䝧	貝勹冫󰀝
弧	弓⺁厶󰂃
伧	亻人⺋󰁀
爝	火爫罒寸
漧	氵十早乙
鼧	臼󰁐󰁦匕
蛦	虫一弓人
㱻	一夕󰄹丶
鰚	󰁢灬宀一
䱻	󰁢灬󰀾月
墽	土白方攵
椷	木戊一口
毭	一口䒑毛
䢮	󰀙田辶󰀌
鰎	󰁢灬󰁬廴
屧	尸彳廿木
炗	廿火󰁧
炚	日火󰁶
䋩	糹臼儿󰁀
䭟	人良艹木
䟭	口止𠂉二
坧	土石󰀝
偘	亻口口口
䠙	口止亠方
㿚	疒罒糹󰁷
厁	人一朩卩
鰁	󰁢灬白水
鰀	󰁢灬爫又
䶥	止󰀆虍一
囎	口貝丷日
膭	月口丨貝
梂	木一氺丶
㜦	女彐工寸
䜦	讠艹勹日
廧	广土人口
榞	木厂白小
燝	火曰󰁸小
軧	車󰁚󰀁丶
馞	禾日十子
䄸	禾白󰀝
䌦	糹羽亻󰁷
㧮	扌臼󰀝
䆭	宀八車干
冭	大󰁦󰁧
怘	古心󰁧
嬂	女亠丷日
揁	扌󰀥貝󰁶
鯨	󰁢灬󰁸小
䬂	几丿虫󰁐
䊪	米艹日丶
朎	月人丶󰁻
捠	扌丘八󰁶
煭	灬一夕灬
酭	西一月
標	木覀二小
㫍	方𠂉亻攵
玁	犭󰁥口攵
鯝	󰁢灬囗古
鯜	󰁢灬立女
娮	女言󰀝
湢	氵一口田
䟸	口止󰁝廾
邝	广阝󰀢
肝	月干󰀢
磞	石山月月
棞	木囗禾󰁶
傝	亻曰羽󰀝
产	立丿󰀏
㺧	犭󰁥口口
⺧	丿土󰀌
匁	勹乂󰀦
䞙	土󰁾一丨
㞙	尸毛水󰀦
卪	卩丶󰀦
晎	日󰁺八󰁶
䣻	西一人口
㙎	土戊一女
㾯	疒田一󰀖
峸	山戊𠃌󰁀
瀭	氵車人刂
耭	二木幺人
怭	忄心丿󰁥
㵋	氵罒貝󰁶
坓	二󰀯土󰀘
媇	女立朩󰁶
崿	山口口ㄅ
㙔	土󰁆口㐄
鮽	󰁢灬人朩
䮂	󰀋灬丶
宂	宀几󰀅
捁	扌丿土口
㴳	氵土丶
㾑	疒人一口
遝	罒󰀫辶󰀦
溓	氵䒑󰁬八
礞	石艹冖󰀓
蚦	虫冂二󰀝
偝	亻丬匕月
椞	木斤木󰁧
㚦	女一󰀯󰀢
乧	󰁦十乙󰀅
兺	八刀口匕
䚎	三人臼儿
㚎	大凵󰀬
彯	覀二小彡
㖘	口厂二󰀖
勅	木口力󰁥
墳	土十艹貝
巸	匚丨口巳
骰	󰀾月几又
烼	火一󰀓󰁶
嗺	口山亻󰁷
鮛	󰁢灬上小
㲾	宀水󰁧
奻	女女󰀝
獁	犭󰁥󰀋灬
愘	忄宀夂口
儘	亻󰁬丨皿
䜹	一口䒑口
斤	斤丿丿丨
鮊	󰁢灬白󰀝
偭	亻丆囗二
䤮	釒止󰀤󰁥
撁	扌亠幺󰀟
鄝	羽人彡阝
侌	人丶乛厶
䀆	󰁬丨一皿
桞	木夕阝󰀢
儝	亻火火木
脝	月󰁸了󰀢
焝	火󰁚󰀁日
塠	土丿󰃧辶
蜭	虫⺈臼󰀝
丧	十䒑󰀖󰁧
㡞	冂丨󰀻女
鮀	󰁢灬宀匕
䐁	月一󰀓丶
䧏	阝夂三丨
䎫	二木乂夂
㤙	囗󰁃心󰁧
擁	扌亠󰁲󰁷
瓁	王艹亻又
㙺	土匚口貝
噺	口立朩斤
楓	木几丿虫
岼	山一丷十
雭	󰀙乃󰂃󰁧
魳	󰁢灬一丨
庮	广西一󰀌
⺮	⺮丿一丶
魲	󰁢灬丶尸
䱽	󰁢灬人口
旪	日十󰀢
渢	氵几丿虫
椸	木方𠂉也
颞	耳又又贝
悘	匚𠂉大心
鐁	釒󰀎八斤
䑫	丿󰁪䒑廾
僝	亻尸子子
昦	曰大󰀯󰀬
烝	了󰀩一灬
袞	六口󰀔󰁧
斝	口口冖十
彥	文厂彡󰁣
㷧	火厂白小
䘦	衤󰁧尸匕
㚞	大木木󰁧
䚞	⺈用木人
嚞	士口士口
濧	氵业丷寸
㹻	犭󰁥禾女
䘺	衤󰁧宀󰁾
嘺	口丿大口
䊆	臼米󰁧
滃	氵八厶羽
䥏	釒彳𠂉卩
㐫	亠乂凵󰀬
䦘	門艮󰀦
皞	白白大十
蠦	虫虍田皿
隞	阝󰁡攵
㟮	山宀八犬
䟮	口止亻犬
斆	󰀗乂乂攵
堝	土ㄇ󰁈口
䪻	厶廾丆貝
娽	女󰁭氺󰁶
䛖	言日󰁒丿
䙬	衤󰁧貝女
㩙	扌宀󰀀土
㗁	口口口ㄅ
䴂	⺈口󰀓灬
嵂	山彳󰁬󰀟
栮	木耳󰀝
鬱	木𠂉十彡
䤎	西一󰁻口
䫻	几丿虫日
劺	厶丿󰀟力
亟	了口又一
㟦	山冖車󰀬
晞	日乂丨
埦	土宀夕⺋
徍	彳土土󰀝
䜎	言火火力
崟	山金󰀘
拺	扌木冂󰁀
䒫	艹亻󰀁丶
䱤	󰁢灬⺈臼
剘	󰀎八刂󰀢
䡒	車田󰀝
虞	󰅋七口大
炥	火弓󰀯󰀢
梙	木口口丨
陞	阝丿廾土
炑	火木󰁶
悑	忄甫󰁶
髵	󰂞彡丆〢
䱨	󰁢灬木刂
髲	󰂞彡皮󰁧
儍	亻󰁘凵夂
䬻	人良二戈
䓦	艹ㄇ󰁺八
熃	󰁻乛亅火
㷽	火羊䒑口
䤋	丷西一󰀞
抺	扌未󰁶
䛲	言白冂丨
㧙	扌心丿󰁥
髊	󰀾月⺶工
瘯	疒方𠂉大
廟	广十早月
滟	氵三丨巴
㜞	車斤女󰀘
䢦	亠幺󰀪辶
阯	阝止󰀝
惍	忄金󰀝
働	亻丿一力
䃍	石䒑󰀓󰁶
熖	火爫臼󰀝
嶎	山尸二寸
熍	火宀口口
佦	亻石󰀝
黟	󰀹土灬夕
䶓	冂丨󰀴󰀳
眞	匕目󰄃八
軟	車⺈人󰁶
䛼	言臼工󰀝
団	囗寸󰀦
䔫	艹乛止冂
㦙	忄日冂心
懘	氵廿儿心
凘	冫󰀎八斤
柇	木禾󰁶
従	彳䒑󰁾󰁶
熧	彳人人火
歨	止󰁾󰁧
擯	扌宀一貝
蓯	艹彳人󰁾
䯨	󰁸冂口大
棆	木人一艹
㯚	木⺮人口
劗	丿土󰁜刂
桦	木亻ヒ十
塦	阝車土󰀘
䡦	車又又木
㛞	女王廾󰀢
熲	匕火丆貝
䣟	󰀄󰁜󰀄阝
䣵	西一耳󰀝
䗫	虫广木木
曅	曰艹一󰀟
驊	󰀋灬艹󰀟
熼	火田󰁺八
䤚	月日土󰀝
撯	扌⺶目󰀝
逥	囗〢二辶
蛞	虫丿古󰀝
硦	石王廾󰀢
璯	王人一日
䰨	丿田儿目
尨	乚彡丶
㰨	口八⺈人
埨	土人一艹
琔	王宀一󰁾
䬠	󰀙⺄〈丨
燌	火十艹貝
䤵	釒丨三三
㐏	五乙󰀅
䲈	󰁢灬广木
単	󰀧曰十󰀬
䖫	虫八干󰀢
㖫	口土八夂
燑	火立曰土
伓	亻丆卜󰁶
㼓	⺁厶丶八
蕯	艹阝夂一
畯	田厶八夂
㤦	忄一口乂
䤦	釒亻戈󰁶
垞	土宀丿七
枞	木人人󰁶
罟	罒古󰀘
螞	虫󰀋灬󰁶
酥	西一禾󰁶
岠	山匚󰁃󰀝
佸	亻丿古󰀝
仒	人󰁦󰁧
蝒	虫丆囗二
槷	土八土木
䧍	阝八人口
羚	䒑󰀠人󰁻
湅	氵木󰀹󰀝
䙫	衤󰁧丬八
劘	广木木刂
䵈	彳幺夂木
㙫	土亻󰁷木
皒	白丿扌丶
隒	阝䒑󰁬八
铨	钅人王󰀝
駭	󰀋灬亠人
暒	日曰丿
澛	氵󰁢一日
鏫	釒禾刂木
㴈	氵丘山󰀢
娏	女乚丶
㘫	土二󰀯󰀢
㻨	匚丨󰁃丶
藯	艹尸二心
㣦	彳禾女󰀝
痯	疒宀󰃧󰀌
倝	十早人󰁶
䀝	目󰁴匕󰁀
睞	目木人人
棦	木⺈󰁬亅
逝	扌斤辶󰀵
蝞	虫󰁅目󰀝
䁧	目艹口夫
㳇	氵八乂󰁶
爌	火广󰁺八
㺓	犭󰁥貝
馡	禾日丨三
擻	扌󰀻女攵
鴸	丿未󰁟灬
䱴	󰁢灬忄一
㱴	一夕貝
楁	木宀夂口
岶	山白󰀝
搘	扌土丿日
㱙	一夕一ㄅ
䛫	言󰀍󰀖󰁶
溭	氵田八夂
㼨	人丶乛丶
劒	人一口丶
墶	土土羊辶
㹓	牜土土儿
丫	丷丨󰀵
洰	氵匚󰁃󰀝
撻	扌土羊辶
䰙	一口冂又
㦦	忄門臼儿
㲤	亠口一毛
虒	⺁虍几󰁫
榦	十早人木
砞	石一木󰁶
俟	亻厶𠂉大
僥	亻土土儿
癒	疒人一心
䌏	糹宀心山
蠞	⺮󰁮卩虫
馦	禾日䒑八
㷊	木木灬󰁧
䤙	西一彑虫
饇	人良匚口
犮	又丶󰀦
劮	丿夫力󰁥
扏	扌九󰁀
䯴	󰂞彡几又
廳	广耳王心
函	了󰀪凵󰀵
㕻	丶丆卜口
㝫	宀阝夂
䝫	貝𠂉丨二
閒	門月󰀌
䣮	西一丶
巓	山匕目貝
䱇	󰁢灬日一
琯	王宀󰃧󰀝
㷓	火勹󰁤心
餸	人良䒑辶
槃	丿󰁪几木
㟞	山戈戈󰁶
餶	人良󰀾月
汼	氵丿󰀟󰀢
扜	扌一󰀛󰀢
焥	火宀夕⺋
楦	木宀一一
埞	土宀一󰁾
䥦	釒工辶
䰴	󰁢灬𠂉乙
嶑	山⺈口󰀓
鄥	󰁟灬阝󰀢
脥	月大人人
㔻	丆卜十󰀬
嚝	口广󰁺八
䜫	八人口工
㶓	氵艹戈丨
餡	人良⺈臼
䰛	一口冂丶
䣞	口口䒑阝
䭤	人良口辶
㔘	凵山力󰁥
䧆	阝󰁺八󰁶
䞝	土󰁾王丶
牣	牜刀丶󰁶
䨒	󰀙羽󰀘
㗎	口力口木
甒	𠂉一󰀷丶
䵓	禾人氺󰀟
嵓	山口口口
㔒	山亻󰁷刂
牊	丿丨一口
曵	曰󰁒丿丶
钞	钅小丿ノ
㫙	日夫󰁶
㴙	氵丿十臼
牴	牜󰁚󰀁丶
咞	口一廾󰀢
樦	木⺮丶王
璞	王󰅊一人
蒞	艹氵亻立
㹨	犭󰁥由󰀝
鼞	士口䒑土
㨦	扌亻󰁷又
䒞	艹冖󰁜󰀅
嬶	女丿目󰀯
蕒	艹罒貝󰁧
䵨	󰀹土灬丶
䴓	一冂丨一
㕒	厂丷王丶
嵨	山󰁞灬󰁶
濊	氵止戊󰀤
䊢	爿󰁝寸米
䭩	人良广三
圵	土上󰀝
囏	廿口夫口
䒘	艹夂󰁧
偫	亻彳土寸
眚	丿主目󰀘
䋠	糹甫󰁶
㶏	氵阝爫心
犌	牜󰁃丨又
蔯	艹阝木曰
䢍	方辶󰀏
㮨	木田八夂
宨	宀儿󰀪󰁧
鑞	釒巛囗󰁒
嚹	口𠂉十󰀛
坵	土丘󰀝
槦	木广󰁬丨
岟	山ㄇ大󰁶
葞	艹弓耳󰀘
粟	覀米󰁧
㼶	人一月丶
崸	山丆貝󰁶
䧦	阝爫丿灬
㧦	扌勹日󰀝
㲙	毛亠厶󰀸
䯳	󰂞彡八厶
倫	亻人一艹
瞧	目亻󰁷灬
䣾	西一宀一
䵏	󰁺由八彡
㖼	口甘木󰁶
労	󰀧冖力󰁣
斎	文󰀳小󰁧
壙	土广󰁺八
颱	几丿虫口
華	艹一艹󰀟
珯	王土丿匕
㶥	火干󰀢
䧮	阝宀三心
䳤	㡀󰁟灬󰁶
鍯	釒勹󰁤心
㞵	山文󰁧
淾	金水󰁧
犪	牜䒑丿夂
妰	女𠂉丨二
䩄	丆囗〢󰁜
鳟	󰁢󰀞丷寸
㘘	言糹糹口
燥	火口口木
賟	貝ㄇ󰁺八
媦	女田月󰀝
泟	氵一止󰀝
㪦	宀一由攵
䇥	⺮一止󰀘
䘘	彳幺丁
僫	亻一󰀚心
䥒	弓厶虫金
䴅	十艹貝灬
顫	亠囗口貝
䓏	艹丆卜口
凮	几丆日󰀌
㰓	木匚丨貝
醀	西一亻󰁷
鑒	匚丨󰁃金
㷺	⺈臼攵火
舮	丿󰁪丶尸
䙘	衤󰁧戊小
狉	犭󰁥丆一
顛	十󰀣八貝
顚	匕目󰄃貝
腀	月人一艹
䡯	車丿囗心
鎒	釒厂二寸
顗	山一口貝
䔏	艹丿土辶
狑	犭󰁥人󰁻
臮	丿目亻丶
吥	口丆卜󰁶
狕	犭󰁥幺力
鴟	󰁚󰀁丶灬
负	⺈贝󰁧
爥	火尸氺虫
洟	氵一弓人
別	口󰁡刂󰀢
䩦	亻丨攵󰀜
㓞	三丨刀󰁥
㼗	丁一󰁐丶
䯩	󰁸冂口巴
顄	了󰀪凵貝
焀	火八人口
䖘	虍几⺈丶
慫	彳人人心
摏	扌三人臼
䱈	󰁢灬二小
䟙	口止七刀
狪	犭󰁥冂口
旘	方亠丷日
䂙	石阝󰀢
䔬	艹田󰁺八
壯	爿士󰀝
䣯	西一󰀐一
頧	丿󰃧丆貝
㶙	氵氵业
儫	亻󰁸冖󰀓
䧝	阝凵丨虫
灮	火儿󰀅
䣹	西一亻戈
䒏	丷󰀺日巴
浟	氵亻丨攵
疞	疒二ㄅ󰁫
赟	文一󰀁贝
鍥	釒三丨大
㰈	木木車辶
捌	扌口力刂
頜	人一口貝
勮	虍一󰀓力
捚	扌曰土󰀝
君	󰁬丿口󰀌
鍒	釒󰁻乛木
頕	󰀥口丆貝
嬓	女白方攵
㖞	口口冂人
䍥	罒厂禾止
卥	󰀥囗󰁤󰂃
頔	由丆貝󰁶
頓	一凵󰁐貝
䵴	󰀹土灬黽
猉	犭󰁥󰀎八
懫	忄斤斤貝
猐	犭󰁥⺶乚
㘅	口彳釒丁
頁	丆貝󰁧
憮	忄𠂉一灬
奯	大止戊󰀤
頀	立日艹又
䟏	土󰁾白木
倎	亻ㄇ󰁺八
嫯	󰁡攵女
漅	氵巛曰木
仩	亻上󰀝
畞	十田ク󰂃
敞	⺌冂口夂
鎥	亻丨夂金
蕞	艹日耳又
䛙	言亻木󰁶
䣁	羽阝󰀢
㦤	士冖一心
䇟	⺮夕力󰁣
鋮	釒戊𠃌󰁀
韢	󰁆口㐄心
渪	氵丿口丶
㙤	土虍丿󰀛
㶟	氵田田小
妌	女二󰀯󰀢
嶟	山丷西寸
䕞	艹門丶艮
瀟	氵艹󰁬󰀲
桩	木广土󰀝
㣤	彳戈戈󰁶
韊	廿󰀜艹󰀹
䞊	貝虍八目
姯	女⺌一儿
彍	弓广󰁺八
徱	彳覀二小
寸	寸一亅丶
憠	厂䒑凵心
囯	囗王󰀌
䊄	工几丶米
獊	犭󰁥人口
䛘	言亻丿士
㺙	犭󰁥宀贝
㸾	牜刀丶心
讦	讠干󰀢
鋥	釒口王󰀝
拥	扌用󰀢
箦	⺮主贝󰁧
毶	毛厶大彡
艒	丿󰁪󰀰目
漛	氵丷夫氺
䌲	糹艹丿灬
靲	廿󰀜人乛
䈑	⺮ㄇ󰁈口
怮	忄幺力󰁥
耮	二木火力
䘞	衤󰁧󰀊一
宦	宀匚丨丨
瀮	氵󰀙木木
㮦	木十冖小
㝑	宀方󰁣
勫	丿米田力
拫	扌艮󰁶
㠘	山󰀗一八
䠘	口止丿匕
䛏	言尸匕󰁀
憒	忄口丨貝
㚮	女冖几󰁀
靅	󰀙二厶貝
澵	氵立朩斤
䭢	人良宀丁
獵	犭󰁥巛󰁒
鞭	廿口十乂
檝	木口耳丶
㸲	牜𠂉丨二
㢤	十󰀁󰁡丶
錥	釒亠厶月
藞	艹石石石
筦	⺮宀二儿
渟	氵󰁸冖丁
釒	釒丿丶一
臒	月艹亻又
㜏	女口貝󰁶
䜏	言阝辶
鱋	󰁢灬虍业
霒	󰀙二厶乛
灿	火山󰀢
圓	囗口貝󰀦
帟	亠󰁖冂丨
䗞	一大虫虫
㭦	木宀丿七
玈	亠幺𠂉󰀕
䧘	阝彑󰀓󰁶
㞎	尸巴󰁫
玌	王乚󰁀
泴	水皿󰀘
㞘	尸一󰀓丶
䞘	土󰁾𠂉乙
捫	扌門󰀝
揬	扌宀八犬
焒	火口口󰀝
懲	彳山一心
䟴	口止厂󰀖
陮	阝亻󰁷󰀝
癮	疒阝爫心
䧟	阝爫臼󰀝
庯	广甫󰀦
㻯	王虍丿󰀛
牂	爿羊󰀢
玚	王ㄋ󰁤󰁥
脽	月亻󰁷󰀝
㽘	田亠几󰁀
䉍	⺮門心󰁧
㛿	女一〣丨
㜠	女山亻󰁷
䟘	口止亠几
㿥	白冖亻󰁷
煒	火󰁆口㐄
雞	爫幺大󰁷
夓	󰀗丆目夂
䤓	西一艹󰀓
暏	日土丿日
䠴	丿󰀽三立
㸈	亻󰁷亻火
玪	王人丶乛
䰢	白󰁜厶丁
涳	氵宀八工
懏	忄亻󰁷𠃌
䠿	丿󰀽三貝
屓	尸貝󰀦
玵	王甘󰀝
㭗	木皿󰀘
瑥	王日皿󰀝
葥	艹䒑月刂
銞	勹曰金󰀘
懟	业丷王心
㑥	亻日勹󰁤
䩟	廿󰀜一人
婟	女囗古󰀝
択	扌尸󰂃󰁶
炫	火亠ㄠ󰁶
嶿	山󰀙丆〢
償	亻⺌冖貝
凟	冫士罒貝
䣘	⺌冖口阝
廔	广󰀻女󰀌
烮	一夕刂火
㢒	广虍󰀐一
偑	亻几丿虫
聑	耳耳󰀝
䫈	山人丶貝
刏	气刂󰀢
崺	山方𠂉也
䧹	广亻亻󰁷
乄	󰁇丶󰀦
斻	方𠂉几󰁀
㖻	口󰁻乛木
闡	門口口十
抙	扌手󰀢
傴	亻匚口口
珌	王心丿󰁥
䛤	言口󰁾󰁶
䣒	口丨一阝
㣒	丷󰀺日彡
蒥	艹󰁚丶田
篦	⺮丿囗匕
怑	忄丷󰀟󰀢
钥	钅月󰀝
䉞	⺮戊一心
㒥	亻山三䒑
撥	扌癶弓又
剞	大丁口刂
䖓	凵山虍几
媏	女山丆〢
㷳	厂亻亻火
㙻	土广日土
䫴	木木二貝
䟯	口止丿古
佖	亻心丿󰁥
陑	阝丆冂〢
陏	阝月󰀝
䞤	土󰁾勹口
烑	火儿󰀪󰁶
胑	月口八󰁶
僑	亻丿大口
䭈	人良󰁬廴
珤	王𠂉十凵
韓	十早󰁆㐄
朂	曰耳力󰁣
檹	木方𠂉口
珬	王戊一󰀝
䬴	人良一木
鐨	釒弓󰀯貝
蛡	虫羽󰀝
屩	尸彳丿口
鉵	釒虫󰁶
錞	釒󰁸子󰀝
䚬	⺈用米㐄
珥	王耳󰀝
菥	艹木斤󰀬
嫟	女匚艹口
沦	氵人匕󰁀
㫟	日几口󰀝
䲦	󰁟灬大󰁶
㩌	扌弓󰀯貝
攄	扌虍田心
灒	氵丿土貝
䀳	目木口󰀝
䬈	几丿虫儿
䨅	大丷日󰁷
珷	王一󰀁丶
勻	勹二󰀌
珼	王貝󰁶
珨	王人一口
闟	門人一羽
䜖	言覀貝󰁶
宩	宀米󰁧
貔	豸丿囗匕
琂	王言󰀝
䘤	衤󰁧木丶
䠓	口止丷一
㠓	山艹冖󰀓
僟	亻幺幺人
睓	目ㄇ󰁺八
䣏	亻󰁺八阝
劻	匚王力󰁥
丅	一丨󰀵
䋆	糹丶尸󰁥
橉	木米夕㐄
鬟	󰂞彡罒󰀔
营	艹冖口口
笟	⺮⺁厶󰂃
汦	氵󰁚󰀁󰁀
屦	尸彳米女
䋞	糹冂乂乂
㬟	勹󰁤丷日
姈	女人丶󰁻
栱	木󰁺八󰁶
㻩	王䒑󰁬八
㫌	方𠂉一止
伾	亻丆卜一
惎	󰀎八心󰁧
卻	八人口卩
㸳	牜人丶󰁻
稷	禾田八夂
㧥	扌丿土儿
葨	艹田一󰀖
摨	扌尸氺󰀟
尩	八儿王󰀌
閂	門一󰀌
䚤	⺈用日丶
㹥	犭󰁥丶王
恟	忄勹乂凵
琧	一󰀚一丶
悎	忄丿土口
傎	亻十󰀣八
盓	氵一󰀛皿
雓	人一朩󰁷
堟	土彑󰀓󰁶
㕥	口人󰁶
䕥	艹八八乂
崦	山大日乚
敥	火火󰀥又
筟	⺮爫子󰀘
莞	艹宀二儿
鴦	ㄇ大󰁟灬
㒀	亻亠丷古
㭌	木丿󰀟󰀢
孌	言糹糹女
㜨	女尸氺󰀟
霨	󰀙尸二寸
䙤	衤󰁧ㄇ辶
傟	亻八厶羽
眓	目戈󰁐󰁀
朓	月儿󰀪󰁶
剙	䒑廾刀八
瑈	王󰁻乛木
䧵	冖󰁜亻󰁷
㱍	言糹糹人
酠	西一丁口
㜓	女艹人口
欍	木艹亻臼
盨	彡丆貝皿
瑤	王󰁝𠂉凵
瑦	王󰁞灬󰁶
瑫	王爫臼󰀝
癓	疒彳山攵
虓	九虍几󰁀
帀	一冂丨󰀵
䢝	一󰀚一辶
㳦	氵戈廾󰀢
㳉	氵月󰀝
卞	亠卜󰁧
䮟	󰀋灬宀又
疥	疒人󰀯󰀵
泦	氵尸九󰁀
鳦	󰁟灬乙󰁀
薥	艹罒勹虫
圏	囗丷夫己
椚	木門󰀝
媀	女曰冂丶
㯌	木一󰀓辶
䙓	衤󰁧罒厶
㟛	山扌甘󰀘
璔	王丷󰀺日
䖁	艹日冂心
扬	扌ㄋ󰁤ノ
璘	王米夕㐄
璚	王󰁻乛口
璝	王口丨貝
璤	王一曰心
璫	王⺌冖田
浥	氵口巴󰁀
㗄	口罒方󰁥
暓	󰁻乛亅日
縠	士冖一又
㼩	戊𠃌一丶
靨	厂曰月二
㕉	厂人一口
㹡	犭󰁥亠幺
囄	口亠乂󰁷
㓥	⺌彐刂󰀢
璷	王甫方攵
鉯	釒󰁐丶人
润	氵门王󰀝
篟	⺮亻月
䐞	月弓冫冫
哥	丁口丁口
婨	女人一艹
䉯	⺮匚丨貝
蓥	艹冖金󰀘
铥	钅丿土厶
㩨	扌三丨心
瓔	王貝貝女
劑	󰀴󰀳刂󰀢
旓	方𠂉⺌月
瓘	王艹口󰁷
㗓	口丿󰃧辶
瓚	王丿土貝
摤	扌大乂乂
欑	木丿土貝
瓫	八刀一丶
阓	门口丨贝
蘓	艹禾󰁢灬
㕦	口大󰁧
䞔	土󰁖尸毛
䞖	土󰁾󰀁丶
厠	厂貝刂󰀵
䰜	弓一口弓
㯏	士󰁅几木
甂	丶尸冂丶
㐤	九十󰀣八
㵦	氵工辶
㩴	扌目目󰁷
甔	⺈厂八丶
甖	貝貝一丶
簟	⺮覀早󰀬
攥	扌⺮目小
嵦	山山一䒑
䔥	艹󰁬米󰀯
鰴	彳山一攵
鋯	釒丿土口
鏞	釒广󰁬丨
菞	艹禾勹丿
甝	虍几甘󰀌
甞	⺌冖口甘
㲡	木二小毛
產	文厂丿
敓	八口儿攵
畓	水田󰀘
䕓	艹宀󰁯小
峩	山丿扌丶
㕓	厂󰀹土土
甧	丿丿月
甪	丿用󰀵
㱎	罒󰀫󰁢人
陥	阝⺈丨日
濜	氵󰁬丨皿
鰐	󰁢灬口ㄅ
猠	犭󰁥ㄇ八
噥	口ㄇ󰁺󰀖
悞	忄口󰁕大
硟	石丿󰀥廴
踦	口止大口
劯	石力󰁥
間	門日󰀌
㸦	󰀄亅󰂃󰀦
䡟	車白丿十
䶬	干干立三
鑠	釒白幺木
疓	疒乃󰀏
甤	一󰀓丿
㖓	口夂三丨
喦	口口口山
匓	勹󰁮几又
辆	车一冂人
畟	田八夂󰁧
畣	人一口田
畧	田夂口󰀘
畫	󰁬土田一
畬	人一朩田
洩	氵曰󰁒丿
椧	木人一卩
㸿	牜士冖几
䋦	糹𠂉母󰁶
䵩	禾刂󰀹灬
當	⺌冖口田
攨	扌宀八󰂃
疂	田󰀪冖一
隥	阝癶一䒑
疄	田米夕㐄
䛅	言甲󰀢
暥	日曰宀女
偞	亻廿󰄃木
跦	口止丿未
皥	白丿目十
疊	田田田一
䨥	󰀙亻󰁷又
䁞	人人人目
㷦	耳火灬󰁧
夏	丆目夂󰁧
旟	方𠂉󰀗八
䉓	⺮木日木
疘	疒工󰀌
㒒	亻业䒑未
䳓	土丿󰁴灬
蒒	艹丿󰃧丨
攓	扌宀󰀀󰁾
㲩	毛日羽󰀌
疢	疒火󰀦
疧	疒󰁚󰀁󰁫
疪	疒󰁴匕󰁫
潧	氵丷󰀺日
䧈	阝西󰀝
䇂	立丨󰀵
䲓	󰁢灬人人
㲓	毛戈人󰀦
岓	山斤󰀢
玨	王王󰀝
鎨	釒亻󰁷十
㘄	口木罒方
滺	氵亻丨心
食	人丶彐󰀖
塧	土䒑八皿
痥	疒丷口儿
脞	月人人土
壟	立月一土
愞	忄丆冂大
㗥	口󰁸孑阝
亦	亠󰁖󰁧
䀘	目一廾󰀢
㒑	亻匚氵󰁷
盠	彑󰀓皿󰀘
䱓	󰁢灬丿廴
燕	廿口丬灬
琒	王夂三丨
搒	扌亠丷方
㕨	口几丶󰁶
鐒	釒火火力
畨	米田󰀘
塨	土󰁺八⺗
炋	火丆卜󰁶
㾟	疒止󰀤󰀏
䫋	禾女丆貝
㞽	山戈󰁐󰁀
遯	月一󰀓辶
揓	扌方𠂉也
鏓	釒丿囗心
䠾	丿󰀽三人
䶙	止󰀆匚󰁃
帥	丿󰃧冂丨
栆	一口丨󰁦
瘜	疒丿目心
隠	阝爫彐心
蚠	八刀虫󰁧
郞	丶艮阝󰀢
胞	月勹巳󰁀
礟	石󰀋灬乂
惞	忄斤⺈人
僞	亻爫丿灬
䃞	󰁸孑九石
㹦	犭󰁥刀口
渄	氵丨三三
萓	艹宀󰀐一
瘧	疒虍匚一
䕫	艹白止夂
搥	扌丿󰃧辶
復	彳𠂉日夂
䃯	石白󰀪木
忿	八刀心󰁧
癁	疒彳𠂉夂
癄	疒亻󰁷灬
獓	犭󰁥攵
仌	人人󰁧
䏄	耳宀八土
髳	󰂞彡󰁻丿
櫞	木糹彑󰀓
癘	疒艹曰丶
癙	疒臼󰁐󰁒
巣	󰀧曰木󰁧
癝	疒亠囗小
鎓	釒八厶羽
繨	糹土羊辶
抋	扌心󰁶
癬	疒󰁢灬羊
泧	氵戈󰁐󰁀
偸	亻人一巜
癲	疒十󰀣貝
啠	斤斤口󰀘
㝥	宀爿米󰁧
䥟	釒扌日󰄃
奟	大月月󰀘
憞	忄󰁸孑攵
缦	纟日罒又
膞	月一曰寸
靥	厂大丶三
䗩	虫戊上小
柆	木立󰀝
䭨	人良山口
燲	火力力貝
璡	王亻󰁷辶
搧	扌丶尸羽
㼍	二木⺁󰂃
勓	󰁴匕白力
狓	犭󰁥皮󰁶
尗	上小󰁧
皜	白󰁸冂口
皟	白貝󰁶
諱	言󰁆口㐄
猯	犭󰁥山〢
皦	白白方攵
㸥	丿丨一丶
䵉	广木木刂
錓	釒⺶乚󰁀
茓	艹宀八󰁧
眣	目丿夫󰁶
皬	白󰀙亻󰁷
䧽	丿米亻󰁷
憸	忄人一人
嘯	口󰁬十󰀲
㞥	山丿󰂃󰁧
燯	火󰀙人󰁻
廦	广尸口辛
䅞	禾日一寸
瞥	丷冂󰅏目
慞	忄立早󰀢
鞥	廿󰀜人廾
軦	車口儿󰁀
皸	冖車皮󰁶
皽	亠囗口皮
皾	士罒貝皮
盁	乃皿󰀘
㐘	米乙󰀅
㽝	一夕刂田
懯	甫方攵心
嫨	女廿口夫
旫	日刀󰁥
棢	木冂䒑󰄃
酼	西一亠󰀸
酻	西一爫子
牓	丿丨一方
艓	丿󰁪廿木
熯	火廿口夫
監	匚丨󰁃皿
盤	丿󰁪几皿
盦	人丶乛皿
嬨	女䒑幺心
䆯	宀八又女
盫	人一口皿
愩	忄工貝󰁶
䊂	米木冂󰁀
勧	𠂉一亻力
侦	亻󰀥贝󰁶
刞	󰀐󰀞刂󰀢
芓	艹子󰀘
㾦	疒立口󰀌
觟	⺈用土土
鈞	釒勹冫󰀝
曥	日虍田皿
租	禾󰀐一󰀝
犓	牜勹凵丿
澠	氵黽󰀝
䉘	⺮木宀小
䢏	󰁦十辶󰀵
倯	亻木八厶
䥆	亠丨三金
陯	阝人一艹
虯	虫󰁐丨󰀢
㙯	土八土厶
䋽	糹土土寸
宬	宀戊𠃌󰀅
眫	目丷󰀟󰀢
賰	貝三人日
䀯	目甫󰁶
耯	二木艹又
眲	目耳󰀝
㐠	爫孑乚乙
䎀	羽戈󰁐󰁀
眻	目羊󰀢
翝	宀厶羽
軈	丿󰀽三心
㺰	王一冂丨
﨟	艹月曰󰄃
䝹	貝宀夕⺋
凞	冫丿匚灬
䨟	󰀙氵土土
㨟	扌山一䒑
睙	目丶尸犬
釞	釒丿󰂃󰁶
蜥	虫木斤󰀢
罦	罒爫子󰀘
潦	氵大丷小
嶉	山口亻󰁷
蛯	虫土丿匕
䒽	艹冂乂乂
窡	宀八又又
邒	丁阝󰀢
銧	釒⺌一儿
滈	氵󰁸冂口
睮	目人一刂
㼥	土丿一丶
懀	忄人一日
睲	目曰丿
䣦	西一力󰁥
䍠	罒亠乂厶
㒹	十󰀣八八
炧	火𠂉也󰁀
皯	皮干󰀢
䢥	一止目辶
㚟	⺈口󰁴大
暟	日山一䒑
偤	亻丷西一
遦	毌貝辶󰀦
㸨	牜󰁐丨󰀢
榸	木土曰土
襠	衤󰁧⺌田
遙	󰁝𠂉十辶
䥨	釒門口口
殢	一夕廿丨
䭻	󰀋灬八刀
聤	耳󰁸冖丁
碥	石丶尸艹
舧	丿󰁪丿丶
颥	󰀙丆冂贝
䁷	󰀗乂乂目
瞙	目艹曰大
瞚	目宀一八
瞜	目󰀻女󰀝
瞝	目亠乂厶
䑩	丿󰁪古󰀝
瞦	目士口口
瞨	目业䒑夫
蟤	虫巳巳八
審	宀丿米田
瞺	目人一日
矅	目羽亻󰁷
矆	目艹亻又
矇	目艹冖󰀓
灊	氵󰀄󰁜丨
矌	目广󰁺八
㙟	土丶󰁮月
䂤	石亻寸󰁶
傤	亻十戈车
桥	木丿大󰀯
䣨	西一丿七
迴	囗口辶󰀌
㔧	虍田皿力
矕	言糹糹目
矖	目一冂匕
矘	目⺌冖灬
矝	󰁻乛亅󰁻
矞	󰁻乛亅口
炤	火刀口󰀝
肤	月二人󰁶
陟	阝止󰀤ノ
矟	󰁻乛亅月
㧌	扌毛󰁀
迚	口丨辶󰀵
䤨	釒⺁󰀕󰁶
矪	𠂉大丿󰁪
㽄	󰀎八斤丶
㰠	亠几⺈人
䐫	月彳人󰁾
㺄	犭󰁥人刂
幭	冂丨艹人
矴	石丁󰀢
邧	二儿阝󰀢
矷	石子󰀝
爣	火⺌冖灬
辷	一辶󰀌
辵	彡󰁾󰁧
䩍	丆囗〢小
期	艹三八月
土	土土土土
侘	亻宀丿七
㾘	疒一日乂
砅	石水󰁶
砆	石夫󰁶
鎩	釒乂朩又
㱪	一夕󰁂日
䎩	二木巛田
砓	石几又󰁶
砛	石人丶乛
䋌	糹匚󰁃󰀝
轪	车大󰁶
龘	立月一三
蜟	虫亠厶月
砥	石󰁚󰀁丶
砤	石𠂉也󰁀
㮪	木工几木
砨	石丶尸乙
忋	忄己󰁀
奲	大土丿十
砱	石人丶󰁻
砳	石石󰀝
䆦	宀八火火
砶	石白󰀝
㜖	女一ㄇ日
榖	士冖一又
輸	車人一刂
耓	二木丁󰀢
瀓	氵彳山攵
刌	寸刂󰀢
䯪	󰁸冂口貝
値	亻十目󰄃
濘	氵宀心丁
㟥	山厶大彡
䀤	夕卜目󰀘
㹠	犭󰁥一乚
硆	石人一口
硋	石亠ㄥ人
硍	石艮󰁶
硏	石一干
硓	石土丿匕
馏	⺈󰁐󰁚田
䪍	廿󰀜門󰀹
逤	氵小丿辶
媍	女⺈貝󰁶
瀤	氵亠罒󰀔
蛟	虫六乂󰁶
硞	石丿土口
艌	丿󰁪人心
鉌	釒禾󰁶
硢	石人一朩
硣	石土丿子
硥	石乚丶
硨	石車󰀢
硲	石八人口
暩	日󰁯二小
硶	石山人乛
硹	石木八厶
硻	匚丨󰁃石
軡	車人丶乛
孍	女口口攵
硾	石丿士󰁺
硿	石宀八工
碀	石⺈󰁬亅
碁	󰀎八石󰀘
㞟	尸丷西大
碂	石宀二小
弘	弓厶󰁶
优	亻乚丶
煤	火艹二木
榥	木日⺌儿
鞟	廿󰀜󰁸子
螟	虫冖曰六
碆	氵皮石󰀘
亪	亠󰁖一󰂃
蝩	虫丿一土
碒	石金󰀝
碔	石一󰀁丶
對	业丷王寸
揌	扌田心󰁶
碖	石人一艹
碞	口口口石
碢	石ㄇ󰁈口
嫍	女爫臼󰀝
碨	石田一󰀖
碩	石丆貝󰁶
碪	石󰀎八󰄃
碫	石丿丨又
躦	口止丿貝
翱	白大十羽
碵	石󰀥貝󰁶
碸	石几丿虫
確	石冖亻󰁷
碻	石󰁸冂口
氳	气囗人皿
碽	石工貝󰁶
獌	犭󰁥曰又
鍌	氵丿土金
㝟	宀一目儿
䝟	豸三丨大
坟	土文󰁶
楥	木爫一又
睟	目亠人十
蝟	虫田月󰀝
饥	⺈󰁐几󰁀
磃	石⺁虍几
躑	口止丷阝
卌	一󰀷󰀵
䍦	罒亠乂󰁷
磏	石䒑󰁬八
磒	石口貝󰁶
磓	石丿󰃧辶
磗	石甫寸󰁶
磘	石爫𠂉凵
磜	石󰁯二小
屍	尸一夕匕
䱍	󰁢灬一一
璌	王宀一八
撌	扌口丨貝
㒌	亻火火几
磡	石󰀎八力
蹫	口止󰁻口
磦	石覀二小
磧	石貝󰁶
磩	石戊上小
磪	石山亻󰁷
磫	石彳人󰁾
㠟	山禾勹氺
磭	石厂二月
磯	石幺幺人
磱	石火火力
砟	石𠂉丨二
惤	忄弓亠幺
夥	日木夕夕
䤥	釒⺈厂⺋
哊	口月󰀝
釨	釒子󰀝
麘	󰁙󰁴匕日
蠟	虫巛囗󰁒
磶	石臼勹灬
䇨	⺮夂㐄󰀬
燨	火丷王丶
蹍	口止尸󰀖
磾	石口口十
礂	石士口口
鐌	釒⺈口󰀓
琌	王山人乛
礆	石人一人
䱧	󰁢灬丷⺋
绳	纟口日乚
礊	車凵几石
寍	宀心皿󰀘
踲	口止⺁目
㼞	一丷十丶
礎	石木木󰁾
礏	石业䒑未
怸	木丶心󰁧
礑	石⺌冖田
礒	石丷王丶
礕	尸口辛石
㻘	王宀日丨
鹧	广廿灬一
礗	石宀一貝
柟	木冂土󰀝
瀞	氵月亅
付	亻寸󰁶
倞	亻󰁸小󰁶
礙	石匕𠂉󰁾
礜	󰀗一󰁕石
蟟	虫大丷小
鄤	曰罒又阝
礝	石󰀙丆〢
礠	石䒑幺心
礡	石艹甫寸
鑌	釒宀一貝
礥	石匚丨貝
䲍	丿󰁪丷灬
擩	扌󰀙丆〢
牨	牜亠几󰁀
礦	石广󰁺八
礩	石斤斤貝
礪	石厂艹丶
礫	石白幺木
礭	石󰀙亻󰁷
礳	石广木石
䉤	⺮米女攵
㒟	亻亠󰀋󰀔
礶	石艹口󰁷
礸	石丿土貝
礹	石口口攵
跴	口止西󰀝
嵪	山󰁸冂口
蒩	艹禾󰀐一
氃	立曰土毛
䵌	󰁺由八人
擓	扌匚氵󰁷
瓓	王門木󰀹
祃	礻󰁶󰀊一
祄	礻󰁶人󰀯
祅	礻󰁶丿大
祇	礻󰁶󰁚󰀁
祊	礻󰁶方󰁥
祋	礻󰁶几又
祌	礻󰁶口丨
祍	礻󰁶丿士
祎	礻󰁶二丨
祏	礻󰁶石󰀝
䨏	󰀙冫⺈人
鸘	󰀙木目灬
敩	󰀧冖孑攵
祒	礻󰁶刀口
扤	扌一儿󰁀
咟	口丆日󰀝
蒟	艹立勹口
璟	王曰󰁸小
祕	礻󰁶心丿
祘	二小二小
㩥	扌十戈󰀞
䊤	米覀早󰀢
祙	礻󰁶未󰁶
祡	止匕二小
莪	艹丿扌丶
祤	礻󰁶羽󰀝
祦	礻󰁶口大
艦	丿󰁪匚皿
㔌	耳又乑刂
攩	扌⺌冖灬
祪	礻󰁶⺈⺋
瑓	王木󰀹󰀝
葓	艹氵󰁺八
摓	扌夂三辶
祮	礻󰁶士口
鑓	釒口丨辶
閬	門丶艮󰀦
祱	礻󰁶丷儿
粃	米󰁴匕󰁀
祳	礻󰁶厂󰀖
祴	礻󰁶戈廾
祵	礻󰁶囗木
鹘	󰀾月勹一
祶	礻󰁶丷丿
祹	礻󰁶勹凵
祻	礻󰁶囗古
呟	口亠幺󰁶
湘	氵木目󰀝
瑟	王王心丿
葟	艹白王󰀘
䇤	⺮一冂人
㨥	扌糹冂人
㿍	疒⺈用󰀟
祿	礻󰁶彑氺
㒓	亻土䒑辶
璓	王艹禾乃
禃	礻󰁶十󰀣
禆	礻󰁶白十
禇	礻󰁶土日
禈	礻󰁶冖車
禉	礻󰁶丷一
禋	礻󰁶覀土
禌	礻󰁶䒑幺
禍	礻󰁶ㄇ口
禎	礻󰁶󰀥貝
瀨	氵木口貝
禑	礻󰁶曰丶
禒	礻󰁶彑󰀓
禓	礻󰁶日󰁤
禔	礻󰁶日󰁾
禕	礻󰁶󰁆㐄
嶇	山匚口口
禗	礻󰁶田心
禘	礻󰁶亠丨
禙	礻󰁶丬月
亳	󰁸冖丿七
禜	火火冖小
锟	钅日󰁴匕
蔟	艹方𠂉大
稥	禾灬日󰀘
懤	忄士乛寸
嶘	山木戈戈
㓟	皮刂󰀢
䓟	艹󰀼土口
禝	礻󰁶田夂
禞	礻󰁶󰁸口
禟	礻󰁶广口
禠	礻󰁶⺁几
䡩	車十󰀣八
隌	阝立日󰀝
㡩	言糹糹丨
㚌	夕夕日木
禢	礻󰁶曰羽
赽	土󰁾ユ人
嚡	口廿󰀜土
禤	礻󰁶罒羽
禥	礻󰁶󰀎土
禦	彳𠂉一小
戦	󰀧曰十戈
舦	丿󰁪大丶
蹓	口止󰁚田
禪	礻󰁶口十
禫	礻󰁶覀早
禬	礻󰁶人日
禭	礻󰁶䒑辶
禮	礻󰁶ㄇ䒑
禯	礻󰁶ㄇ󰀖
禰	礻󰁶一乂
駥	󰀋灬戈
禱	礻󰁶士寸
秥	禾󰀥口󰀝
蓟	艹󰁢󰀞刂
巘	山虍一犬
槥	木三丨彐
麦	主夂󰁧
禴	礻󰁶人艹
禵	礻󰁶日貝
禶	礻󰁶丿貝
㮥	木厶大田
禷	礻󰁶米貝
喟	口田月󰀝
䖟	亠󰄃虫󰁧
禸	冂厶󰀦
㞩	山几丶󰁧
䞩	土󰁾人口
偉	亻󰁆口㐄
灉	氵巛口󰁷
毜	毛小󰀦
禿	禾儿󰀅
犨	亻󰁷亻󰀟
秈	禾山󰀢
秌	火禾󰁶
贏	󰄹月貝丶
櫩	木門⺈臼
贍	貝⺈厂言
秎	禾八刀󰁥
秏	禾毛󰁀
蘌	艹彳𠂉小
疟	疒匚一󰀌
捤	扌尸毛󰁀
鴘	厶廾󰁟灬
荤	艹冖车󰀬
蕿	艹火爫又
灨	氵立早貝
秙	禾古󰀝
秚	禾丷󰀟󰀢
壤	土亠口󰀔
秝	禾禾󰁶
秞	禾由󰀝
秠	禾丆卜一
秢	禾人丶󰁻
㕟	󰀥冂艹又
䵘	禾人氺󰁤
嵘	山艹冖木
䠩	口止止󰀤
㠩	人󰄃󰀸󰀅
秨	禾𠂉丨二
賶	貝人丶口
庍	广斤󰀵
秬	禾匚󰁃󰀝
猨	犭󰁥爫又
秴	禾人一口
秶	冫⺈人禾
賩	貝宀二小
枌	木八刀󰁥
䌨	糹艹󰁯小
秿	禾甫󰁶
稄	禾厶八夂
稅	禾八口儿
鋨	釒丿扌丶
掤	扌月月󰀝
玤	王三丨󰀢
蕟	艹癶弓又
鵘	󰁬丿口灬
洀	氵丿󰁪󰁶
㜾	孑人󰀯󰀢
賓	宀一󰀤貝
䋨	糹立口󰀝
賒	貝人二小
稏	禾一󰀚一
稐	禾人一艹
稑	禾土八土
岘	山ㄇ󰁜󰁀
䋤	幺小丶
㬥	日凵山米
稘	禾󰀎八󰁶
稙	禾十󰀣󰀝
稜	禾土八夂
醨	西一亠厶
稦	禾󰁆口㐄
䆨	宀八日大
貺	貝口儿󰁀
稨	禾丶尸艹
稩	禾田月󰀝
貶	貝丿之󰁶
県	目󰄃小󰁧
朌	月八刀󰁥
㜌	士冖一又
稯	禾乂凵夂
稴	禾䒑󰁬八
獨	犭󰁥罒虫
嬩	女󰀗一八
鬥	丨王王亅
貘	豸艹日大
瘟	疒日皿󰀌
拤	扌上卜󰁶
䬩	丆卜人艮
販	貝⺁又󰁶
秵	禾囗大󰁶
稾	󰁸冂口禾
穀	士冖一又
穂	禾一由心
穄	禾癶二小
穈	广木木禾
䗟	匚𠂉大虫
匤	匚王丶󰀦
㰦	土厶⺈人
㳘	氵亠厶儿
穌	󰁢灬禾󰁶
辥	凵丿丿辛
穎	匕禾丆貝
穏	禾爫彐心
褥	衤󰁧厂寸
㣌	󰀥口彡󰁥
貁	豸宀八󰁶
豾	豸丆卜一
阨	阝厂⺋󰁀
瘨	疒十󰀣八
幩	冂丨十貝
穚	禾丿大口
穛	禾亻󰁷灬
穜	禾立曰土
穞	禾󰁢一日
穢	禾止戊󰀤
藟	艹田田田
髥	󰂞彡冂二
櫥	木广士寸
痟	疒⺌月󰀌
穤	禾󰀙丆〢
穥	禾󰀗一八
穦	禾宀一貝
穧	禾󰀴󰀳󰀝
葤	艹糹寸󰁧
簘	⺮󰁬米󰀯
穨	禾几口貝
鑤	釒曰󰁺氺
䊟	米廿冂丶
㑤	亻艹田󰀝
抟	扌二󰁓丶
尘	小土󰀘
穩	禾爫工心
穪	禾一八乂
豥	一󰀓亠人
豤	一󰀓艮󰁶
豣	一󰀓一干
懝	忄匕𠂉󰁾
棩	木󰀲一󰀝
穳	禾丿土貝
穵	宀八乙󰀅
穻	宀八一󰀛
豑	ㄇ󰁺一丿
旌	方𠂉丿主
䙦	衤󰁧艹夕
鰞	󰁢灬󰁞灬
窅	宀八目󰀘
谽	八人口口
线	纟二󰅅丶
窇	宀八勹巳
窉	宀八一人
窊	宀八⺁󰂃
窋	宀八凵山
窌	宀八󰁚卩
窎	宀八󰁠一
窏	宀八氵󰀛
籘	⺮月丷小
艟	丿󰁪立土
钤	钅人丶乛
愂	十冖孑心
㒤	亻耳耳耳
䒤	艹日󰀘
剟	又又又刂
扟	扌⺄十󰀢
窓	宀八厶心
轭	车厂⺋󰁀
朞	󰀎八月󰀘
窙	宀八土子
窚	宀八戊𠃌
癨	疒󰀙亻󰁷
讞	言虍一犬
脨	月木口󰀝
窞	宀八⺈臼
讚	言丿土貝
憌	釒勹冫心
窢	宀八戈󰀞
排	扌丨三三
讖	言人人󰀞
窧	宀八󰀥早
窩	宀八ㄇ口
窪	宀八氵土
窫	宀八三大
窮	宀八丿弓
窯	宀八丷灬
變	言糹糹攵
讉	言口丨辶
窰	宀八爫凵
窱	宀八亻木
梩	木曰土󰀝
錟	釒火火󰁶
茟	艹󰁬󰀟󰀬
箘	⺮囗禾󰁧
揤	扌󰁮卩󰀢
古	古一丨一
䰥	戈口󰀞厶
㰥	廿󰄃⺈人
䨍	󰀙二󰀯󰀬
窴	宀八十八
灓	言糹糹水
聓	工几丶耳
窶	宀八󰀻女
剈	口月刂󰀢
窹	宀八爿口
窺	宀八夫儿
窻	宀八丿心
瀰	氵弓一乂
窾	宀八士人
竀	宀八一儿
竁	宀八毛毛
竂	宀八大小
竃	宀八土乚
竄	宀八臼󰁒
竅	宀八白攵
竆	宀八丿口
竇	宀八士貝
竈	宀八土黽
竉	宀八立三
竊	宀八丿厶
竎	立廾󰀬
螸	八人口虫
鋟	釒彐冖又
竒	立口亅󰀬
篥	⺮覀木󰁧
诘	讠士口󰀝
吤	口人󰀯󰀢
毘	田󰁴匕󰀅
㯥	木日木日
䯥	󰀾月日灬
竓	立毛󰁀
唧	口彐厶卩
譢	言䒑󰀓辶
譡	言⺌冖田
譠	言亠囗一
譟	言口口木
譞	言罒一󰀔
譝	言黽󰀝
譜	言䒑业日
梗	木一日乂
竝	立立󰀝
腨	月山丆〢
譗	言⺮人口
兌	八口儿󰀅
胓	月一丷十
竧	立丿󰀽丿
竪	匚丨󰁃立
竬	立丿口丶
竰	立厂曰土
譇	言大土日
竲	立丷󰀺日
譄	言丷󰀺日
譂	言口口十
䌍	糹廿口
嶥	山厂䒑人
䎟	女丆冂〢
笘	⺮󰀥口󰀘
掟	扌宀一󰁾
鬘	󰂞彡曰又
蕤	艹一󰀓主
婎	女亻󰁷󰀝
竸	立曰儿儿
竻	⺮力󰁣
梥	宀八厶木
竾	⺮也󰀅
笉	⺮勹冫󰀘
謱	言󰀻女󰀝
屭	尸貝貝貝
蛵	虫一巛工
嬎	女⺈口
䬎	几丿虫󰀞
笐	⺮亠几󰀅
笒	⺮人丶乛
茍	丨一󰀥口
䉥	⺮扌丿心
笚	⺮甲󰀬
謙	言䒑󰁬八
笡	⺮󰀐一󰀘
麒	广󰁃〢八
謕	言⺁虍几
謓	言十󰀣八
謒	言人丶口
醝	西一⺶工
鉍	釒心丿󰁥
㕤	口九󰁀
艍	丿󰁪尸古
䖤	夕⺋虫󰁧
卟	口卜󰁶
歘	火火火人
筘	⺮扌口󰀘
赥	土󰁖⺈人
鵥	丷󰀠刂灬
䠻	丿󰀽三弓
諾	言艹口
聺	耳宀󰁯小
灺	火也󰁀
遺	口丨一辶
諹	言曰一󰁤
笽	⺮皿󰀘
笿	⺮夂口󰀘
鯞	󰁢灬彐丨
櫎	木广󰁺八
筆	⺮󰁬󰀟󰀬
䡻	車丿目方
諫	言木󰀹󰀝
㐍	爫乙󰀅
筓	⺮一干
壓	厂曰月土
筗	⺮亻口丨
筙	⺮二木󰁧
菍	艹人丶乛
筥	⺮口口󰀘
筧	⺮目儿󰀅
筨	⺮人丶口
諓	言戈戈󰁶
諒	言󰁸小󰁶
氎	田田田毛
㵥	氵宀心皿
紥	扌乚幺小
檘	木尸口辛
崥	山白丿十
䐟	月󰀀冂土
筫	⺮貝󰁧
筬	⺮戊𠃌󰀅
铤	钅丿士廴
败	贝夂󰁶
筯	⺮󰀐󰀞力
筰	⺮亻𠂉二
簼	⺮扌󰀀土
鐍	釒󰁻乛口
筿	⺮夂朩󰁧
誷	言冂䒑󰄃
䎍	羽甫󰁶
寎	宀爿一人
毎	𠂉󰄃𠃌十
箉	⺮扌口力
箊	⺮方人󰁦
箎	⺮虍几󰀅
荍	艹󰁐丨攵
箖	⺮木木󰁧
箚	⺮人一刂
箞	⺮丷夫⺋
箠	⺮丿士󰁺
箣	⺮木冂刂
誚	言⺌月󰀝
箥	⺮氵皮󰁧
㴥	氵山⺌月
玍	𠂉土󰀘
莍	艹一氺丶
朠	月艹ㄇ大
揟	扌乛󰁾月
竘	立勹口󰀝
䔤	艹白丆日
嫘	女田ㄠ小
誃	言夕夕󰁶
箽	⺮丿一土
菟	艹⺈口丶
鳥	󰁟灬󰀦
詾	言勹乂凵
篂	⺮曰丿
醩	西一一日
膩	月󰀁二丶
篅	⺮山丆〢
冩	冖臼勹灬
䆩	宀八目大
詵	言丿土儿
㩪	扌糹丆貝
䑍	月貝貝女
篊	⺮氵󰁺八
㴎	氵大二小
䦻	阝子󰀝
燺	火󰁸冂木
篔	⺮口貝󰁧
艩	丿󰁪󰀴󰀳
詣	言匕日󰀝
蔍	艹󰁙󰁴匕
詢	言勹日󰀝
峎	山艮󰁧
泎	氵𠂉丨二
㳥	氵王廾󰀢
璍	王艹一󰀟
彴	彳勹丶󰁶
偎	亻田一󰀖
䁎	目󰁸冖丁
灎	氵ㄇ󰁺皿
梏	木丿土口
颏	亠ㄥ丿贝
袏	衤󰁧工
槻	木夫目儿
㧻	扌一󰀓丶
䧻	人一口󰁷
熺	火士口口
篢	⺮工貝󰁧
篣	⺮亠丷方
鈩	釒丶尸󰁥
舩	丿󰁪八厶
爩	火木𠂉彡
䈩	⺮人一刂
茻	凵丿凵丨
鸴	󰀧冖󰁠一
渴	氵日勹󰄃
猻	犭󰁥孑小
葍	艹一口田
篫	⺮工几手
篯	⺮钅一戈
殎	一夕大人
䏍	厶月󰀘
詐	言𠂉丨二
樻	木口丨貝
娻	女木曰󰀝
临	〢𠂉丶󰀱
医	匚𠂉大󰀦
㢏	广人一刂
㸴	石丿󰀟󰀬
䡏	車弓厶󰁶
塏	土山一䒑
桏	木工阝󰀢
炎	火火󰁧
衏	彳二儿丁
顏	文厂彡貝
鉺	釒耳󰀝
篳	⺮曰艹󰀟
篴	⺮一󰀓辶
篵	⺮彳人󰁾
篹	⺮目大⺋
篺	⺮扌白十
篻	⺮覀二小
篽	⺮彳𠂉卩
黱	月丷夫灬
簄	⺮丶尸巴
鍻	釒曰勹󰄃
荻	艹犭ノ火
獻	虍一口犬
捻	扌人丶心
闌	門木󰀹󰀌
簆	⺮宀二攵
扝	扌二ㄅ󰁀
簊	⺮󰀎八土
仴	亻月󰀝
橻	木󰁈丨一
爺	八乂耳阝
舺	丿󰁪甲󰀢
巴	巴󰁈丨乚
䍻	⺶巳巳八
㷴	厂禾禾火
㡏	冂丨人刂
烎	一廾火󰁧
澈	氵亠厶夂
很	彳彐󰀖󰁶
侈	亻夕夕󰁶
簍	⺮󰀻女󰀘
簑	⺮亠口󰀔
龈	止人凵󰀖
胎	月厶口󰀝
簕	⺮廿󰀜力
訮	言一廾󰀢
㵍	氵門心󰁶
喌	口口丶丨
疌	一󰁬󰁾󰀦
訪	言方󰁥
訩	言乂凵󰀢
訨	言止󰀝
抻	扌日丨󰀢
纴	纟丿士󰀝
芻	勹凵丿丿
銻	釒丷弓丿
訧	言乚丶
簛	⺮󰀎八斤
簞	⺮口口十
簠	⺮甫皿󰀘
簣	⺮口丨貝
簤	⺮罒貝󰁧
簥	⺮丿大口
驀	艹曰大灬
㾈	疒亻寸󰀦
㺴	王犬󰁶
亴	󰁸冖土九
庴	广󰁺日󰀌
棏	木曰一寸
焎	扌斤灬󰁧
俈	亻丿土口
壏	土匚丨皿
簩	⺮火火力
簫	⺮󰁬十󰀲
脎	月乂木󰁶
鄎	丿目心阝
簬	⺮口止口
帍	丶尸冂丨
蛻	虫八口儿
告	丿土口󰀘
訔	山言󰀘
紁	糹又丶󰁶
簱	⺮方󰀎八
簴	⺮虍业八
狻	犭ノ厶夂
湴	氵䒑业󰀝
鹴	󰀙木目一
蹴	口止亠丶
樥	木艹夂丨
簶	⺮礻󰁶氺
簷	⺮⺈厂言
簹	⺮⺌冖田
簺	⺮宀󰀀土
簻	⺮ㄇ󰁈辶
簽	⺮人一人
簾	⺮广䒑八
㹴	犭󰁥一乂
㣏	大早彡󰁥
年	󰅎丨十󰀵
乴	扌斤乙󰀅
籂	⺮人良丨
籄	⺮匚口貝
䆏	禾米田八
㬈	日日皿󰀝
籅	⺮󰀗一八
籆	⺮艹亻又
籇	⺮󰁸冖󰀓
朻	木󰁐丨󰀢
岎	山八刀󰁥
籊	⺮羽亻󰁷
籋	⺮一八乂
籎	⺮匕𠂉󰁾
籏	⺮方𠂉八
籔	⺮󰀻女攵
籗	⺮󰀙亻󰁷
㶍	氵󰁢灬羊
嬴	亠󰄃口丶
欴	丶󰁮⺈人
㘻	土囗大󰁶
䘻	衤󰁧亠月
䕌	艹禾亻󰁷
涍	氵土丿子
蛍	󰀧冖虫󰁧
㺎	犭󰁥广丨
籢	⺮人一攵
鬈	󰂞彡丷⺋
籣	⺮門木󰀹
籥	⺮人一艹
阻	阝󰀐一󰀝
冏	冂八口󰀌
膏	󰁸冖口月
熏	丿一󰀹灬
籧	⺮虍一辶
籨	⺮人一人
㭈	木ユ人󰁶
䅏	禾尸毛󰁀
覨	口口二儿
覧	匚丨󰁃儿
籫	⺮丿土貝
籬	⺮亠乂󰁷
籮	⺮罒糹󰁷
籯	⺮󰄹月丶
籱	⺮󰀙亻󰁷
覕	心丿目儿
覔	丆卜目儿
籶	米几󰁀
㹎	牜田幺小
䞪	土󰁾匚斤
晻	日大曰乚
噻	口宀󰀀土
䙻	丿ㄅ丨儿
㫴	日土丿子
籿	米寸󰁶
襸	衤󰁧丿貝
粇	米亠几󰁀
適	亠丷冂辶
酏	西一也󰁀
弎	󰀁三丶󰀦
粍	米毛󰁀
粐	米丶尸󰁥
兏	厂上儿󰁫
陻	阝覀土󰀝
虻	虫亠󰄃󰁀
腏	月又又又
䪈	廿󰀜口辶
㪈	土土󰀥又
粓	米甘󰀝
粔	米匚󰁃󰀝
埪	土宀八工
潗	氵亻󰁷木
襧	衤󰁧一乂
粙	米由󰀝
粚	米𠂉也󰁀
瀩	氵禾几貝
柪	木幺力󰁥
襚	衤󰁧䒑辶
粦	米夕㐄󰀬
粩	米土丿匕
苩	艹白󰀘
粭	米人一口
㮴	木臼丨又
䮴	󰀋灬癶䒑
宴	宀日女󰀘
殴	匚乂几又
粴	米曰土󰀝
粵	丿ㄇ丿ㄅ
襇	衤󰁧門日
襆	衤󰁧业夫
儞	亻一八乂
粸	米󰀎八󰁶
侎	亻米󰁶
骈	󰀊󰀞䒑廾
箴	⺮厂一丶
薻	艹氵巛木
戏	又戈󰁶
媈	女冖車󰀢
㫈	方人󰁦口
䇏	立󰁸子󰀝
犩	禾女白󰀟
糂	米󰀎八󰄃
糄	米丶尸艹
糆	米丆囗二
糉	米乂凵夂
糋	米䒑月刂
䘥	衤󰁧甲󰀢
詡	言羽󰀝
糐	米甫寸󰁶
糓	士冖一又
彎	言糹糹弓
褘	衤󰁧󰁆㐄
褗	衤󰁧匚女
頍	十又丆貝
䗻	虫⺮󰁮卩
㭴	木〢又土
旻	曰文󰁧
孴	子孑子日
糘	米宀一󰀓
褔	衤󰁧一田
糚	米艹爿士
糛	米⺌冖土
糞	米田󰁺八
糡	米立曰儿
量	日一日土
㙡	土彳人󰁾
藻	艹氵口木
痻	疒󰁚󰀁日
减	冫厂一丶
闻	门耳󰀌
褆	衤󰁧日󰁾
糥	米丆冂〢
糦	米士口口
糧	米曰一土
糩	米人一日
㠴	冂丨刀丶
裺	衤󰁧大乚
裷	衤󰁧丷⺋
栴	木𠂉󰀼亠
破	石󰅌又󰁶
师	リ一冂丨
場	土曰一󰁤
皏	白䒑廾󰀢
済	氵文󰀳󰀝
蠴	虫艹罒日
頴	匕二小貝
㻦	王日冂丶
糭	米󰁘凵夂
糱	凵丿丿米
糲	米厂艹丶
糴	丿丶米󰁷
怊	忄刀口󰀝
糶	凵山米󰁷
逋	一月丨辶
裩	衤󰁧曰󰁴
糺	糹乚󰁀
糽	糹丁󰀢
糾	糹󰁐丨󰀢
糿	糹刀󰁥
忎	丿十心󰁧
枍	木八一ㄅ
紂	糹寸󰁶
紃	糹川󰀢
約	糹勹丶󰁶
紅	糹工󰀝
紆	糹一󰀛󰀢
㟴	山白󰁜厶
釩	釒几丶󰁶
紉	糹刀丶󰁶
䨪	󰀙土日土
煻	火广󰁬口
柴	止匕木󰁧
埴	土十󰀣󰀝
幈	冂丨尸廾
晏	日宀女󰀘
癏	疒罒一󰀔
蹈	口止爫臼
腻	月弋二丶
懩	忄䒑夫艮
燩	火白方攵
紋	糹文󰁶
紌	糹乚丶
納	糹冂人󰁶
閩	門虫󰀦
薩	艹阝立
紐	糹󰁈丨一
紑	糹丆卜󰁶
幪	冂丨艹󰀓
燞	亻󰁷⺈灬
紒	糹人󰀯󰀢
紓	糹󰁻乛亅
㹪	犭󰁥󰀼一
脌	月𠂉㐄󰀢
焌	火厶八夂
䄌	礻󰁶又又
嶃	山車斤󰀢
袻	衤󰁧丆〢
锄	钅󰀐󰀞力
紗	糹小丿󰁥
紘	糹厶󰁶
紙	糹󰁚󰀁󰁀
㢴	弓囗󰁤丶
䢴	丿阝󰀢
傻	亻丿囗夂
㶈	氵火火虫
碴	石木日一
肻	󰀥冖月󰀘
邻	人丶󰁻阝
眏	目ㄇ大󰁶
消	氵⺌月󰀝
級	糹乃󰂃󰁶
紛	糹八刀󰁥
紜	糹二厶󰁶
紝	糹丿士󰀝
紞	糹冖󰁜󰁀
紟	糹人丶乛
紡	糹方󰁥
紣	糹九十󰀢
紤	糹斤󰀢
虩	⺌曰小几
癩	疒木口貝
袦	衤󰁧凵山
嶪	山业䒑未
紨	糹亻寸󰁶
㶪	丆卜火󰁧
紬	糹由󰀝
紭	糹弓厶󰁶
㵂	氵广廿灬
究	宀八九󰀅
紲	糹廿󰄃󰁀
紳	糹曰丨󰀢
紴	糹皮󰁶
㡴	广立󰀌
紵	糹宀丁󰀢
僻	亻尸口辛
巈	山廿󰀜米
烻	火丿󰀥廴
㷈	火大日乚
蛏	虫又土󰀝
雏	⺈彐亻󰁷
淈	氵尸凵山
盏	二󰅅丶皿
后	⺁一口󰀌
紷	糹人丶󰁻
紸	糹丶王󰀝
紹	糹刀口󰀝
紺	糹甘󰀝
紻	糹ㄇ大󰁶
淪	氵人一艹
袊	衤󰁧人󰁻
㷪	火亻󰁷乃
紿	糹厶口󰀝
絀	糹凵山󰀢
䂌	󰁻乛亅土
狿	犭󰁥丿廴
終	糹夂󰁦󰁶
絃	糹亠幺󰁶
組	糹󰀐一󰀝
螏	虫疒𠂉大
瞏	罒土口󰀔
絅	糹冂口󰀝
鞏	工几丶󰀜
䞏	贝田心󰁶
㞏	尸丿之󰀦
枏	木冂二󰀝
垏	土󰁬󰀟󰀢
絆	糹丷󰀟󰀢
絇	糹勹口󰀝
絈	糹白󰀝
絉	糹木丶󰁶
絊	糹木一󰀝
絋	糹广厶󰁶
跱	口止土寸
訬	言小丿󰁥
絎	糹彳一丁
絏	糹曰󰁒丿
鴴	彳一丁灬
結	糹士口󰀝
琻	王金󰀝
贴	贝󰀥口󰀝
吻	口勹󰁤ノ
洴	氵䒑廾󰀢
㴴	氵火一󰄃
䐻	月古辛󰀢
絑	糹丿未󰁶
絒	糹丶丿丨
餎	人良夂口
絔	糹丆日󰀝
絕	糹刀巴󰁀
衙	彳五口丁
睏	目囗木󰁶
蝏	虫󰁸冖丁
靏	󰀙冖亻灬
絗	糹囗口󰀝
㝏	宀人󰀯󰀬
䝏	一󰀓󰀻女
坏	土丆卜󰁶
杏	木口󰀘
遌	口口二辶
絚	糹一丨一
恌	忄儿󰀪󰁶
絝	糹大二ㄅ
絞	糹六乂󰁶
絟	糹人王󰀝
絠	糹月󰀝
絡	糹夂口󰀝
衉	丿皿夂口
郩	乂月阝
絤	糹西󰀝
鑻	釒木乂乂
賴	木口⺈貝
瑻	王毌貝󰁶
摻	扌厶厶彡
呻	口日丨󰀢
䳴	罒󰀫󰁟灬
㑻	亻宀心山
絥	糹亻犬󰁶
給	糹人一口
絧	糹冂一口
絨	糹戈󰁥
絩	糹儿󰀪󰁶
絪	糹囗大󰁶
絬	糹丿古󰀝
頏	亠几丆貝
蠏	虫⺈用󰀟
砏	石八刀󰁥
栏	木丷三󰀝
堏	木方土󰀘
䠏	口止癶大
㠏	山艹一󰀟
絭	丷夫幺小
絯	糹亠ㄥ人
姗	女󰀼󰀼一
統	糹亠厶儿
絲	糹幺小󰁶
蠩	虫言土日
蠨	虫艹󰁬󰀲
絳	糹夂㐄󰀢
鶴	冖亻󰁷灬
絴	糹羊󰀢
臍	月󰀴󰀳󰀝
蠣	虫厂艹丶
嶴	丿冂米山
掻	扌又虫󰁶
玻	王󰅌又󰁶
趴	口止八󰁶
絶	糹⺈巴󰁀
奪	大亻󰁷寸
㶴	火夕夕󰁶
䎻	耳󰀼土口
憤	忄十艹貝
絹	糹口月󰀝
邩	火阝󰀢
絻	糹⺈口󰁜
韏	丷夫󰁆㐄
絼	糹豸󰁥
矏	目丿目方
蟏	虫艹󰁬八
埏	土丿止廴
柏	木白󰀝
㟏	山人丶口
䀎	目一ㄅ󰁀
絽	糹口口󰀝
絾	糹戊𠃌󰁀
絿	糹一氺丶
綀	糹木口󰀝
綁	糹三丿阝
麩	木人人夫
綃	糹⺌月󰀝
綄	糹宀二儿
綅	糹彐冖又
鵴	勹米󰁟灬
綆	糹一曰乂
綇	糹西一󰀝
浴	氵八人口
嵴	山󰀪人月
赴	土󰁾卜󰀦
珻	王𠂉母󰁶
綈	糹丷弓丿
綉	糹禾乃󰁥
䏻	厶月土厶
㵴	氵戈爿丨
綊	糹大人人
暆	日方𠂉也
蟭	虫亻󰁷灬
綍	糹十冖子
闂	門丷夫⺋
綏	糹爫女󰀝
綐	糹丷口儿
綒	糹爫子󰀝
經	糹一巛工
綕	糹士心󰁶
杜	木土󰀝
綗	糹冂八口
㪵	丷󰀠󰁦十
綘	糹夂三丨
媵	月䒑大女
䉴	⺮亠口󰀔
咏	口丶𠃌󰀩
扴	扌人󰀯󰀢
簈	⺮尸丿干
艴	弓󰀯⺈巴
钏	钅川󰀢
谈	讠火火󰁶
継	糹米󰄃󰁀
続	糹士冖儿
堼	土土寸土
綜	糹宀二小
綝	糹木木󰁶
綞	糹丿士󰁺
綟	糹丶尸犬
綠	糹彑氺󰁶
腍	月人丶心
䣪	西一一丨
㣪	彳爫一又
綢	糹󰀼土口
綣	糹丷夫⺋
壪	土言糹糹
綥	糹田一󰀯
綧	糹󰁸子󰀝
綩	糹宀夕⺋
灤	氵言糹木
綫	糹戈戈󰁶
綬	糹爫冖又
維	糹亻󰁷󰀝
綯	糹勹𠂉凵
曈	日立曰土
㩵	扌虍一犬
䩵	廿󰀜冖車
婵	女丷󰅐󰀢
橵	木󰁺月攵
屈	尸凵山󰀵
汈	氵𠃌󰀞󰀝
籈	⺮覀土丶
豈	山一口䒑
鑏	釒宀心丁
綱	糹冂䒑山
髦	󰀍厶彡乚
綳	糹月月󰀝
綴	糹又又又
綵	糹爫木󰁶
綶	糹曰木󰁶
綷	糹亠人十
綸	糹人一艹
憍	忄丿大口
劤	斤力󰁥
綺	糹大丁口
綻	糹宀一󰁾
毫	亠口冖乚
綽	糹󰀥早󰀢
綾	糹土八夂
綿	糹白冂丨
緀	糹一󰁬女
螊	虫䒑󰁬八
㔢	糹⺈巴力
緃	糹人人󰁾
緄	糹曰󰁴匕
緅	糹耳又󰁶
娵	女耳又󰁶
䨵	󰀙氵覀早
㨵	扌䒑月刀
緇	糹巛田󰀝
箈	⺮氵厶口
致	一厶土夂
唏	口乂丨
䮈	󰀋灬夕夕
吶	口冂丿󰂃
逍	⺌月辶󰀌
锏	钅门日󰀝
讈	言厂禾止
緋	糹丨三三
荥	艹冖水󰁧
緍	糹󰁚󰀁日
緎	糹戈口󰀞
総	糹八厶心
緑	糹󰁭氺󰁶
緒	糹土丿日
鏎	釒曰艹󰀟
緕	糹文󰀳󰀝
緖	糹土丿日
伞	人丷十󰀬
緘	糹戊一口
緙	糹廿󰀜󰀢
設	言几又󰁶
㦧	忄丿土日
線	糹白水󰁶
緛	糹丆冂大
䘄	土丿日虫
䏎	月几丶󰁶
楴	木亠丷丨
䈴	⺮䒑󰁬八
㯈	木木口辶
緝	糹口耳󰀝
㧵	扌丆卜口
毈	󰁚丶丿又
駵	󰀋灬一󰁃
戴	十戈田八
哏	口艮󰁶
緞	糹丿丨又
緟	糹丿一土
诈	讠𠂉丨二
铏	钅一廾刂
締	糹亠丷丨
緡	糹󰁂󰀁日
緢	糹艹田󰀝
緣	糹彑󰀓󰁶
緤	糹廿󰄃木
緥	糹亻口木
緦	糹田心󰁶
緧	糹丷西一
編	糹丶尸艹
緩	糹爫一又
緪	糹忄一一
緫	糹勹󰁤心
螵	虫覀二小
瞵	目米夕丨
琎	王二󰀯辶
鞵	廿󰀜爫大
件	亻丿󰀟󰀢
㻶	王⺮󰁬󰀟
滶	氵󰁡攵
延	丿止廴󰀌
緭	糹田月󰀝
鐎	釒亻󰁷灬
緯	糹󰁆口㐄
緰	糹人一刂
閎	門厶󰀦
緱	糹亻ユ大
緲	糹目小丿
蛼	虫車󰀢
喎	口ㄇ󰁈口
浏	氵文刂󰀢
疎	乛止木口
薎	艹罒冖戈
練	糹木󰀹󰀝
繿	糹匚丨皿
㵏	氵艹亠十
䖎	阝虍几󰁀
緵	糹乂凵夂
膜	月艹日大
緸	糹覀土󰀝
緹	糹日一󰁾
緺	糹ㄇ󰁈口
緻	糹一厶攵
緼	糹曰皿󰀝
緽	糹󰀥貝󰁶
缶	󰅎山󰀵
蝵	禾火虫󰁧
鼶	臼󰁐󰁦几
緾	糹厂曰土
㝵	日一寸󰁧
伶	亻人丶󰁻
弶	弓󰁸小󰁶
漶	氵口口心
緿	糹厶口心
縀	糹󰁃丨又
縁	糹󰁭󰀓󰁶
縂	糹丷口心
縃	糹乛󰁾月
镎	钅人一手
縄	糹曰曰乚
縆	糹忄一一
敎	乂孑攵
嶏	山厂西己
趏	土󰁾丿古
畎	田大丶󰁶
獎	爿󰁝寸犬
縉	糹一业日
䶏	丷弓丨󰀯
㕎	厂土厶皿
縊	糹䒑八皿
縋	糹丿󰃧辶
縌	糹䒑凵辶
縍	糹亠丷方
䗤	虫广󰁬丨
䁻	目白幺木
㮏	木木二小
䍎	𠂉十凵灬
縎	糹󰀾月󰀝
齶	止󰀆口ㄅ
轶	车󰅎人󰁶
眵	目夕夕󰁶
朵	几木󰁧
彶	彳乃󰂃󰁶
佶	亻士口󰀝
㜵	女亠󰀋󰀔
縏	丿󰁪几小
縑	糹䒑󰁬八
縒	糹⺶工󰀝
饐	人良士䒑
拘	扌勹口󰀝
縕	糹囗人皿
阎	门⺈臼󰀌
喇	口一口刂
瘎	疒󰀎八󰄃
蘎	艹󰀙月巴
嘎	口丆目戈
明	日月󰀝
㘎	口门乛攵
䘎	虫言糹弓
縗	糹亠口󰀔
縘	糹爫幺大
縙	糹艹耳󰀝
縚	糹爫臼󰀝
奠	丷西一大
縜	糹口貝󰁶
縝	糹十󰀣八
縞	糹󰁸冂口
鎎	釒气米󰁶
縡	糹宀辛󰀢
雵	󰀙ㄇ大󰁧
縢	月丷夫小
盵	目𠂉乙󰁀
辶	辶丶󰁈󰂃
囵	囗人匕󰁫
澶	氵亠囗一
㾶	疒󰀾月󰀌
侶	亻口丿口
縣	󰀣小丿小
縤	糹幺小
縥	糹三人禾
縦	糹彳䒑󰁾
㲻	亻水󰁶
縧	糹亻丨朩
翕	人一口羽
闎	門白水󰀦
踏	口止水日
痎	疒亠ㄥ人
渏	氵大丁口
帏	冂丨二丨
䗎	虫覀土󰀝
㸏	广木木火
讟	言士罒言
縪	糹曰艹󰀟
縫	糹夂三辶
縬	糹戊上小
縭	糹亠乂厶
慽	忄戊上小
縯	糹宀一八
縰	糹彳止󰁾
鲇	󰁢󰀞󰀥口
縲	糹田幺小
娤	爿士女󰀘
虙	虍心丿󰀏
縳	糹一曰寸
縴	糹亠幺󰀟
㨈	扌文󰀳󰀝
縵	糹曰罒又
娈	亠󰁗女󰀘
䊏	米火火󰁶
蘧	艹󰅋七辶
縸	糹艹曰大
縹	糹覀二小
縺	糹車辶󰁶
欏	木罒糹󰁷
總	糹丿囗心
績	糹貝󰁶
縿	糹厶厶彡
繀	糹山亻󰁷
㰴	立口⺈人
嚐	口⺌冖日
繃	糹山月月
水	水水水水
画	一田凵󰀬
䔻	艹󰁸孑攵
尴	乚〢皿
犏	牜丶尸艹
抏	扌二儿󰁀
騈	󰀋灬丿干
锻	钅亻三又
繅	糹巛曰木
繆	糹羽人彡
獟	犭󰁥土儿
繈	糹弓厶虫
蘥	艹人一艹
繉	糹目儿󰀪
朲	木人󰁶
繋	車几又小
繌	糹丿囗夂
㩈	扌宀八口
䉏	⺮⺈用󰀟
剏	䒑廾刀丶
繍	糹󰁬米󰀯
繎	糹󰁝犬灬
繏	糹巳巳八
啡	口丨三三
錎	釒⺈臼󰀝
崻	山彳土寸
䴻	禾勹丿夕
繓	糹曰耳又
㯴	木艹宀口
織	糹亠丷日
㕺	口口一ㄅ
繕	糹羊䒑口
畻	田丷夫土
敻	⺈ㄇ人攵
啻	亠丷冖口
䕻	艹一ㄇ匕
橈	木土土儿
牏	丿丨一刂
艏	丿󰁪䒑目
鉏	釒󰀐一󰀝
繖	糹󰁺月攵
繗	糹米夕㐄
繘	糹󰁻乛口
繙	糹丿米田
繚	糹大丷小
繛	幺小早
繜	糹丷西寸
繝	糹門月󰀝
妈	女󰀊一󰀝
䦈	󰂞工󰀝
㦈	忄丷王皿
㪘	人一口攵
繞	糹土土儿
繟	糹口口十
繠	心心心小
繡	糹󰁬十󰀲
繢	糹口丨貝
繣	糹󰁬土一
繥	糹士口口
繦	糹弓口虫
艎	丿󰁪白王
鉎	釒丿󰀝
檏	木业䒑未
㒻	󰀰目儿󰀅
䲴	火󰁟灬󰁶
咻	口亻木󰁶
沴	氵人彡󰁥
璻	王羽亠十
馈	⺈󰁐口贝
钻	钅󰀥口󰀝
猏	犭󰁥丶月
榈	木门口口
牎	丿丨一󰁈
䤫	釒山人乛
戝	貝戈󰁶
繪	糹人一日
繫	車凵几小
㔺	十七十󰀬
繭	艹冂丨虫
繮	糹一田一
䋏	糹𠂉丨二
勏	立口力󰁥
繯	糹罒一󰀔
㧈	扌弓󰁀
繰	糹口口木
繱	糹艹勹心
繲	糹⺈用󰀟
繳	糹白方攵
䫅	宀木丆貝
䳔	臼󰁟灬󰁧
繵	糹亠囗一
繶	糹立曰心
㒗	亻艹二土
繸	糹䒑󰀓辶
㓻	罒一止刂
繹	糹罒土十
哻	口曰干󰀢
䓻	艹冖二女
籴	丿󰂃米󰁧
汴	氵亠卜󰁶
览	〢𠂉丶󰁜
蓻	艹土䒑丶
拏	女又手󰀬
狏	犭󰁥𠂉也
繺	糹⺈彐灬
繻	糹󰀙丆〢
榎	木丆目夂
薞	艹一夕艮
橏	木羊䒑口
纀	糹亻业夫
煁	火󰀎八󰄃
纃	糹󰀴󰀳󰀝
纄	糹艹夂辶
酴	西一人木
纅	糹白幺木
纆	糹󰀹土土
慴	忄羽白󰀝
兴	󰀧一八󰁧
覵	門月目儿
煴	火日皿󰀝
纇	米幺小貝
駙	󰀋灬亻寸
䅴	禾十冖小
㦵	丿未戈󰁶
纉	糹夫夫貝
纊	糹广󰁺八
纋	糹丆󰀐夂
續	糹士罒貝
莏	艹扌小丿
紈	糹九丶󰁶
纎	糹十戈󰀞
鎏	氵亠厶金
纏	糹广曰土
坴	土八土󰀘
㾵	疒言十󰀵
纑	糹虍田皿
纓	糹貝貝女
纔	糹⺈口丶
纕	糹亠口󰀔
纖	糹人人󰀞
纗	糹山亻口
纘	糹丿土貝
纙	糹罒糹󰁷
纚	糹一ㄇ匕
饵	⺈󰁐耳󰀝
纜	糹匚丨儿
纝	糹田田小
纞	糹言糹心
㵈	氵氵女古
極	木了口一
协	十力八󰁶
捏	扌日土󰀝
彵	彳也󰁀
㽵	疒土󰀌
㥵	忄囗一󰀓
䥵	釒日土儿
醻	西一士寸
熻	火人一羽
伵	亻四󰀝
牻	牜乚丶
獏	犭󰁥艹大
赈	贝厂二󰀖
鵈	耳󰁟灬󰁶
艻	艹力󰁣
鉻	釒夂口󰀝
䈻	⺮月甫󰁧
㜴	女一ㄇ目
鈻	釒󰃧󰀝
禂	礻󰁶󰀼口
闍	門土丿日
绹	纟勹𠂉凵
燸	火󰀙丆〢
瓎	王木口貝
㘍	口小亻戈
蘍	艹丿一力
葇	艹󰁻乛木
昍	日日󰀝
蔎	艹言几又
峏	山丆冂〢
郴	木木阝󰀢
搏	扌一月寸
烴	火一巛工
䐏	月三人日
僴	亻門日󰀝
䃴	石言土日
㤵	孑攵心󰁧
檴	木艹亻又
㽪	田丷󰀺日
㳏	氵口乂󰁶
蕍	艹氵人刂
缞	纟亠口󰀔
葎	艹彳󰁬󰀟
鑎	釒匚口貝
鲈	󰁢󰀞󰀥尸
萏	艹⺈臼󰀘
琏	王车辶󰁶
槴	木丶尸巴
㲏	丿丨一毛
鏻	釒米夕㐄
揻	扌戊一女
䀁	月皿󰀘
巎	山丆目夂
淎	氵三人󰀟
閍	門方󰀏
叝	土厶卩又
缹	𠂉十凵灬
缻	𠂉十凵丶
樴	木亠丷日
缾	𠂉十凵廾
莣	艹亠󰄃心
飵	人良𠂉二
㹘	牜󰀙丆〢
磵	石門日󰀝
描	扌艹田󰀝
㳈	氵十儿󰁀
愴	忄人丶口
㣵	彳土羊辶
䄴	禾月󰀝
眑	目幺力󰁥
罃	火火冖凵
䏺	月夂三丨
罆	𠂉十凵貝
罇	𠂉十凵寸
罈	𠂉十凵早
鏏	釒三丨彐
罉	𠂉十凵手
珏	王王丶󰁶
菏	艹氵丁口
罊	車凵几凵
罋	亠󰁲丿凵
猺	犭󰁥爫凵
錺	釒艹方󰁥
罎	𠂉十凵厶
罏	𠂉十凵皿
罓	ㄇ乂󰀦
䎙	宀一󰀤羽
堎	土土八夂
荈	艹夕㐄󰀬
罙	冖八木󰁧
濥	氵夕宀八
䎺	耳𠂉一刂
罝	罒󰀐一󰀘
罞	罒󰁻乛丿
菺	艹丶尸月
荺	艹土勹冫
鬻	弓米弓丨
捺	扌大二小
笻	⺮工卩󰀬
䑇	月斤斤貝
罧	罒木木󰁧
瀍	氵广曰土
罯	罒立日󰀘
罰	罒言刂󰀬
罳	罒田心󰁧
䕎	艹日一田
㑺	亻亻󰁷乃
区	匚乂󰀦
䌺	纟耳󰀝
㭻	木⺌冂口
㢎	广丿十臼
䢎	一廾辶󰀵
墎	土󰁸孑阝
梎	木白匕󰁀
碎	石亠人十
胍	月⺁厶󰂃
颎	匕火丆贝
毻	工月毛
鎺	釒礻󰁶一
罺	罒巛曰木
罻	罒尸二寸
怒	女又心󰁧
罿	罒立曰土
䧧	阝丷王丶
垎	土夂口󰀝
艑	丿󰁪丶艹
螎	虫一口丨
犺	犭󰁥亠几
櫻	木貝貝女
髻	󰂞彡士口
芺	艹丿大󰁧
羅	罒糹亻󰁷
羉	罒言糹小
氻	氵力󰁥
艬	丿󰁪⺈丶
鑺	釒目目󰁷
羏	⺶彡󰁥
羐	丨一󰀥󰂃
羒	⺶八刀󰁥
䍺	⺶口口心
卺	了󰀩一⺋
㡎	冂丨厶彡
㬻	月艹亠󰀸
塎	土宀八口
䄍	礻󰁶󰁺日
硎	石一廾刂
愍	󰁃󰁐弋心
鄍	冖曰六阝
脍	月人二厶
羓	⺶巴󰁀
睡	目丿十一
健	亻󰁬󰀟廴
羘	月羊󰀢
羜	⺶宀丁󰀢
羢	⺶戈󰁥
㛎	女口口󰀝
䛎	言宀八󰁶
吺	口几又󰁶
鐺	釒⺌冖田
檻	木匚丨皿
狺	犭ノ言󰀝
誻	言水日󰀝
骻	󰀾月大ㄅ
羥	⺶一巛工
羦	⺶宀二儿
義	丷王丿丶
羪	⺶丶艮󰁶
㚥	女一󰀛󰀢
羬	⺶戊一口
羭	⺶人一刂
羮	丷王灬一
㫻	日人一艹
㤎	力口心󰁧
嫻	女門木󰁶
䊺	糹一彑󰀝
恍	忄⺌一儿
灍	氵門䒑人
䁍	目戊一口
偍	亻日一󰁾
恕	女口心󰁧
羳	⺶丿米田
聍	耳宀丁󰀢
遍	丶尸冂辶
羴	羊⺶羊󰀬
羵	⺶十艹貝
羶	⺶亠囗一
羷	⺶人一人
眎	目二小󰁶
阺	阝󰁚󰀁丶
蹻	口止丿口
瘺	疒尸雨󰀦
奞	大亻󰁷󰀘
羺	羊󰀙丆〢
䜮	八人口󰀟
羻	⺶󰁙乛夂
羾	羽工󰀝
翂	羽八刀󰁥
翇	羽又丶
翈	甲羽󰀝
翋	羽立󰀝
翍	羽皮󰁶
翐	羽丿夫󰁶
陎	阝丿未󰁶
㣎	白小彡󰁣
㪻	言糹糹十
䋺	糹禾火󰁶
勺	勹丶󰀦
炍	火⺁又󰁶
悍	忄日干󰀢
傍	亻亠丷方
䣎	巛田阝󰀢
䙎	衤󰁧爫大
臞	月目目󰁷
风	几乂󰀦
裎	衤󰁧口王
饏	乛耳攵艮
㺏	犭󰁥󰀻女
屛	尸丿一干
翖	人一口羽
奏	三人一大
憎	忄丷󰀺日
縻	广木木小
虺	一儿虫󰀦
酺	西一甫󰁶
湏	氵丆貝󰁶
㥏	忄ㄇ󰁺八
䆎	禾人人󰀞
㹏	牜廿口
㿴	大耳皮󰁶
翯	羽󰁸冂口
翲	覀二小羽
翷	米夕㐄羽
翸	十艹貝羽
䥺	钅󰀄亅丿
郍	丿󰁪阝󰀢
脁	󰀼冫儿󰀪
㯠	木亠幺󰀟
㶻	夂三丨灬
濺	氵貝戈戈
昺	曰一冂人
幻	ㄠ𠃌󰁀
乻	方人󰁦乙
㘺	土亻戈󰁶
呝	口丶尸乙
硃	石丿未󰁶
肸	月八十󰀢
傕	亻冖亻󰁷
耛	二木厶口
酎	西一寸󰁶
巻	丷夫己󰀅
㷻	火𠂉一灬
跻	口止文󰀯
疺	疒丿之󰀦
規	夫目儿󰁀
鷻	󰁟灬󰁸攵
耬	二木󰀻女
烚	火人一口
䦏	門人󰀯󰀵
㦏	忄巳巳八
䨯	󰀙阝木日
耲	二木亠󰀔
瀛	氵亠󰄃丶
抑	扌󰁚卩󰀢
槏	木䒑󰁬八
姏	女甘󰀝
妏	女文󰁶
絘	糹冫⺈人
窵	宀八󰁟灬
梠	木口口󰀝
䅎	禾禾乃󰁥
腎	匚丨󰁃月
帻	冂丨主贝
智	𠂉大口日
㸻	牜厶𠂉大
主	丶王󰀌
榏	木䒑八皿
榹	木⺁虍几
氾	氵⺋󰁀
粈	米󰁈丨一
溚	氵艹人口
䋜	丶尸又小
鈎	釒勹厶󰁶
湻	氵󰁸曰󰀝
爎	火宀大小
觏	󰀀ㄇ土󰁜
刎	勹󰁤刂󰀢
戎	戈󰀏
㧏	扌冂乂󰁶
䈎	⺮廿󰄃木
聲	士󰁅几耳
聳	彳人人耳
肁	丶尸󰁬󰀟
熎	火爫𠂉凵
冎	ㄇ󰁈冂󰀅
醎	西一戊口
肍	月九󰁀
邍	夂田󰁭辶
䂍	󰁻乛亅氺
棎	木冖八木
媻	丿󰁪几女
䖅	艹󰀙口人
曧	曰一口虫
肗	月女󰀝
䖺	亻丨夂虫
㖺	口三人日
添	氵一大⺗
喺	口亻丿小
刾	一丷大刂
䫎	又又又貝
絸	糹目儿󰁀
蘺	艹亠乂󰁷
癥	疒彳山攵
肵	月斤󰀢
锺	钅丿一土
蔺	艹门亻󰁷
臎	月羽亠十
燎	火大丷小
懎	忄土人口
凎	冫金󰀝
䇎	立󰁺日󰀝
㨏	扌山火
濆	氵十艹貝
苺	艹母󰁧
㽥	田󰁻乛木
暦	厂木木曰
䜸	一口䒑毛
䡎	車丶尸󰁥
嬻	女士罒貝
窲	宀八米十
絢	糹勹日󰀝
嵒	口口口山
胮	月夂㐄󰀢
慻	忄丷夫目
銺	爿士金󰀘
壋	土⺌冖田
㗺	口一大三
䗺	丿󰀥󰄃虫
嶻	山十戈󰁷
旺	日王󰀝
䗌	虫日丿
﨏	土八八口
烍	火丿土儿
孻	孑󰁬丨皿
䋢	扌斤幺小
槗	木口口
胝	月󰁚󰀁丶
玒	王工󰀝
䂫	石夂㐄󰀢
㜹	女目目󰁷
獺	犭󰁥木貝
鍺	釒土丿日
冾	冫人一口
僂	亻󰀻女󰀝
脤	月厂二󰀖
脦	月󰀁心丶
㥻	戊丿朩心
炇	火攵󰁶
冟	冖白匕󰀅
脴	月丆卜口
椻	木匚曰女
礻	礻󰁶丶丶
乏	丿之󰁧
嚎	口󰁸冖󰀓
暎	日艹ㄇ大
皎	白亠八乂
腺	月白水󰁶
鹏	月月勹一
箻	⺮彳󰁬󰀟
腁	月丿一干
腃	月丷夫⺋
䏏	月一󰀛󰀢
鄴	业䒑未阝
䴦	󰁙󰁴匕言
綡	糹󰁸小󰁶
䵅	󰁡攵夕
腖	月木曰󰀝
䌌	糹羽白󰀝
綎	糹丿士廴
䟼	口止一丶
䍐	罒干󰀬
㲈	士󰁅几口
膁	月䒑󰁬八
㭠	木丿土儿
鍏	釒󰁆口㐄
膔	月󰁙󰁴匕
膖	月夂三辶
䆴	宀八⺈乚
膗	月山亻󰁷
㤻	󰁚丶丿心
柈	木丷󰀟󰀢
樍	木貝󰁶
傺	亻󰁯二小
䂺	石日木󰁶
磻	石丿米田
亏	二ㄅ󰀅
邺	业阝󰀢
裻	上小又󰀔
麏	󰁙󰁴匕口
虎	󰅋七几󰁫
裋	衤󰁧一䒑
膴	月𠂉一灬
篠	⺮亻丨朩
玏	王力󰁥
膼	月ㄇ󰁈辶
䦵	門一八乂
㠛	山艹亻又
厏	厂𠂉丨二
䎏	人丶乛羽
臏	月宀一貝
臑	月󰀙丆〢
襅	衤󰁧曰󰀟
㞑	尸二二乚
朩	朩一亅丶
臗	月宀艹丶
槈	木厂二寸
屴	山力󰁣
㢙	广廿口力
槸	木土八丶
臨	匚丨󰁃口
紇	糹𠂉乙󰁀
嵟	山厂亻󰁷
㣻	乂心󰁧
臵	一厶土口
䢻	匚丨󰁃阝
僺	亻口口木
惺	忄日丿主
㜎	女爫幺大
蜎	虫口月󰀝
黏	禾人氺口
滏	氵八乂䒑
经	纟ス工󰀝
臹	一厶土𠃌
蜐	虫土厶力
纒	糹广曰土
岴	山丘󰀝
㲴	气口丨󰀵
㘧	土󰁻乛亅
䠜	口止艹耳
舊	艹亻󰁷臼
綋	糹宀厶
舏	丿古󰁐丨
䲖	󰁢灬士寸
䰧	白󰁜厶几
楀	木丿口丶
舗	人土口甫
舚	丿古⺈言
樿	木口口十
篨	⺮阝人朩
淕	氵土八土
寴	宀立朩儿
鱻	󰁢灬󰁢灬
萺	艹󰀰目󰀘
类	米大󰁧
携	扌亻󰁷乃
㢻	弓禾女󰀝
式	󰀁工丶󰀦
伏	亻犬󰁶
㼏	爫女⺁󰂃
毴	毛丨三三
雎	󰀐󰀞亻󰁷
輏	車西一󰀝
盎	ㄇ大皿󰀘
漏	氵尸雨󰁶
橮	木󰁚丶貝
尲	乚䒑八
圥	土儿󰀅
墧	土丿大口
舼	丿󰁪󰁺八
婈	女土八夂
䩈	丆囗〢母
艁	丿󰁪丿口
艊	丿󰁪白丨
笭	⺮人丶󰁻
繧	糹󰀙二厶
樈	木立曰儿
艕	丿󰁪亠方
艖	丿󰁪⺶工
撹	扌󰀧冖儿
堿	土戊一口
艢	丿󰁪土口
䨈	宀一󰀤󰁷
鰻	󰁢灬日又
艫	丿󰁪虍皿
瑺	王⺌冖丨
葺	艹口耳󰀘
尻	尸九󰁫
摺	扌羽白󰀝
䐺	月覀早󰀢
㐺	亻亻人󰁶
㽚	田丿󰀟󰀬
䒥	艹一冂丨
䜬	八人口由
藎	艹󰁬丨皿
芇	艹冂丨󰀬
䛵	言爫冖又
瞎	目宀三口
轏	車尸子子
鞎	廿󰀜艮󰁶
徶	彳㡀攵󰁶
㽏	氵人一甘
住	亻丶王󰀝
彏	弓目目又
枎	木夫󰁶
䣝	尸土丿阝
芖	艹大󰁧
巏	山艹口󰁷
劏	⺌冖口刂
㷂	匚丨󰁃火
㽶	疒己󰁫
䜵	一口䒑皮
潶	氵󰀹土灬
蜵	虫󰀲一󰀝
鯻	󰁢灬木刂
霵	󰀙口耳丶
壧	土口口攵
掺	扌厶大彡
寻	彐寸󰁧
莺	艹冖勹一
玺	⺈小王丶
㰻	士口䒑人
䑺	丿󰁪几虫
笁	⺮工󰀘
蕎	艹丿大口
苖	艹由󰀘
㩽	木口十又
䝵	貝甫󰁶
靵	廿󰀜󰁈一
蝎	虫日勹󰄃
睎	目乂丨
粫	米丆冂〢
龏	立月一廾
侏	亻󰅎󰅇󰁶
㾏	疒土土󰀌
澏	氵口口山
坎	土⺈人󰁶
䄧	禾乃󰁥
奵	女丁󰀢
嵏	山乂凵夂
寠	宀󰀻女󰀘
孏	女艹門󰀹
慺	忄󰀻女󰀝
䞵	土󰁾又又
繒	糹丷󰀺日
鏺	釒癶弓又
䐗	月土丿日
茖	艹夂口󰀘
㕬	口八厶󰁶
宻	宀又丷山
殻	士冖几又
珺	王󰁬丿口
讻	讠乂凵󰀢
檕	車凵几木
涗	氵八口儿
䯻	󰂞彡丿口
㯻	一口丨木
刴	乃木刂󰀢
补	衤󰁧卜󰁶
釲	釒巳󰁀
躌	口止𠂉㐄
頎	斤丆貝󰁶
縇	糹宀一一
翏	羽人彡󰁣
迏	大丶辶󰀦
忏	忄丿十󰀢
栎	木丿󰄃小
㿏	疒󰁬丿羊
俏	亻⺌月󰀝
䣽	𠂉大口一
蔏	艹亠丷口
殈	一夕丿皿
䇴	⺮西󰀘
㮈	木大二小
䑖	臼一󰁬󰁾
荴	艹扌夫󰁧
荵	艹刀丶心
魻	󰁢灬甲󰀢
茺	艹亠厶儿
筻	⺮一日乂
死	一夕匕󰁫
㥬	忄亠丷方
湆	氵立曰󰀝
佅	亻未󰁶
䮉	󰀋灬𠂉󰀕
莋	艹亻𠂉二
瑏	王宀八丿
㮻	木又丶虫
䮻	󰀋灬士寸
䑏	月艹口󰁷
㱈	木木二人
癪	疒禾貝
莔	艹囗八ㄇ
栞	一干木
韎	󰁆口㐄木
蟎	虫廿冂丶
矎	目⺈ㄇ夂
柎	木亻寸󰁶
城	土厂𠃌丶
䟎	土󰁾夫貝
㟎	山爫女󰀝
䨴	󰀙业丷寸
娴	女门木󰁶
砋	石止󰀝
㨴	扌十早乙
䒎	艹犬廾巴
咎	夂卜口󰀘
汏	氵大󰁶
璎	王贝贝女
蒎	艹氵⺁󰀕
钎	钅丿十󰀢
䭗	人良立儿
玳	王亻󰀁丶
蒏	艹冖西一
氈	亠囗口毛
璏	王彑󰁴匕
䰈	󰂞彡⺶工
䪵	󰀄亅丿貝
䋝	糹󰀧女󰀝
㮧	木󰁞灬󰁶
菋	艹口未󰁧
筡	⺮人一朩
緓	糹艹ㄇ大
䘪	衤󰁧亠儿
鷎	白大十灬
跎	口止宀匕
疍	乛󰁾曰一
斍	文目儿󰀅
喍	口止匕木
䖍	虍攵󰀦
㷎	火日勹󰄃
汫	氵二󰀯󰀢
菻	艹木木󰁧
姴	一夕刂女
䧴	十又亻󰁷
㑎	亻巛山󰀢
菤	艹丷夫⺋
呎	口尸󰂃󰁶
觴	⺈用𠂉󰁤
瑎	王󰁴匕白
摎	扌羽人彡
鲏	󰁢󰀞皮󰁶
貏	豸白丿十
梵	木木几丶
菫	艹一口
耎	丆冂〢大
瀎	氵艹罒人
逎	西一辶󰀌
孇	女亻󰁷又
菵	艹冂䒑󰄃
莻	艹乃口匕
屶	山刀󰁣
鎻	釒巛貝󰁶
菾	艹一大⺗
䀥	目丿󰄃小
镍	钅丿目木
䜘	言艹勹攵
畍	田人󰀯󰀢
踎	口止丆口
帎	冂丨冖󰁜
渎	氵十乛大
㸎	火耳耳耳
与	一ㄅ一󰀌
緬	糹丆囗二
痜	疒禾几󰁫
闠	門口丨貝
㪴	二儿󰁦十
䪴	冖󰁜丆貝
媴	女土口󰀔
攎	扌虍田皿
甎	一曰丨丶
䳏	土土󰁟灬
骴	󰀾月止匕
㳴	氵心丿土
䑻	丿󰁪方子
賏	貝貝󰁶
锎	钅门一廾
葻	艹几丿虫
㬴	月󰁺八󰁶
萯	艹⺈貝󰁧
㖾	口口䒑丿
㦟	豸日土心
䡜	車土八土
搻	人一口手
萻	艹立曰󰀘
鐻	釒虍一󰀓
阍	门󰁚弋日
溿	氵田丷󰀟
葄	艹月𠂉二
济	氵文󰀯󰀢
嵎	山曰冂丶
赎	贝十乛大
瘍	疒曰一󰁤
䄝	礻󰁶三臼
礢	石䒑夫艮
䘍	艹日冂虫
㵎	氵門月󰀝
㓎	冫彐冖又
篩	⺮丿󰃧丨
婴	贝贝女󰀘
䩴	廿󰀜古月
穴	宀八󰁧
擎	艹勹口手
驴	󰀊󰀞丶尸
詴	言月󰀝
権	木𠂉一󰁷
鈐	釒人丶乛
铎	钅又󰀟󰀢
蓎	艹广󰁬口
葝	艹一巛力
葦	艹󰁆口㐄
葧	艹十冖力
胻	月彳一丁
䡴	車立日土
弝	弓巴󰁀
羋	丨一丨󰀟
㜺	女丿土貝
鶎	宀二小灬
㛦	女木木󰁶
龗	󰀙口口三
蜏	虫禾乃󰁥
嗍	口䒑凵月
涎	氵丿止廴
痍	疒一弓人
藍	艹匚丨皿
䶈	臼󰁐󰁦寸
䈠	⺮爫一又
㗍	口禾日󰀝
䗍	彑󰀓虫󰁧
朄	曰丨木󰀹
䑹	丿󰁪宀又
蒚	艹一口丨
䟬	口止丘󰀝
蒠	艹丿目心
蒢	艹阝人朩
蒤	艹氵人朩
蒦	艹亻󰁷又
霴	󰀙二厶氺
蒧	艹戊󰀥口
爻	乂乂󰁧
軵	車亻寸󰁶
刻	亠ㄥ丿刂
朴	木卜󰁶
㻵	王尸子子
䜴	一口䒑又
湈	氵甘木󰁶
䅻	禾亠乂厶
䙏	衤󰁧甫寸
蒪	艹甫寸󰁧
蒫	艹⺶工󰀘
捙	扌車󰀢
燁	火艹一󰀟
㫒	日廾󰀬
媧	女ㄇ󰁈口
䠳	丿󰀽三山
舃	臼一ㄅ灬
琲	王丨三三
蓅	艹氵亠󰀸
奡	丆目大󰀯
蚏	虫月󰀝
儻	亻⺌冖灬
㚏	大廾󰀬
䈷	⺮木夂口
㿵	皮丆冂大
蓗	艹彳土󰁾
櫈	木癶一几
燏	火󰁻乛口
蓜	艹西一己
蓞	艹爫臼󰀘
歴	厂木木止
鼵	臼󰁐󰁦犬
蛴	虫文󰀯󰀢
缵	纟丿土贝
更	一日乂󰀦
围	囗二𠃌丨
䉻	米󰁚󰀁󰁀
㛴	女巛丿乂
㗻	口ㄇ󰁈辶
㦡	忄白幺木
蓧	艹亻丨朩
蓩	艹󰁻乛力
蓫	艹一󰀓辶
洏	氵丆冂〢
疻	疒口八󰀦
䲘	󰁢灬⺮󰃧
䇫	⺮匚丨丨
鬪	丨王王寸
蓺	艹土八丶
䖻	虫亠厶󰀸
䗠	方𠂉乛虫
祩	礻󰁶丿未
䈏	⺮一口田
煏	火一口田
歈	人一月人
孈	女山亻口
䍿	羽王󰀘
蔖	艹虍󰀐一
媕	女人一廾
櫴	木木口貝
蔞	艹󰀻女󰀘
蔢	艹氵皮女
罵	罒󰀋灬󰁧
轵	车口八󰁶
鞴	廿󰀜󰁺用
蔣	艹爿󰁝寸
㞴	山󰁚󰀁󰁀
併	亻䒑廾󰀢
垴	土亠乂凵
枴	木口刀󰁥
蔥	艹丿囗心
蔩	艹宀一八
瘻	疒󰀻女󰀌
欈	木山亻口
醏	西一土日
䪝	󰁆口㐄又
蕄	艹門心󰁧
㩦	扌亻󰁷口
籝	⺮󰄹月丶
敘	人一朩攵
䋻	糹十冂十
㿈	疒󰁲丿󰁷
䌓	𠂉母几小
欵	匕𠂉大人
厼	厶小󰁧
蕜	艹丨三心
鋻	匚丨󰁃金
萹	艹丶尸艹
蕥	艹󰀄亅󰁷
蕦	艹彡丆貝
蕧	艹彳𠂉夂
祑	礻󰁶丿夫
蕪	艹𠂉一灬
䊻	糹⺈人󰁶
臻	一厶土禾
燻	火丿一灬
蕮	艹臼勹灬
靴	廿󰀜亻ヒ
侵	亻彐冖又
㝴	二儿寸󰀦
杴	木⺈人󰁶
击	󰀟凵󰀬
㵞	氵禾火心
蕶	艹󰀙人󰁻
犻	犭󰁥一丨
薂	艹白方攵
薉	艹止戊󰀤
薊	艹󰁢灬刂
䤏	西一丨手
椏	木一󰀚一
䖯	土土虫󰁧
淴	氵勹󰁤心
䪩	立日人乛
薘	艹土羊辶
薙	艹𠂉大󰁷
㗲	口󰁬土一
㚐	大大󰁧
薝	艹⺈厂言
抎	扌二厶󰁶
犎	土土寸󰀟
贻	贝厶口󰀝
驏	󰀋灬尸子
薟	艹人一人
薢	艹⺈用󰀟
邎	󰁝言丿辶
肎	冖月󰀘
䂎	󰁻乛亅貝
䌻	纟羽󰀝
璂	王󰀎八土
紏	糹󰁦十󰀢
錻	釒一󰀁丶
㩏	扌󰀹土灬
䩏	丆囗〢人
婏	女⺈口丶
㳾	氵⺶乚󰁀
薺	艹󰀴󰀳󰀘
聎	耳儿󰀪󰁶
過	ㄇ󰁈冂辶
墏	爿󰁝寸土
㫘	丆卜日󰀘
滻	氵立丿
藄	艹󰀎八小
㵻	氵月臼又
䄦	禾了󰀢
藊	艹禾丶艹
簮	⺮夫夫曰
町	田丁󰀢
浻	氵冂八口
嵻	山广󰁬氺
䵻	目󰁕丆彐
钺	钅一󰁐丶
蒺	艹疒𠂉大
骏	󰀊󰀞厶夂
誏	言丶艮󰁶
唘	石又口󰀘
藖	艹匚丨貝
藘	艹虍田心
㖐	口口󰁬丿
藝	艹土八厶
鏟	釒立丿
䏟	月心丿󰁥
珟	王几一夕
㪏	白丿十又
藥	艹白幺木
剎	乂木丶刂
䪏	󰁆口㐄人
藦	艹广木手
藪	艹󰀻女攵
藬	艹阝口貝
藭	艹宀八弓
漎	氵彳人󰁾
㳂	氵八厶󰁶
藺	艹門亻󰁷
藽	艹立朩儿
鐟	釒夫夫日
㴻	氵一口寸
琟	王亻󰁷󰀝
蘄	艹口口斤
活	氵丿古󰀝
畺	一田一一
䕺	艹业丷又
啺	口曰一󰁤
茎	艹ス工󰀘
铺	钅一月丶
挎	扌大二ㄅ
猎	犭ノ󰁺日
䐔	月丶尸艹
㼡	丿未一丶
蘔	艹匕禾貝
橫	木廿一八
蘙	艹匚𠂉羽
蘝	艹人一人
蘞	艹人一攵
蘟	艹阝爫心
䌎	田夂口小
匎	勹大曰乚
鍟	釒日丿
㫏	方𠂉覀女
䍟	罒乂凵夂
蘨	艹爫𠂉小
紽	糹宀匕󰁀
蘬	艹丿󰃧丨
蘭	艹門木󰀹
㒏	亻宀󰀀󰁦
䥚	几目目金
媥	女丶尸艹
蘿	艹罒糹󰁷
詮	言人王󰀝
㳻	氵󰁺日󰀝
虄	艹虫夂
峻	山厶八夂
䒺	艹幺小󰁧
璺	󰀗ㄇ一丶
撺	扌宀八丨
鬏	󰂞彡禾火
苎	艹宀一󰀘
狎	犭ノ甲󰀢
拎	扌人丶󰁻
莟	艹人丶口
虊	艹言糹木
虌	艹㡀攵黽
㪙	日木攵󰁶
鼡	󰀧几󰀟󰀬
䟨	口止󰁂󰀁
櫝	木士罒貝
虘	虍󰀐一󰀌
嬏	女丿米田
䋎	糹日一󰀝
㬏	日一口丨
虜	虍田力󰀏
虝	虍几勹󰁤
號	口一ㄅ几
䱡	󰁢灬勹米
虤	虍几虍几
虥	虍几戈戈
虦	戈戈虍几
䋟	糹己心󰁶
狟	犭󰁥一一
虧	虍亻󰁷ㄅ
紦	糹巴󰁀
虪	虍几亻灬
㓺	虍文刂󰀢
䓺	艹丷王大
哺	口一月丶
治	氵厶口󰀝
粻	米󰀍󰀖󰁶
礴	石艹氵寸
耻	耳止󰀝
头	󰁦大󰀦
掎	扌大丁口
㤴	忄耳乚󰁀
䤴	釒了󰀪凵
泤	氵󰁐丶人
䄽	禾西󰀝
虲	虫卜󰁶
纟	纟ㄥㄥ󰀞
嗩	口⺌貝󰁶
泘	氵丿丷󰀛
玎	王丁󰀢
莎	艹氵小丿
魏	禾女白厶
蚄	虫方󰁥
蚅	虫厂⺋󰁀
䐠	月艹亠󰀸
㮘	木󰁻乛攵
䌟	糹尸口辛
匟	匚亠几󰁫
猟	犭󰁥󰀧󰀟
粠	米󰁺八󰁶
蚎	虫日󰀝
䱠	󰁢灬戈戈
蚘	虫乚丶
蚙	虫人丶乛
蚞	虫木󰁶
蚟	虫王󰀝
饴	⺈󰁐厶口
雝	巛口巴󰁷
蚥	虫八乂󰁶
聻	氵車斤耳
磴	石癶一䒑
捎	扌⺌月󰀝
壴	土口䒑󰀘
䣴	西一乂儿
㣴	彳󰁺由八
䉟	⺮扌亻又
鉟	釒丆卜一
洡	氵二木󰁶
冸	冫丷󰀟󰀢
蚲	虫一丷十
䅄	禾力力力
荎	艹一厶土
箏	⺮爫󰁬亅
廮	广貝貝女
鍎	釒⺁十目
蚽	虫丆卜一
蚾	虫皮󰁶
弨	弓刀口󰀝
籟	⺮木口貝
羠	⺶一弓人
蛒	虫夂口󰀝
猤	犭󰁥癶大
錤	釒󰀎八󰁶
䆮	宀八氵又
蛝	虫艮󰁶
䌤	糹一八乂
滅	氵戊一火
吙	口火󰁶
狤	犭󰁥士口
逻	罒夕辶󰀦
鋤	釒󰀐󰀞力
寏	宀⺈ㄇ大
榴	木󰁚丶田
㐎	文乙󰀅
䯏	󰀾月丿古
㲟	艹ㄇ大毛
鷿	尸口辛灬
㦴	戈夂口󰀌
䦴	門罒土十
蜄	虫厂二󰀖
㒫	一丨二儿
稫	禾一口田
㘟	囗廾󰀵
鯏	󰁢灬禾刂
缽	𠂉十凵一
篏	⺮甘⺈人
诏	讠刀口󰀝
䳱	󰁻乛亅灬
勸	艹口口力
莤	艹西一󰀘
蜙	虫木八厶
蜦	虫人一艹
蜧	虫丶尸犬
䲜	󰁢灬󰁢灬
蜪	虫勹𠂉凵
䎤	二木尸口
務	󰁻乛亅力
蜯	虫三人󰀟
㐋	土乙󰀅
鍤	釒丿十臼
獤	犭󰁥󰁸攵
蜼	虫亻󰁷󰀝
醄	西一勹凵
氏	󰁚弋󰁫
奴	女又󰁶
襴	衤󰁧門󰀹
㰏	木⺮󰁸口
饯	⺈󰁐二丶
糪	尸口辛米
䥴	釒山亻𠃌
㥴	忄⺁虍几
䍤	罒󰀴󰀳󰀘
屄	尸宀八󰀦
毠	力口毛󰀅
舤	丿󰁪几丶
爤	火艹門󰀹
鰏	󰁢灬一田
谏	讠一󰀹󰅇
珎	王⺈小󰁶
鈤	釒日󰀝
蝜	虫⺈貝󰁶
蝝	虫彑󰀓󰁶
碐	石土八夂
蝫	虫土丿日
蝬	虫乂凵夂
儩	亻貝日󰁤
蝱	亠󰄃虫虫
蝲	虫木口刂
䈤	⺮木甘󰀘
燤	火艹曰丶
臤	匚丨󰁃又
馴	󰀋灬川󰀢
釤	釒彡󰁥
䦥	門木木󰀦
䝩	貝人彡󰁥
頪	米丆貝󰁶
蠪	立月一虫
砪	石母󰁶
株	木󰅎󰅇󰁶
螌	丿󰁪几虫
紀	糹己󰁀
祬	礻󰁶一土
螐	虫󰁞灬󰁶
僎	亻巳巳八
㙥	土六口󰀔
犤	牜罒厶匕
醍	西一日󰁾
觎	人一月󰁜
䠪	口止幺󰄃
槎	木䒑󰀠工
姎	女ㄇ大󰁶
銤	釒米󰁶
螜	士冖一虫
螧	虫土丿日
䔓	艹言𠂉十
螪	虫亠丷口
掫	扌耳又󰁶
慟	忄丿一力
螰	虫󰁙󰁴匕
䃐	石宀八犬
㦱	一戈土󰀌
螴	阝木曰虫
牤	牜亠󰄃󰁀
艤	丿󰁪丷丶
剤	文󰀳刂󰀢
邴	一冂人阝
祫	礻󰁶人口
鄩	彐工口阝
汿	氵󰁻乛亅
䕹	艹亠人󰁷
螾	虫宀一八
﨎	文亻󰁷又
棪	木火火󰁶
焩	火月月󰀝
脩	亻丨夂月
蟇	艹曰大虫
蟌	虫丿囗心
配	西一己󰁀
䄩	禾󰀁丶󰁶
税	禾丷口儿
討	言寸󰁶
免	⺈口󰁜󰀅
樎	木宀亻日
䧎	阝口月󰀝
㧎	扌󰀄亅丿
缿	𠂉十凵口
憏	忄󰁯二小
蟖	虫󰀎八斤
蟗	一口丨虫
蟘	虫亻󰀁貝
蟙	虫亠丷日
蟚	士口䒑虫
蟜	虫丿大口
蟞	㡀攵虫󰁧
㶢	火九󰀅
榊	木礻󰁶丨
耞	二木力口
蟦	虫十艹貝
䄤	礻󰁶木貝
怞	忄由󰀝
酩	西一夕口
蟧	虫火火力
㣥	彳亻土寸
梪	木一口䒑
墪	󰁸孑攵土
腩	月十冂十
煩	火丆貝󰁶
蟬	虫口口十
鈍	釒一凵乚
䅩	禾十又八
㢪	弓二ㄅ󰁀
戍	厂丶󰅅丶
刍	⺈彐󰀘
舍	人干口󰀘
爍	火白幺木
㨎	扌丆冂大
䅍	禾丿士廴
蟱	虫𠂉一灬
蟴	󰀎八斤虫
蟷	虫⺌冖田
㥦	匚大人心
蟽	虫土羊辶
蟿	車凵几虫
郤	八人口阝
䃤	石󰁬十󰀲
僤	亻口口十
蠅	虫黽󰀝
偄	亻丆冂大
礄	石丿大口
跈	口止人彡
蠔	虫󰁸冖󰀓
蠘	虫十戈󰁷
蠙	虫宀一貝
饪	⺈󰁐丿士
醤	丬爫寸一
炩	火人丶󰁻
肩	丶尸月󰀌
傩	亻又亻󰁷
楪	木廿󰄃木
重	丿一日土
䂩	石囗大󰁶
䆤	宀八丿丿
㥥	忄日冂丶
妎	女人󰀯󰀢
懍	忄亠囗禾
燍	火󰀎八斤
覎	目儿子󰀌
蠤	丷西一虫
蠥	凵丿丿虫
䥎	釒厂二月
㥎	禾勹丿心
緁	糹一󰁬󰁾
蠭	夂三丨虫
氱	气曰一󰁤
獱	犭󰁥宀貝
䮬	󰀋灬艹大
蠳	虫貝貝女
腤	月立日󰀝
慤	士冖几心
䅤	禾丿十臼
兤	⺌一儿八
㦥	忄宀三心
衁	亠󰄃丿皿
衃	丿皿丆卜
衆	丿皿乑󰁧
衇	丿皿⺁󰀕
餪	人良丆大
褪	衤󰁧彐辶
烩	火人二厶
惩	彳一止心
太	大丶󰀦
䃩	石ㄇ󰁺󰀖
㤪	一夕⺋心
衎	彳干一丁
衑	彳人丶丁
衒	彳亠幺丁
術	彳木丶丁
耤	二木󰁺日
衖	彳󰁺八丁
碍	石日一寸
梍	木白七󰁀
墍	白匕󰀄土
䁌	目田月󰀝
衘	彳𠂉一丁
䰭	丆冂〢厶
颍	匕水丆贝
袍	衤󰁧勹巳
衛	彳󰁆口丁
衜	彳䒑丿丁
衝	彳丿一丁
怤	亻寸心󰁧
衞	彳󰁆口丁
衟	彳巛丆丁
衠	彳十󰀣丁
衦	衤󰁧干󰀢
衧	衤󰁧一󰀛
畇	田勹冫󰀝
霟	󰀙氵󰁺八
衯	衤󰁧八刀
夋	厶八夂󰁧
惚	忄勹󰁤心
衳	衤󰁧八厶
衴	衤󰁧冖󰁜
衵	衤󰁧日󰀝
衶	衤󰁧口丨
䜟	言十戈󰀞
衻	衤󰁧冂二
㢍	广艹ㄇ大
氜	气日󰀌
㯤	木人人人
袆	衤󰁧二丨
桍	木大二ㄅ
炌	火人󰀯󰀢
䡍	車夫󰁶
塍	月䒑大土
袇	衤󰁧󰀼亠
袉	衤󰁧宀匕
肌	月几󰁀
邌	禾勹丿辶
䘩	衤󰁧勹日
巪	匚󰁃󰁈󰀅
昩	日一木󰁶
瘩	疒艹人口
跪	口止⺈⺋
阩	阝丿廾󰀢
邤	斤阝󰀢
袎	衤󰁧幺力
袐	衤󰁧心丿
袑	衤󰁧刀口
袓	衤󰁧󰀐一
袔	衤󰁧丁口
悤	丿囗夕心
袕	衤󰁧宀八
袗	衤󰁧人彡
袘	衤󰁧𠂉也
袙	衤󰁧白󰀝
袚	衤󰁧丶
袛	衤󰁧󰁚丶
袝	衤󰁧亻寸
袟	衤󰁧丿夫
㡍	白大冂丨
袠	亠丿夫󰀔
袡	衤󰁧冂土
复	𠂉日夂󰁧
䃌	石覀土󰀝
烌	火亻木󰁶
植	木十󰀣󰀝
餍	厂犬人艮
背	丬匕月󰀘
㙩	土大丷小
袣	衤󰁧廿󰄃
噩	王口口口
䙩	衤󰁧艹󰀓
綪	糹月󰀝
涪	氵立口󰀝
险	阝人一一
趪	土󰁾󰁺八
袧	衤󰁧勹口
郼	󰁆口㐄阝
袩	衤󰁧󰀥口
袪	衤󰁧土厶
袮	衤󰁧𠂉小
㿦	士󰁅几白
䁤	目亠丷古
袯	衤󰁧ㄥ丶
䉳	⺮󰁢灬羊
袳	衤󰁧夕夕
袴	衤󰁧大ㄅ
袵	衤󰁧亻士
袶	衤󰁧夂㐄
袸	衤󰁧子
袹	衤󰁧丆日
袺	衤󰁧士口
㤍	工一ㄅ心
翎	人丶󰁻羽
䣍	大日󰁐阝
壍	氵車斤土
棍	木日󰁴匕
磍	石宀三口
裍	衤󰁧囗木
鄌	广󰁬丨阝
袾	衤󰁧丿未
懞	忄艹冖󰀓
斩	车斤󰀢
疩	疒九十󰀵
乪	乙田󰀌
喩	口人一巜
裀	衤󰁧囗大
䇞	⺮甘󰀘
蹪	口止口貝
鹪	亻󰁷灬一
㨪	扌日⺌儿
裃	衤󰁧上卜
裇	衤󰁧丿皿
㖝	未口匕󰀅
稪	禾𠂉日夂
横	木󰁺由八
娪	女五口󰀝
䇩	⺮日󰁒丿
裏	亠曰土󰀔
裐	衤󰁧口月
騪	󰀋灬臼又
臩	󰁃丨匚󰀯
裑	衤󰁧丿丿
裓	衤󰁧戈廾
裖	衤󰁧厂󰀖
裗	衤󰁧亠󰀸
爞	火虫虫虫
鞍	廿󰀜宀女
迎	󰁚卩辶󰀵
瞍	目臼丨又
濎	氵目󰁕󰁈
垍	土丿目󰀝
俎	人人󰀐一
㞍	尸九丶󰀦
裛	󰁸巴󰀔󰁧
䈞	⺮亠口日
補	衤󰁧甫󰁶
裝	爿士亠󰀔
裞	衤󰁧丷儿
裡	衤󰁧曰土
裦	亠亻二󰀔
裧	衤󰁧火火
㫪	三人丨日
䫪	大乂乂貝
嫪	女羽人彡
櫪	木厂禾止
裪	衤󰁧勹凵
裫	衤󰁧󰀲一
裬	衤󰁧土夂
裭	衤󰁧虍几
裮	衤󰁧日曰
裯	衤󰁧󰀼口
裲	衤󰁧一丶
兞	古儿毛󰁫
猩	犭ノ日主
茩	艹⺁一口
髪	󰂞彡又
裵	亠丨三󰀔
靍	󰀙亻󰁷灬
裶	衤󰁧丨三
睍	目目儿󰁀
蝍	虫󰁮卩󰀢
坍	土󰀼亠󰀝
杍	木子󰀝
㝍	宀一ㄅ一
䝍	一󰀓冖車
傓	亻丶尸羽
製	𠂉一冂󰀔
裿	衤󰁧大口
褀	衤󰁧󰀎八
顙	又又又貝
褃	衤󰁧止月
褄	衤󰁧一󰁬
褅	衤󰁧亠丨
䪪	力口立日
㪪	一大丨又
捩	扌丶尸犬
卩	卩𠃌丨
褉	衤󰁧三大
褋	衤󰁧廿木
褍	衤󰁧山〢
醞	西一囗皿
冞	冖米󰁧
䆞	宀八日匕
褏	亠亻二󰀔
褑	衤󰁧爫又
荩	艹尸󰂃󰁦
獩	犭󰁥止󰀤
褕	衤󰁧人刂
鍩	釒艹口
蠍	虫日勹人
砍	石⺈人󰁶
褖	衤󰁧彑󰀓
齎	󰀴󰀳貝󰁧
低	亻󰁚󰀁丶
㠍	山亻󰁷木
栍	木丿󰀝
堍	土⺈口丶
褝	衤󰁧󰀧十
褞	衤󰁧曰皿
褟	衤󰁧曰羽
褠	衤󰁧󰀀土
沉	氵冖几󰁀
褤	衤󰁧土󰀔
褦	衤󰁧厶匕
惥	臼人心󰁧
助	󰀐󰀞力ノ
歪	丆卜一止
㭪	木甫󰁶
䊩	米丿米田
褬	衤󰁧又木
褯	衤󰁧广丨
倜	亻󰀼土口
褳	衤󰁧車辶
褵	衤󰁧亠厶
褷	衤󰁧彳󰁾
褸	衤󰁧󰀻女
褹	衤󰁧土丶
銩	釒丿土厶
褻	亠土八󰀔
筪	⺮匚甲󰀬
芩	艹人丶乛
美	丷王大󰁧
而	丆冂〢󰀬
龎	厂立月三
㸭	牜巴󰁀
㟍	山丶艮󰁶
䟍	土󰁾丿方
倌	亻宀丨󰁃
澎	氵士口彡
褽	尸二小󰀔
褾	衤󰁧覀小
褿	衤󰁧一日
襀	衤󰁧貝
襂	衤󰁧厶彡
襃	亠亻二󰀔
䗥	虫彳人󰁾
㣟	彳士口󰀝
择	扌又󰀟󰀢
嬪	女宀一貝
䬪	人良丆卜
㬪	日日日彑
忣	忄乃󰂃󰁶
襊	衤󰁧曰又
襋	衤󰁧木冂
襌	衤󰁧口十
襍	衤󰁧亻木
襎	衤󰁧丿田
襏	衤󰁧癶又
襐	衤󰁧⺈󰀓
襑	衤󰁧彐寸
鋩	釒艹亠󰄃
謪	言亠丷口
狩	犭ノ宀寸
襒	衤󰁧㡀攵
襓	衤󰁧土儿
鉴	〢𠂉丶金
襕	衤󰁧门󰀹
襖	衤󰁧丿大
襗	衤󰁧罒十
襘	衤󰁧人日
襙	衤󰁧口木
廎	广󰁴丆貝
从	人人󰁶
㻎	大王王󰀌
襛	衤󰁧ㄇ󰀖
黎	禾勹丿氺
蚍	虫󰁴匕󰁀
绎	纟又󰀟󰀢
滎	火火冖水
怩	忄尸匕󰁀
羫	⺶宀八工
辫	辛纟辛󰀢
韪	日一󰁾丨
襜	衤󰁧⺈言
襝	衤󰁧人人
聞	門耳󰀌
遞	⺁虍几辶
襡	衤󰁧罒虫
襢	衤󰁧亠一
襣	衤󰁧丿󰀯
襤	衤󰁧匚皿
襥	衤󰁧亻夫
㾫	疒丶尸艹
䟪	口止丿之
倩	亻主月󰀝
讝	言口口攵
襪	衤󰁧艹人
襫	衤󰁧大日
襬	衤󰁧罒匕
嫿	女󰁬土一
襮	衤󰁧曰氺
襯	衤󰁧立儿
襰	衤󰁧木貝
伎	亻十又󰁶
噍	口亻󰁷灬
襱	衤󰁧立三
㼎	⺁厶󰂃乂
虍	󰅋七󰁫
鼎	目󰁕丆󰁈
晍	日冂一口
癍	疒王文王
灩	氵山三皿
枪	木人⺋󰁀
鞪	󰁻乛亅󰀜
聩	耳口丨贝
襳	衤󰁧人󰀞
襵	衤󰁧耳耳
䙥	衤󰁧󰀙󰁻
㡟	冂丨一日
襶	衤󰁧十八
襷	衤󰁧󰀗手
肞	月丶乂󰁶
傞	亻⺶工󰀝
㞪	󰁭山󰀬
襹	衤󰁧一匕
快	忄ユ人󰁶
俫	亻一丷木
襺	衤󰁧艹虫
邞	夫阝󰀢
毄	車口几又
襽	衤󰁧艹󰀹
叞	尸二小又
見	目儿󰀅
㰟	气⺈人󰁶
覑	丿丨一儿
㜍	女广󰁬口
覒	毛目儿󰁀
幎	冂丨冖六
乎	丿丷󰀛󰀵
眍	目匚乂󰁶
湎	氵丆冂三
霍	󰀙亻󰁷󰀘
蜍	虫人一木
衪	衤󰁧也󰁀
顪	止戊一貝
桪	木彐寸󰁶
硪	石丿扌丶
視	礻󰁶目儿
覛	⺁󰀕目儿
覜	儿󰀪目儿
覟	士心目儿
覤	虍几目儿
覥	ㄇ󰁺八儿
覦	人一月儿
㶦	火󰁻乛亅
䡪	車丶尸羽
塪	土爫臼󰀝
覩	土丿日儿
㡪	冂丨爫夂
詥	言人一口
覫	亠丷冖儿
覰	虍󰀐󰀞儿
観	𠂉一亻儿
覹	目儿彳攵
覺	󰀗乂乂儿
覽	匚丨󰁃儿
鍞	釒󰀥貝󰁶
獞	犭󰁥立土
㛍	女大人人
于	一󰀛󰀵
囍	士口䒑口
溎	氵木土土
盍	土厶皿󰀘
躎	口止一乂
雍	亠󰁲丿󰁷
蕌	艹日日日
界	田人󰀯󰀬
敌	丿古夂󰁶
嶍	山羽白󰀝
䶍	一厶土󰀯
㕌	厂日一寸
䍞	冂乂乂󰀞
覿	士罒貝儿
颖	匕禾丆贝
觍	ㄇ󰁺八󰁜
觓	⺈用󰁐丨
觔	⺈用力󰁥
觕	牜⺈用󰀢
玞	王夫󰁶
厞	厂丨三三
觠	丷夫⺈用
觡	⺈用夂口
觧	⺈用羊󰀢
觩	⺈用一丶
觬	⺈用臼儿
勞	火火冖力
拞	扌丘󰀝
觱	戊一口用
觲	⺈用丷󰀟
䜻	一口䒑󰁾
圻	土斤󰀢
觵	⺈用󰁺八
㓍	冫亠厶儿
蜻	虫主月󰀝
响	口丿冂口
鵍	宀二儿灬
瓍	王阝辶
觶	⺈用口十
觷	󰀗乂乂用
觹	⺈用亻𠃌
觺	匕𠂉大用
觻	⺈用白木
殘	一夕戈戈
觽	⺈用山𠃌
訁	言丶一一
訂	言丁󰀢
訃	言卜󰁶
訄	九言󰀌
訅	言九󰁀
訆	言󰁐丨󰀢
計	言十󰀢
訉	言几丶󰁶
䫟	口貝丆貝
匞	匚工󰀌
茞	艹匚丨丨
冲	冫口丨󰀢
訌	言工󰀝
訍	言又丶󰁶
訏	言一󰀛󰀢
訐	言干󰀢
訑	言也󰁀
㛻	女大土土
訒	言刀丶󰁶
囻	囗󰁂󰀁󰁫
䛻	言⺁十目
盻	目八一ㄅ
曻	曰夕㐄󰀬
電	󰀙曰乚󰀅
镌	钅亻󰁷乃
渍	氵主贝󰁶
嗌	口䒑八皿
藌	艹宀心虫
痌	疒冂一口
泷	氵ヒ丶
記	言己󰁀
不	丆卜󰀦
㗌	口宀一土
訙	言九丶󰁶
訚	门言󰀌
訛	言亻ヒ󰁀
訜	言八刀󰁥
訝	言󰀄亅丿
訞	言丿大󰁶
訟	言八厶󰁶
訠	言弓丨󰀢
訡	言人丶乛
訢	言斤󰀢
訣	言ユ人󰁶
扞	扌干󰀢
鉞	釒戈󰁐󰁀
訥	言冂人󰁶
牞	牜力󰁥
艞	丿󰁪⺮󰀪
訦	言冖󰁜󰁀
㚻	田女󰀘
䚻	󰁝言󰀘
嚻	口口丆口
暻	日曰󰁸小
皻	虍󰀐󰀞皮
蚻	木乚虫󰁧
隻	亻󰁷又󰁧
絍	糹亻丿士
赍	十人人贝
嵍	󰁻乛亅山
斌	文二止丶
㖌	亻九口匕
䖌	虍几刂󰀢
顋	田心丆貝
訰	言一凵乚
許	言𠂉十󰀢
訲	言口丨󰀢
訳	言尸󰂃󰁶
訴	言斤丶󰁶
訵	言四󰀝
訶	言丁口󰀝
訷	言曰丨󰀢
訸	言禾󰁶
訹	言木丶󰁶
鈺	釒王丶󰁶
軴	車丶王󰀝
维	纟亻󰁷󰀝
滴	氵亠丷古
廴	廴󰁌󰂃
䩻	廿󰀜󰀋灬
㻴	王日罒又
診	言人彡󰁥
註	言丶王󰀝
殯	一夕宀貝
訽	言勹口󰀝
䑥	丿󰁪乃󰂃
鸍	一八冂灬
芞	艹气󰀅
犞	牜丿大口
詀	言󰀥口󰀝
詁	言古󰀝
钍	钅土󰀝
蒍	艹丶丿灬
鰶	󰁢灬󰁯小
詃	言亠幺󰁶
詄	言丿夫󰁶
詅	言人丶󰁻
詆	言󰁚󰀁丶
詇	言ㄇ大󰁶
詉	言女又󰁶
詊	言丷󰀟󰀢
詋	言口儿󰁀
詌	言甘󰀝
詍	言廿󰄃󰁀
謢	言亻󰁷又
騻	󰀋灬大乂
詏	言幺力󰁥
缴	纟白方夂
艺	艹乙󰀅
弴	弓󰁸子󰀝
扺	扌󰁚󰀁󰁀
㨻	車斤手󰀬
伴	亻丷󰀟󰀢
㮎	木丆卜皿
䮎	󰀋灬乂丨
反	⺁又󰀦
揍	扌三人大
詑	言宀匕󰁀
詒	言厶口󰀝
詓	言土厶󰁶
詔	言刀口󰀝
評	言一丷十
詖	言皮󰁶
贎	貝艹曰丶
㧪	扌⺈厂⺋
䧪	阝广大女
利	禾刂󰀢
槪	木白匕󰁜
秪	禾󰁚󰀁丶
觪	⺈用辛󰀢
駪	󰀋灬丿儿
詗	言冂口󰀝
詘	言凵山󰀢
詙	言又丶
詚	言日一󰀝
詛	言󰀐一󰀝
詜	言凵丨又
膺	广亻亻月
移	禾夕夕󰁶
詝	言宀丁󰀢
醺	西一丿灬
佴	亻耳󰀝
㽴	疒󰂃󰀦
潴	氵犭ノ日
姻	女囗大󰁶
㳎	氵厶廾󰀢
詞	言𠃌一口
詟	ヒ丶言
詠	言丶𠃌󰀩
糎	米厂曰土
撍	扌󰀄󰁜日
咍	口厶口󰀝
䳎	臼󰁟灬󰁶
锍	钅亠厶󰀸
豎	匚丨󰁃䒑
㦪	忄言火又
詤	言人󰄃󰀸
妪	女匚乂󰁶
䦪	門日勹󰄃
物	牜勹󰁤ノ
扩	扌广ノ
鉩	釒人小󰁶
親	立朩目儿
試	言󰀁工丶
詧	󰁯言󰀘
詨	言六乂󰁶
詩	言土寸󰁶
詸	言米󰁶
詫	言宀丿七
离	亠乂凵厶
覻	虍一口儿
馻	󰀋灬厶儿
詬	言⺁一口
㾴	疒木日一
䇺	⺮一口䒑
出	凵山󰀵
澴	氵罒一󰀔
詭	言⺈厂⺋
㑍	亻二木󰁶
詯	言丿目󰀝
躅	口止罒虫
洎	氵丿目󰀝
瑍	王⺈ㄇ大
䴎	田田田灬
崎	山大丁口
蓍	艹土丿日
鲎	󰀧冖󰁢一
該	言亠ㄥ人
詳	言羊󰀢
憩	丿古丿心
熩	火丶尸巴
䩪	廿󰀜宀󰃧
婪	木木女󰀘
詶	言丶丿丨
詷	言冂一口
詪	言艮󰁶
驪	󰀋灬一匕
詺	言夕口󰀝
詻	言夂口󰀝
歡	艹口口人
㸍	火虍一戈
翴	羽車辶󰁶
愺	忄艹早󰀢
忴	忄人丶乛
俴	亻戈戈󰁶
詿	言土土󰀝
誀	言耳󰀝
鄺	广󰁺由阝
襻	衤󰁧木手
芴	艹勹󰁤󰁣
簧	⺮󰁺由八
㔍	⺮目廾刂
勥	弓口虫力
屎	尸米󰀦
䔍	艹󰀋灬󰁧
甍	艹罒冖丶
汎	氵几丶󰁶
誄	言二木󰁶
誅	言丿未󰁶
誆	言匚王󰀝
誇	言大二ㄅ
誈	言一厶土
鎍	釒十冖小
诎	讠凵山󰀢
篎	⺮目小丿
狥	犭󰁥勹日
誌	言士心󰁶
瀜	氵一口虫
誎	言木口󰀝
誐	言丿扌丶
誑	言犭󰁥王
誒	言厶𠂉大
誔	言丿士廴
淝	氵月巴󰁀
誖	言十冖子
誗	言禾刂󰀢
誘	言禾乃󰁥
誙	言一巛工
㪎	大人人又
䪎	廿󰀜山口
媎	女土丿日
谣	讠爫󰅎山
誜	言厶八夂
誝	言人丶口
語	言五口󰀝
誟	言土丿子
誠	言戊𠃌󰁀
誡	言戈廾󰀢
誢	言目儿󰁀
誣	言工人人
誤	言口一大
莥	艹犭󰁥一
玥	王月󰀝
鍍	釒广廿又
誦	言󰁻用󰀢
獍	犭ノ立儿
谎	讠艹亠󰀸
誧	言甫󰁶
誨	言𠂉母󰁶
誩	言言󰀝
說	言八口儿
誫	言厂二󰀖
説	言丷口儿
㑏	亻宀寸󰁶
鴼	󰁟灬夂口
誯	言日曰󰀝
誰	言亻󰁷󰀝
誱	言一󰁬󰁾
課	言曰木󰁶
誳	言尸凵山
誴	言宀二小
誵	言乂月
铘	钅󰀂亅阝
掍	扌曰󰁴匕
厍	厂车󰀵
䯎	󰀾月人干
㯎	木言木󰁶
誸	言弓亠幺
誹	言丨三三
誺	言木人人
歶	止匕曰丶
鼯	臼󰁐󰁦口
誾	門言󰀌
獥	犭󰁥白攵
諀	言白丿十
萍	艹氵一十
琍	王禾刂󰀢
奎	大土土󰀘
魎	白󰁜厶丶
諂	言⺈臼󰀝
諃	言木木󰁶
諄	言󰁸子󰀝
諅	󰀎八言󰀘
諆	言󰀎八󰁶
談	言火火󰁶
諈	言丿士󰁺
諉	言禾女󰀝
諊	言勹米󰁶
請	言月󰀝
諌	言木曰󰀝
諍	言⺈󰁬亅
諎	言󰁺日󰀝
諏	言耳又󰁶
諐	亻口󰀸言
諑	言一󰀓丶
導	䒑丿目寸
捍	扌日干󰀢
㰎	木山亻𠃌
䍍	士冖一又
市	亠冂丨󰀬
諕	言虍几󰁀
䓞	艹丶尸犬
舥	丿󰁪巴󰁀
鈥	釒火󰁶
胟	月母󰁶
諘	言󰀔󰁶
諙	言󰁚󰀁日
珍	王人彡ノ
讎	亻󰁷言󰁷
鏍	釒田幺小
諚	言宀一󰁾
諛	言臼人󰁶
諜	言廿󰄃木
諝	言乛󰁾月
諞	言丶尸艹
諟	言日一󰁾
諠	言宀一一
諡	言八一皿
諢	言冖車󰀢
諣	言ㄇ󰁈口
諤	言口口ㄅ
諥	言丿一土
諦	言亠丷丨
諧	言󰁴匕白
諩	言䒑业󰀝
諪	言󰁸冖丁
须	彡丆贝󰁶
耺	耳二厶󰁶
瀺	氵⺈口丶
損	扌口貝󰁶
名	夕口󰀘
䀺	亻丨攵目
㡻	广󰁚丿卩
諬	禾乚丶
諭	言人一刂
諮	言冫⺈口
諯	言山丆〢
㔞	丿十丬力
凥	尸几󰁫
臥	匚丨󰁃人
諰	言田心󰁶
釥	釒小󰁶
諲	言覀土󰀝
銍	釒一厶土
芍	艹勹丶󰁧
犍	牜󰁬󰀟廴
抍	扌丿廾󰀢
諳	言立日󰀝
諴	言戊一口
諵	言十冂十
諶	言󰀎八󰄃
諷	言几丿虫
諸	言土丿日
㦎	忄󰁬土一
䦎	門二儿󰁫
諺	言立丿彡
諻	言白王󰀝
頻	止󰀤丆貝
諽	言廿󰀜󰀢
砻	ヒ丶石
蠻	言糹糹虫
偺	亻夂卜日
恺	忄山己󰁀
㠻	土丿冂丨
䁺	目罒土十
諿	言口耳󰀝
謀	言甘木󰁶
謁	言曰勹󰄃
謂	言田月󰀝
謃	言曰丿
謄	月丷夫言
謅	言勹凵丿
謆	言丶尸羽
謈	曰󰁺八言
謉	言白󰁜厶
謎	言米辶󰁶
鬎	󰂞彡木刂
才	󰀛丿󰀏
牍	丿丨一大
犥	牜󰁙󰁴灬
劥	亠几力󰁥
謊	言艹亠󰀸
謋	言夕㐄木
謍	火火冖言
謏	言臼丨又
謐	言心丿皿
謑	言爫幺大
嫎	女亠丷方
䊍	禾勹丿米
㫎	方𠂉冖車
謔	言虍匚一
査	木󰀐一󰀘
埻	土󰁸子󰀝
蟻	虫丷王丶
矻	石𠂉乙󰁀
謗	言亠丷方
謘	言尸辛󰀢
䟻	口止人朩
㟻	車斤山󰀬
謚	言䒑八皿
講	言󰀀冂土
謜	言厂白小
謝	言丿󰀽寸
謞	言󰁸冂口
謟	言爫臼󰀝
謠	言󰁝𠂉凵
謡	言爫𠂉凵
猍	犭󰁥木人
挍	扌六乂󰁶
錍	釒白丿十
詎	言匚󰁃󰀝
栻	木󰀁工丶
艥	丿󰁪口丶
牥	牜方󰁥
謤	言覀二小
謥	言丿囗心
謨	言艹曰大
謩	艹曰大言
謫	言亠丷古
鞻	廿󰀜󰀻女
前	䒑月刂󰀬
謬	言羽人彡
㬎	日幺幺灬
垻	土貝󰁶
枻	木廿󰄃󰁀
瞻	目⺈厂言
螻	虫󰀻女󰀝
謯	言虍󰀐一
锫	钅立口󰀝
㞻	山口一ㄅ
䞻	土󰁾󰁻力
謲	言厶厶彡
謳	言匚口口
謴	言毌貝󰁶
謵	言羽白󰀝
謶	言广廿灬
謷	󰁡攵言
謸	言󰁡攵
謹	言廿口
檎	木人亠厶
狍	犭ノ勹巳
苍	艹人⺋󰀅
鋍	釒十冖子
謺	土䒑十言
謻	言禾夕夕
謽	弓口虫言
謾	言曰罒又
䟞	口止小丿
儥	亻士罒貝
謿	言十早月
譀	言乛耳攵
㩎	扌日月犬
譁	言艹一󰀟
匍	勹甫󰀦
䩎	丆囗〢人
坻	土󰁚󰀁丶
䝻	貝尸古󰀝
㝻	廿口丿
譃	言虍业󰀝
靻	廿󰀜󰀐一
蝻	虫十冂十
睻	目宀一一
杻	木󰁈丨一
譅	言刀丶止
譆	言士口口
㤩	夂口心󰁧
䅨	禾禾日󰀝
譈	言󰁸孑攵
證	言癶一䒑
藣	艹罒厶匕
譋	言門月󰀝
譌	言爫丿灬
譍	广亻亻󰁷
譎	言󰁻乛口
譏	言幺幺人
譐	言丷西寸
譑	言丿大口
譒	言丿米田
譓	言一曰心
购	贝勹厶󰁶
窘	宀八󰁬口
郥	貝阝󰀢
馍	⺈󰁐艹大
腌	月大日乚
煌	火白王󰀝
榍	木尸⺌月
妍	女一廾󰀢
䃓	石󰀀冂土
㦍	忄口口丿
識	言亠丷日
䦦	門金󰀌
全	人王󰀘
慨	忄彐厶󰁜
煨	火田一󰀖
褩	丿󰁪几󰀔
譙	言亻󰁷灬
譚	言覀早󰀢
㠞	彳山一山
譛	言夫夫日
埩	土⺈󰁬亅
䟩	口止土厶
㟩	󰁂󰀁攵山
㤌	忄甘󰀝
䤌	西一人口
夌	土八夂󰁧
椌	木宀八工
礌	石󰀙田󰀝
褌	衤󰁧冖車
餌	人良耳󰀝
逺	土ㄥ󰀔辶
譤	言白方攵
譥	白方攵言
譧	言广䒑八
譨	言ㄇ󰁺󰀖
譩	言立曰心
譪	言艹曰󰄃
譫	言⺈厂言
譭	言臼工又
杖	木󰂃󰁶
韩	十日十丨
蟩	虫厂䒑人
矩	𠂉大匚󰁃
柩	木匚ク丶
莇	艹󰀐󰀞力
議	言丷王丶
譱	羊言言󰀌
耝	二木󰀐一
㢩	弓勹丶󰁶
䢩	五口攵辶
譳	言󰀙丆〢
譴	言口丨辶
譵	言业丷寸
譶	言言言󰀘
護	言艹亻又
譸	言士乛寸
譹	言󰁸冖󰀓
譺	言匕𠂉󰁾
譻	貝貝言󰀘
譼	匚丨󰁃言
譽	󰀗一󰁕言
譾	言䒑月羽
譿	言三丨心
讀	言士罒貝
讁	言亠丷辶
道	䒑丿目辶
讂	言⺈ㄇ夂
讃	言夫夫貝
懌	忄罒土十
凌	冫土八夂
臌	月士口又
稍	禾⺌月󰀝
讄	言田田田
讅	言宀丿田
部	立口阝󰀢
㨍	土土寸手
烨	火亻ヒ十
胨	月󰀂小󰁶
墩	土󰁸孑攵
惨	忄厶大彡
讆	彳󰁆口言
讇	言門⺈臼
䄨	禾一󰀛󰀢
㥩	忄土丿日
讋	立月一言
慥	忄丿土辶
䞞	土󰁾弓󰀯
讍	言王口口
讏	彳󰁆口言
䣙	山月月阝
讑	言人一艹
讒	言⺈口丶
讓	言亠口󰀔
讔	言阝爫心
讕	言門木󰀹
嗀	士冖一又
棴	木月卩又
讘	言耳耳耳
醌	西一日匕
讙	言艹口󰁷
炓	火󰁦十󰀢
肓	亠󰄃月󰀘
册	󰀼󰀼一󰀌
悓	忄目儿󰁀
㥍	忄󰀎八󰁶
䥍	土䒑十金
讛	言艹土厶
讜	言⺌冖灬
楩	木亻一乂
奩	大匚口口
襩	衤󰁧士貝
焨	火日月󰀝
丩	󰁐丨󰀵
器	口口大口
温	氵日皿󰀝
縩	糹󰁯二小
踩	口止爫木
鸩	冖󰁜勹一
瀥	氵羽󰁸口
䛞	言日干󰀢
硌	石夂口󰀝
桌	󰀥日木󰁧
塌	土日羽󰀝
䡌	車厶󰁶
䜞	言󰀴󰀳󰀝
㢦	丁口丁丶
題	曰一󰁾貝
行	彳一丁󰀢
圞	囗言糹木
诐	讠皮󰁶
悥	言心󰁧
㺟	犭󰁥羽󰁷
䙞	衤󰁧癶䒑
聥	耳丿口丶
恥	耳心󰁶
㢞	广羽田八
䗦	虫夂三辶
䚦	⺈用⺁几
灝	氵曰󰁸貝
谸	丿八口
谹	八人口厶
谺	八人口丿
谻	八人口󰀠
㙨	土幺幺人
䂨	石斤丶󰁶
㣩	彳木木󰁶
谾	八人口工
豀	八人口大
豂	八人口彡
豃	八人口攵
豄	八人口貝
豅	八人口三
砌	石七刀ノ
迍	一凵乚辶
頌	八厶丆貝
豏	一口䒑八
㠌	山󰀎八人
俍	亻丶艮󰁶
忍	刀丶心󰁧
栌	木󰀥尸ノ
豒	山三丨丿
豖	一󰀓丶󰀦
䆍	禾立月三
豘	一󰀓一乚
豙	立󰀓󰁧
汮	氵勹冫󰀝
豜	一󰀓一廾
豝	一󰀓巴󰁀
豞	一󰀓勹口
針	釒十󰀢
臝	󰄹月日丶
邨	一凵󰁐阝
肨	月三丨󰀢
炨	火宀匕󰁀
您	亻⺈小心
储	亻讠土日
旨	匕日󰀘
痨	疒艹冖力
䶩	止󰀆󰀴󰀳
嗨	口氵𠂉母
㻧	王夕㐄木
豠	一󰀓󰀐一
藨	艹󰁙󰁴灬
门	门丶丨𠃌
壌	土六󰀀󰀔
䣌	广󰁚󰀁阝
磌	石十󰀣八
棌	木爫木󰁶
飌	艹口口虫
裌	衤󰁧大人
豦	虍一󰀓󰀦
豧	一󰀓甫󰁶
豨	一󰀓乂丨
豩	一󰀓一󰀓
豬	一󰀓土日
豭	一󰀓󰁃又
豮	一󰀓十贝
潥	氵覀米󰁶
豰	士冖二又
碟	石廿󰄃木
询	讠勹日󰀝
豴	一󰀓亠古
豵	一󰀓彳󰁾
镴	钅巛囗󰁒
輋	山大車󰀬
㶩	火冖󰁜󰁀
舝	󰁆巛冖㐄
鈝	釒丿󰀟󰀢
嘨	口󰁬米󰀯
乩	󰀥口乚󰁀
繩	糹黽󰀝
昨	日𠂉丨二
鹩	大丷日一
蹩	丷冂󰅇󰁾
䛦	言八人口
豻	豸干󰀢
梌	木人一朩
碌	石󰁭氺󰁶
䢌	一冂丨辶
墌	土广廿灬
貃	豸白󰀝
貇	豸艮󰁶
袌	亠勹巳󰀔
颌	人一口贝
貈	豸丿󰁪󰁶
貍	豸曰土󰀝
貎	豸臼儿󰁀
貐	豸人一刂
貒	豸山丆〢
兝	古儿八刀
䅝	禾宀八工
腓	月丨三三
爫	爫丿丶丿
貚	豸口口十
貛	豸艹口󰁷
貝	貝丨󰁈丶
貞	󰀥貝󰁧
貟	厶貝󰁧
㘨	土冂人󰁶
負	⺈貝󰁧
財	貝󰀛丿󰁥
貢	工貝󰁧
貣	󰀁丶貝󰁧
貤	貝也󰁀
貥	貝亠几󰁀
貦	貝二儿󰁀
貧	八刀貝󰁧
貨	亻ヒ貝󰁧
㬩	日三丨心
龍	立月一三
辍	车又又又
欩	刀口⺈人
澍	氵士口寸
坌	八刀土󰀘
侍	亻土寸󰁶
㝌	宀ク󰂃󰁧
貪	人丶乛貝
貫	毌貝󰁧
責	貝󰁧
熝	火󰁙󰁴匕
笩	⺮亻󰀁丶
荨	艹彐寸󰁧
鬩	丨王王儿
貮	一󰀁貝丶
䆝	宀八丿皿
冝	冖󰀐一󰀘
睤	目田一󰀯
貰	廿󰄃貝󰁧
貱	貝皮󰁶
貲	止匕貝󰁧
貳	󰀁二貝丶
貴	口丨一貝
貵	厶大貝󰁧
㻍	王口一大
仍	亻乃ノ
廍	广立口阝
滍	氵凵丨虫
绍	纟刀口󰀝
蜌	虫󰁴匕土
黍	禾人氺󰁧
㧩	扌几一丨
買	罒貝󰁧
貸	亻󰀁丶貝
貹	貝丿󰀝
秩	禾󰅎人󰁶
憨	乛耳夂心
姩	女𠂉㐄󰀢
䧩	阝乛耳攵
費	弓󰀯貝󰁧
貽	貝厶口󰀝
駩	󰀋灬人王
膨	月士口彡
貾	貝󰁚󰀁丶
貿	󰁚丶刀貝
賀	力口貝󰁧
賁	十艹貝󰁧
賂	貝夂口󰀝
賃	亻丿士貝
賄	貝月󰀝
賅	貝亠ㄥ人
賆	貝䒑廾󰀢
資	冫⺈人貝
勝	月丷夫力
㐦	󰀗一󰁕乙
賉	貝丿皿󰀝
狝	犭󰁥⺈小
賋	貝六乂󰁶
賌	亠ㄥ丿貝
賍	貝广土󰀝
賎	貝二戈󰁶
賐	貝厶八夂
賑	貝厂二󰀖
媩	女古月󰀝
檩	木亠囗小
㪩	󰁬十󰀲又
韌	󰁆口㐄丶
䟌	土󰁾十󰁷
㟌	山乚丶
柌	木𠃌一口
埌	土丶艮󰁶
賕	貝一氺丶
溌	氵癶二儿
賗	貝口口丨
賘	貝广土丶
骩	󰀾月九󰁀
賙	貝󰀼土口
狨	犭ノ戈
苨	艹尸匕󰀅
賚	木人人貝
䢊	子辶󰀌
賜	貝曰勹󰁤
煉	火木󰀹󰀝
錝	釒宀二小
賞	⺌冖口貝
茝	艹匚丨丨
賠	貝立口󰀝
賡	广󰁬人貝
賢	匚丨󰁃貝
犸	犭ノ󰀊一
賤	貝戈戈󰁶
賥	貝亠人十
賦	貝一󰀁丶
賧	貝火火󰁶
夵	大小󰁧
鞌	宀女廿󰀜
㭩	木爫寸󰁶
挨	扌厶𠂉大
孩	孑亠ㄥ人
垌	土冂一口
潍	氵纟亻󰁷
㞌	尸子󰀌
位	亻立󰀝
質	斤斤貝󰁧
賫	十人人貝
賬	貝󰀍󰀖󰁶
賭	貝土丿日
茨	艹冫⺈人
筩	⺮󰁻用󰀬
賮	󰁬丨一貝
錨	釒艹田󰀝
儉	亻人一人
賯	貝勹日子
䉝	⺮丷王丶
剝	彑氺刂󰀢
衹	衤󰁧󰁚󰀁
鉝	釒立󰀝
賳	貝十戈口
䡋	車十又󰁶
噌	口丷󰀺日
亍	一丁󰀬
㙌	土󰁬丨八
呋	口二人󰁶
陌	阝丆日󰀝
躍	口止羽󰁷
纍	田田田小
溍	氵一业日
賸	月丷夫貝
賹	貝䒑八皿
賺	貝䒑󰁬八
賻	貝甫寸󰁶
䎾	耳人一艹
賽	宀󰀀八貝
賾	匚丨口貝
賿	貝羽人彡
贀	匚𠂉大貝
鸤	尸󰁠一󰀝
贂	貝厶厶彡
贄	土䒑十貝
贅	󰁡攵貝
㲧	毛又丶虫
䫞	丷王灬貝
犝	牜立曰土
濪	氵月巴
砩	石弓󰀯󰀢
迪	由辶󰀌
遨	主󰁡夂辶
贇	文一󰀁貝
贈	貝丷󰀺日
贉	貝覀早󰀢
贊	丿土󰁜貝
嘌	口覀二小
昌	日日󰀘
瘌	疒一口刂
跍	口止古󰀝
贋	厂亻亻貝
贌	貝业䒑夫
㷍	火人一艹
䘌	匚艹虫
抨	扌一丷十
动	二厶力ノ
䫩	厶厶厶貝
㫩	十艹日󰀘
贐	貝󰁬丨皿
贑	立早工貝
贒	匚丨󰁃貝
飱	一夕人艮
贔	貝貝貝󰁧
贕	󰁚丶丿貝
飕	几乂臼又
贗	厂亻󰁟貝
贙	虍几虍貝
銨	釒宀女󰀝
芨	艹乃󰂃󰁧
竩	立宀󰀐一
贚	貝立月三
贛	立早夂貝
贜	貝艹戈丨
㡊	冂丨⺈臼
珝	王羽󰀝
㴧	氵丿目心
贠	厶贝󰁧
遉	󰀥貝辶󰀦
㛌	女厶丿󰀟
䁉	丶尸戈目
弍	󰀁二丶󰀦
伍	亻五󰀝
缍	纟丿十一
曌	日月宀工
雌	止󰁴亻󰁷
蛌	虫⺁厶󰂃
㞊	凵山二乚
䐝	月⺌貝󰁶
耉	土丿丿口
瀉	氵宀臼灬
䀉	丿大口皿
卝	丨一󰀥󰀝
獝	犭󰁥󰁻口
鎝	釒艹人口
䕦	艹󰄹月丶
匊	勹米󰀦
赬	土󰁖󰀥貝
安	宀女󰀘
赲	土󰁾力󰀏
䝊	一󰀓一󰁾
㱞	一夕立󰀝
䱞	󰁢灬大小
螩	虫亻丨朩
鞩	廿󰀜⺌刂
枩	木八厶󰁧
瞩	目尸丿丶
赹	土󰁾勹冫
赺	土󰁾人乛
赻	土󰁾小丿
赼	土󰁾⺈人
䚌	白大十儿
幍	冂丨爫臼
赾	土󰁾斤󰀵
㹍	牜亠丷古
蚌	虫三丨󰀢
鹍	曰󰁴󰁴一
湍	氵山丆〢
侪	亻文󰀯󰀢
赿	土󰁾󰁚󰀁
趀	土󰁾丿丿
趂	土󰁾⺈小
趃	土󰁾丿夫
趆	土󰁾󰁚丶
䚊	䒑八皿儿
趇	土󰁾立󰀌
趈	土󰁾󰀥口
皊	白人丶󰁻
処	夂几󰁫
趉	土󰁾凵山
釦	釒口󰀝
趌	土󰁾士口
趎	土󰁾丿未
趐	土󰁾羽󰀌
趒	土󰁾儿󰀪
硩	扌斤石󰀘
怨	夕⺋心󰁧
逨	木人人辶
衩	衤󰁧又丶
趓	土󰁾几木
趕	土󰁾曰干
趖	土󰁾人土
趗	土󰁾口󰁾
趘	土󰁾尸毛
趙	土󰁾⺌月
趚	土󰁾木口
翽	止戊一羽
趜	土󰁾勹米
䛊	言口八󰁶
钓	钅勹丶󰁶
趝	土󰁾人心
綌	糹八人口
蒓	艹糹一乚
咓	口一󰁐丶
涌	氵󰁻月丨
㶌	氵耳幺一
䒓	艹一ㄅ󰀅
㒝	亻艹罒人
劦	力力力󰁣
尪	乚王󰀌
䰪	󰀪人月厶
㰪	土土⺈人
犦	牜曰󰁺氺
鏩	釒車斤󰀢
菩	艹立口󰀘
簪	⺮󰀂󰁜日
氪	󰅎⺄古儿
趞	土󰁾󰁺日
趠	土󰁾󰀥早
趡	土󰁾亻󰁷
趢	土󰁾󰁭氺
趤	土󰁾宀石
趥	土󰁾丷一
趦	土󰁾冫口
趧	土󰁾日󰁾
趨	土󰁾勹丿
趩	土󰁾田八
趫	土󰁾丿口
趬	土󰁾土儿
趭	土󰁾亻灬
鷌	󰁟灬󰀋灬
趮	土󰁾口木
趯	土󰁾羽󰁷
淌	氵⺌冂口
呓	口艹乙󰁀
跌	口止󰅎人
緌	糹禾女󰀝
锩	钅䒑大⺋
䘊	虫⺮罒人
䑓	艹二冖土
㑓	亻厶又
峪	山八人口
泪	氵目󰀝
甩	月乚󰁫
㳍	氵冂丨
䳍	󰁺八󰁟灬
唌	口丿󰀥廴
泍	氵木一󰀝
甌	匚口口丶
蔌	艹一口人
鳍	󰁢󰀞土日
趶	口止一󰀛
趷	口止𠂉乙
趹	口止ユ人
趻	口止人乛
趽	口止方󰁥
跀	口止月󰀝
跁	口止巴󰁀
跂	口止十又
跅	口止斤丶
跇	口止廿󰄃
䘝	衤󰁧󰀁丶
勦	巛曰木力
跉	口止人󰁻
噊	口󰁻乛口
䙊	衤󰁧一丨
跊	口止未󰁶
猦	犭󰁥几虫
跐	口止止匕
跒	口止丁口
镩	钅宀八丨
跓	口止丶王
㛑	󰀥夕又女
沪	氵丶尸ノ
啩	口土土卜
蕩	艹氵曰󰁤
粪	米󰁺八󰁧
硂	石人王󰀝
跘	口止丷󰀟
䕩	艹木大小
㕩	口三丨󰀢
跙	口止󰀐一
跜	口止尸匕
㭧	丿󰁪木󰁧
閊	門山󰀵
䎦	二木火火
跠	口止一人
跡	口止亠󰁖
跢	口止夕夕
鋦	釒尸𠃌口
狦	犭󰁥冂〢
跧	口止人王
跩	口止曰丿
跭	口止夂㐄
跮	口止一土
凉	冫󰁸小󰁶
铓	钅艹亠󰄃
蓓	艹亻立口
経	糹又土󰀝
浌	氵亻戈󰁶
嵌	山艹二人
䓓	艹三丿寸
㓓	冫十冂十
钩	钅勹厶󰁶
睌	目⺈口󰁜
璩	王󰅋七󰀓
赪	土󰁖󰀥贝
咩	口䒑󰀟󰀢
浪	氵丶彐󰀖
㵪	氵丷王人
䵪	󰀹土灬匕
䖝	丿虫󰀦
嗊	口工貝󰁶
跾	亻丨攵󰁾
跿	口止土󰁾
踀	口止口󰁾
嚾	口艹口󰁷
踂	口止耳乚
踃	口止⺌月
踄	口止止󰀤
䤊	西一艹耳
惉	氵󰀥口心
胉	月白󰀝
郉	一干阝
踆	口止厶夂
踇	口止𠂉母
踈	口止木口
䈦	⺮乂凵夂
踋	口止土卩
踍	口止土子
踐	口止戈戈
捦	扌金󰀝
㨩	扌广丿廴
䉨	⺮立󰀓又
娩	女⺈口󰁜
扨	扌刀丶󰁶
铩	钅乂木󰁶
贪	人丶乛贝
騩	󰀋灬白厶
洪	氵󰁺八󰁶
哩	口日土󰀝
䴪	󰁙󰁴匕氺
沍	氵一彑󰀝
呌	口󰁦十󰀢
﨩	阝󰁟山󰀢
獦	犭󰁥艹󰄃
鍦	釒方𠂉也
鲍	󰁢󰀞勹巳
葌	艹女女女
踒	口止禾女
饑	人良幺人
踕	口止一󰁾
嵊	山禾丬匕
踗	口止人心
踘	口止勹米
踙	口止耳又
踚	口止人艹
踛	口止土土
踜	口止土夂
圝	囗言糹糹
䠧	口止尸日
踠	口止宀⺋
踡	口止丷⺋
踤	口止亠十
踥	口止立女
踨	口止人󰁾
踫	口止䒑业
瀦	氵一󰀓日
踰	口止人刂
㐌	𠂉也󰀅
䯍	󰀾月人󰁻
同	冂一口󰀌
搌	扌尸󰁺󰀖
踳	口止三日
踴	口止󰁻力
狄	犭ノ火󰁶
踷	口止土日
踸	口止󰀎󰄃
踻	口止ㄇ口
柗	木八口󰀝
踾	口止一田
篍	⺮禾火󰁧
萌	艹日月󰀘
鯍	󰁢灬亠󰀸
踿	口止禾火
霝	󰀙口口口
蜝	󰀎八虫󰁧
咊	口禾󰁶
㳋	氵丘󰀝
䒊	八一ㄅ巴
蹃	口止艹口
蹅	口止木一
蹆	口止艮辶
蹌	口止人口
㦩	忄阝爫心
蹎	口止十八
慌	忄艹亠󰀸
榩	木虍文󰁶
禩	礻󰁶田八
䦩	門目夂󰀦
妩	女二󰁜󰁀
肦	󰀼冫八刀
蹔	車斤口󰁾
㓌	冫人王󰀝
馩	禾日十貝
哌	口⺁󰀕󰁶
䴍	貝貝󰁟灬
瓌	王亠罒󰀔
洍	氵匚丨丨
鴍	文󰁟灬󰁧
蓌	艹人人夂
蹖	口止三臼
蹗	口止󰁙匕
蹘	口止羽彡
蹚	口止⺌土
啥	口人干口
蹜	口止宀日
蹝	口止彳󰁾
蹞	口止󰁴貝
蹠	口止广灬
蹡	口止爿寸
蹢	口止亠古
蹣	口止廿丶
蹤	口止彳󰁾
蹥	口止車辶
擋	扌⺌冖田
䱋	󰁢灬󰁺八
㩩	扌匕水貝
䠝	口止口貝
刨	勹巳刂󰀢
䈨	⺮阝艮󰁧
爨	󰀗ㄇ一火
戨	丁口丁戈
鈨	釒二儿󰁀
舨	丿󰁪⺁又
鮁	󰁢灬丶
㽞	口口田󰀘
汍	氵九丶󰁶
籍	⺮三󰅇日
䒌	冖日六巴
和	禾口󰀝
蹱	口止立土
蹳	口止癶又
豍	一口䒑十
钌	钅了󰀢
蹵	󰁸小󰁾
蹷	厂䒑凵󰁾
蹸	口止米㐄
蹹	口止人羽
蹺	口止土儿
鑊	釒艹亻又
葊	艹人一廾
蹾	口止󰁸攵
瑊	王戊一口
躀	口止毌貝
熦	火小亻󰁷
憦	忄火火力
躂	口止土辶
躃	口止尸辛
躄	尸口辛󰁾
躆	口止虍󰀓
飊	火火火虫
䀞	目󰁦十󰀢
躊	口止士寸
躋	口止󰀴󰀳
殍	一夕爫子
宍	宀六󰁧
䮍	󰀋灬亠󰀔
㮍	䒑月刂木
㗩	口羽白󰀝
躒	口止白木
莊	艹爿士󰀘
鎊	釒亠丷方
痩	疒曰丨又
早	早丨󰁈丨
帪	冂丨厂󰀖
个	人丨󰀬
玊	王丶󰀦
鮍	󰁢灬皮󰁶
闩	门一󰀌
藩	艹氵丿田
䦧	門臼儿󰁫
慦	一氺丶心
躖	口止幺丨
躗	彳󰁆口󰁾
躘	口止立三
躙	口止門󰁷
躚	口止覀辶
烢	火宀丿七
躝	口止門󰀹
躟	口止亠󰀔
躠	艹丿󰃧󰁾
躡	口止耳耳
躢	口止門羽
躣	口止目󰁷
躤	口止艹日
躥	口止宀󰁒
挌	扌夂口󰀝
猌	木人人犬
茌	艹亻士󰀘
錌	釒山厂干
揊	扌一口田
䮋	󰀋灬一刂
㮋	木月阝
躨	口止䒑夂
绪	纟土丿日
蜩	虫󰀼土口
黪	󰀹土灬彡
躩	口止目又
㜩	女丿ㄇ大
仪	亻丶乂󰁶
圩	土一󰀛󰀢
匌	勹人一口
酦	西一ㄥ丶
躭	丿󰀽三󰁜
躮	丿󰀽三刀
躰	丿󰀽三一
躱	丿󰀽三木
躳	丿󰀽三口
躴	丿󰀽三艮
躵	丿󰀽三心
躶	丿󰀽三木
奘	󰄃丨丆大
躸	丿󰀽三口
躹	丿󰀽三米
躻	丿󰀽三工
徔	彳艹之󰁶
躽	丿󰀽三女
幼	ㄠ力ノ
䰍	󰂞彡木氺
㰍	立月一木
氍	目目亻乚
双	又又󰁶
躿	丿󰀽三氺
軀	丿󰀽三口
軁	丿󰀽三女
軂	丿󰀽三力
躪	口止艹󰁷
纪	纟己󰁀
軄	丿󰀽三日
麪	木人人𠃌
菌	艹囗禾󰁧
㝩	宀广󰁬氺
溪	氵爫ㄠ大
坩	土艹二󰀝
軅	丿󰀽三󰁷
軆	丿󰀽三䒑
軇	丿󰀽三寸
軉	丿󰀽三貝
軋	車乚󰁀
軌	車九󰁀
軍	冖車󰀬
軑	車大󰁶
軒	車干󰀢
軓	車几丶󰁶
軕	車山󰀢
軖	車王󰀝
軗	車几又󰁶
傜	亻爫𠂉凵
軞	車毛󰁀
鄜	󰁙󰁴匕阝
厌	厂犬󰀦
掌	⺌冖口手
㭍	冫七木󰁧
䭍	人良皿
廨	广⺈月󰀟
軤	車丿丷󰀛
馷	󰀋灬一丨
軪	車幺力󰁥
隩	阝丿ㄇ大
軯	車一丷十
皩	白王日儿
蚩	凵丨一虫
魍	白󰁜厶󰄃
潪	氵𠂉大日
筍	⺮勹日󰀘
莌	艹丷口儿
铹	钅艹冖力
劊	人一󰀺刂
軶	車丶尸乙
軸	車由󰀝
軹	車口八󰁶
膫	月大丷小
輀	車丆冂〢
鲴	󰁢󰀞囗古
輂	󰁺八車󰀬
輄	車⺌一儿
輅	車夂口󰀝
輆	車亠ㄥ人
䋊	糹一止󰀝
輈	車丿󰁪󰁶
勊	古儿力󰀏
鋊	釒八人口
骍	󰀊󰀞辛󰀢
認	言刀丶心
牌	丿丨一十
扌	扌一亅󰀞
㾞	疒西一󰀌
輍	車八人口
騂	󰀋灬辛󰀢
邳	丆卜󰀞阝
輘	車土八夂
雩	󰀙二ㄅ󰀅
蛩	工几丶虫
缪	纟羽人彡
剌	一口󰅇刂
弪	弓ス工󰀝
㪍	十冖孑攵
㼪	大人人丶
輝	⺌一儿車
灜	氵󰄹月丶
聜	耳宀八工
輠	車曰木󰁶
輡	車⺈臼󰀝
輦	夫夫車󰀬
輧	車丿一干
輨	車宀󰃧󰀝
輩	丨三丨車
輪	車人一艹
輫	車丨三三
好	女子󰀝
輱	車戊一口
輲	車山丆〢
熜	火丿囗心
醜	西一白厶
鈌	釒ユ人󰁶
㯪	木󰀙人󰁻
䐩	月山一䒑
寪	宀爫丿灬
姍	女冂艹󰀢
怓	忄女又󰁶
诪	讠三丿寸
鐩	釒䒑󰀓辶
扊	丶尸火火
輷	車勹言󰀝
㧍	扌方󰁥
䀓	目九丶󰁶
輻	車一口田
䉑	⺮𠂉一灬
輿	󰀗車一八
轁	車爫臼󰀝
轂	士冖一又
䆊	禾丬匕八
冊	冂艹󰀵
轆	車󰁙󰁴匕
捝	扌丷口儿
燜	火門心󰁶
憊	亻󰁺丿心
轎	車丿大口
轐	車业䒑夫
轒	車十艹貝
禾	禾禾禾禾
轗	車戊一心
轙	車丷王丶
轚	車凵几車
轜	車󰀙丆〢
轝	󰀗一󰁕車
㑩	亻罒夕󰁶
拌	扌丷󰀟󰀢
鬍	󰂞彡古月
苌	艹丿七󰂃
箪	⺮丷曰十
殪	一夕士䒑
鑩	釒王口口
讪	讠山󰀢
䄜	礻󰁶亠厶
㗧	口宀八土
轢	車白幺木
轥	車艹門󰁷
㬍	日甫寸󰁶
慜	𠂉母攵心
嬍	女山一攵
䬍	几丿虫心
腜	月甘木󰁶
酜	西一夫󰁶
䞧	土󰁾⺁口
辀	车丿󰁪󰁶
劜	力乚󰁀
犜	牜󰁸孑攵
銜	彳釒一丁
傊	亻口貝󰁶
悊	扌斤心󰁧
肊	月乙󰁀
勜	八厶羽力
㬝	日丷󰀺日
鋜	釒口󰁾󰁶
狜	犭󰁥古󰀝
兊	八厶儿󰀅
辢	木口辛󰀢
芌	艹二ㄅ󰀅
屪	尸宀大小
橍	木門王󰀝
積	禾貝󰁶
莩	艹爫子󰀘
鱪	󰁢灬曰日
掩	扌大日乚
玩	王二儿󰁀
辦	辛力辛󰀢
辪	止丿󰃧辛
辯	辛言辛󰀢
辳	木木厂󰀖
䊌	米广󰁴匕
劌	止戊一刂
辴	口口曰󰀖
㩍	扌⺮木冂
㢓	广立早󰀵
䃒	石一口丨
辸	乃辶󰀏
耊	土丿一土
㧝	力口手󰀬
瀊	氵丿󰁪皿
辺	刀辶󰀏
辻	十辶󰀵
辿	山辶󰀵
迀	干辶󰀵
迃	二ㄅ辶󰁫
迆	也辶󰁫
㒧	亻亠乂󰁷
牜	牜丿一󰀞
迉	尸辶󰀏
僊	亻覀大巳
䢋	一󰀯辶󰀵
館	人良宀󰃧
迊	一冂丨辶
胊	󰀼冫勹口
椨	木广亻寸
夨	󰁕一󰂃󰀦
褨	衤󰁧⺶工
礨	田田田石
迒	亠几辶󰁫
迖	犬辶󰀦
郒	丶󰁮口巴
㤨	忄󰁺八󰁶
碓	石亻󰁷󰀝
覌	又目儿󰁀
墓	艹日大土
梓	木辛󰀢
鎜	丿󰁪几金
厜	厂丿士󰁺
䀒	目丿十󰀢
㡓	冂丨冖車
玜	王八厶󰁶
掜	扌臼儿󰁀
㱠	一夕古󰀝
韋	󰁆口㐄󰀬
柋	亻󰀁丶木
矋	目厂艹丶
迡	尸匕辶󰁫
迣	廿󰄃辶󰁫
迧	曰丨辶󰀵
迬	丶王辶󰀌
迱	宀匕辶󰁫
鏜	釒⺌冖土
揜	扌人一廾
珜	王羊󰀢
飨	󰁲丿人艮
遊	方𠂉子辶
磨	广木木石
裨	衤󰁧白十
壨	田田田土
棨	丶尸攵木
㣨	彳女古󰀝
递	丷弓丨辶
偊	亻丿口丶
䠋	口止白十
槌	木亻󰁃辶
倒	亻一厶刂
觌	十乛󰁦󰁜
瀒	氵木人口
䄓	礻󰁶白王
儓	亻士口土
愓	忄日一󰁤
焓	火人丶口
脓	月冖󰀔󰁶
鄓	丿目犬阝
恊	忄力力力
卋	十廿󰀘
獋	犭󰁥丿十
鍋	釒ㄇ󰁈口
迺	西辶󰀌
䂡	石丘󰀝
迾	一夕刂辶
迿	勹日辶󰀌
匜	匚也󰁫
䌜	糹业䒑未
鞨	廿󰀜日󰄃
迩	⺈小辶󰀦
焯	火󰀥早󰀢
枨	木丿七󰂃
㷠	火火夕㐄
錜	釒人丶乛
䫳	罒勹虫貝
欅	木󰀗一手
逭	宀丨󰁃辶
䳀	󰁟灬丿夫
逜	五口辶󰀌
譲	言六󰀀󰀔
垨	土宀寸󰁶
俩	亻一冂人
㿩	白⺌冖灬
梾	木一丷木
䂒	𠂉大士口
㣓	󰀥夕又彡
踭	口止⺈亅
獜	犭󰁥米㐄
荾	艹厶八夂
瞋	目十󰀣八
犴	犭ノ干󰀢
逴	󰀥早辶󰀵
艧	丿󰁪艹又
鉧	釒母󰁶
澂	氵山一攵
榃	木木田󰀘
㜿	孑󰁻乛亅
㹖	牜丷夫󰀓
運	冖車辶󰀵
絙	糹一日一
饨	⺈󰁐一乚
㸣	丿丨一未
䍜	罒亻󰁷󰀘
㓜	幺刀󰁥
奨	丬爫寸大
楨	木󰀥貝󰁶
票	覀二小󰁧
襨	衤󰁧业寸
窸	宀八丿心
鈧	釒亠几󰁀
㥨	女土土心
飓	几乂󰀣八
肒	月九丶󰁶
炒	火小丿ノ
楌	木立丿彡
奌	󰀥口大󰁧
憓	忄一曰心
熓	火󰁞灬󰁶
䆓	宀八厶儿
冓	󰀀冂土󰀘
氿	氵九󰁀
袥	衤󰁧石󰀝
膓	月𠂉曰󰁤
醓	西一冖皿
嚯	口󰀙亻󰁷
丨	丨丨〇〇
縨	糹日⺌儿
暯	日艹曰大
隯	阝士乛寸
蚯	虫丘󰀝
釹	釒女󰀝
伣	亻ㄇ󰁜󰁀
㹢	犭󰁥力口
儼	亻口口攵
遻	口口䒑辶
虋	艹󰀗ㄇ刀
㙋	土󰀎八󰁶
䙋	衤󰁧宀一
㓧	人丶乛刂
䭪	⺈󰁐日土
邇	一八冂辶
賈	覀貝󰁧
佫	亻夂口󰀝
䊧	米弓󰀯貝
劧	手力󰁥
抧	扌口八󰁶
犧	牜丷王丶
芧	艹󰁻乛亅
兓	󰀄󰁜󰀄󰁜
䅓	禾勹口又
煓	火山丆〢
慓	忄覀二小
酓	人丶乛一
㷨	火山夂丨
儢	亻虍田心
痿	疒禾女󰀌
淨	氵爫󰁬亅
盯	目丁󰀢
䛯	言尸古󰀝
巨	匚󰁃󰀌
䖜	虍几虍日
蹕	口止曰󰀟
跨	口止大ㄅ
雯	󰀙文󰁧
絺	糹乂丨
䟊	土󰁾虍󰀓
壄	木󰁻乛土
癦	疒󰀹土土
獧	犭󰁥罒󰀔
鍧	釒勹言󰀝
邲	心丿阝󰀢
䓽	艹言己󰀅
䌧	糹士乛寸
䒙	艹上󰀘
㪠	䒑󰁬〢又
迋	王辶󰀌
紪	糹止匕󰁀
錧	釒宀󰃧󰀝
挧	扌羽󰀝
猧	犭󰁥ㄇ口
爓	火門⺈臼
舓	丿古日󰁤
鈓	釒丿士󰀝
墤	土口丨貝
氠	气曰丨󰀵
䈓	⺮日勹󰄃
刓	二儿刂󰀢
戓	戈口󰀌
㔜	爫孑力󰁥
凧	几冂丨󰀵
攼	干攵󰁶
釧	釒川󰀢
躕	口止广寸
絣	糹䒑廾󰀢
丟	王厶󰁧
儊	亻木木󰁾
愊	忄一口田
䎋	丿土口羽
厧	厂十󰀣八
逯	󰁭氺辶󰀦
袨	衤󰁧亠幺
瀯	氵火火口
怯	忄土厶󰁶
墨	󰀹土灬土
䢨	彳人人辶
㢨	弓干󰀢
㨤	扌匚亻󰁷
蕫	艹立曰土
敧	大丁口又
泉	白水󰁧
遧	立早辶󰀵
鄔	󰁞灬阝󰀢
燓	木乂乂火
懓	忄爫冖夂
凓	冫覀木󰁶
䇓	彡丆貝立
榌	木⺄〈丨
惓	忄丷夫⺋
釓	釒乚󰁀
臓	月艹戊丨
乨	厶口乚󰁀
噯	口爫冖夂
景	曰󰁸小󰁧
癯	疒目目󰁷
蹨	口止󰁝灬
鹨	羽人彡一
噸	口一凵貝
謼	言虍丿󰀛
鄦	𠂉一󰀷阝
鄨	㡀攵口巴
綨	糹󰀎八󰁶
㛙	女辛󰀢
逧	八人口辶
瞴	目𠂉一灬
鄲	口口曰阝
倧	亻宀二小
䦠	門一󰀓丶
䨄	人丶乛󰁷
㔋	匚丨󰁃刂
唋	口人一朩
鄻	夫夫車阝
鄼	夫夫貝阝
鄿	艹口口阝
酀	廿口丬阝
龌	止人凵土
酂	丿土儿阝
羌	䒑二󰁜󰀅
辌	车󰁸小󰁶
後	彳幺夂󰁶
澌	氵艹三斤
㾌	疒丿土儿
䊓	米日一󰁾
賛	夫夫貝󰁧
辡	辛辛󰀢
聦	耳勹󰁤心
狧	犭󰁥丿古
䫄	丷口儿貝
摋	扌乂朩又
酔	西一九十
酖	西一冖󰁜
䬨	人良勹九
㬨	日土󰁖󰁖
欨	勹口⺈人
冯	冫󰀊一󰀝
讌	言廿口灬
軃	丿󰀽三十
酨	十戈西一
綑	糹囗木󰁶
戫	月戈󰀞
嬌	女丿大口
侜	亻丿󰁪󰁶
絵	糹人二厶
膯	月癶一䒑
笨	⺮木一󰀘
䕤	艹口口阝
醯	西一亠皿
迌	月辶󰀌
翌	羽立󰀘
翪	羽乂凵夂
鉓	釒𠂉冂丨
俌	亻甫󰁶
㿌	疒人一人
打	扌丁󰀢
忌	己心󰁧
醆	西一戈戈
醈	西一火火
㑫	亻人丶心
酧	西一宀寸
醊	西一又又
䡠	車󰀥貝󰁶
綹	糹夂卜口
紾	糹人彡󰁥
凯	山󰁁几󰁀
櫨	木虍田皿
㫨	日宀女󰀝
䫨	󰁡攵貝
㛏	女一氺丶
瞈	目八厶羽
醔	禾火西一
醖	西一日皿
醗	西一癶儿
醘	西一土皿
貭	⺁十貝󰀦
褎	亠亻二󰀔
釯	釒亠󰄃󰁀
䍌	𠂉十凵口
竨	立󰀥早󰀢
諨	言一口田
蠠	丆囗〢虫
醥	西一覀小
焧	火八厶心
䬙	几丿虫凵
㰑	木心心木
醸	西一六󰀔
醹	西一󰀙〢
醼	西一廿灬
釐	未攵厂土
㼌	⺁厶丶󰂃
伌	亻厂⺋󰁀
弌	󰀁一丶󰀦
漌	氵廿口
猓	犭󰁥曰木
輌	車一冂山
鼌	曰一口乚
㦨	忄門木󰀹
椦	木丷夫力
豟	一󰀓丶乙
袿	衤󰁧土土
禨	礻󰁶幺人
振	扌厂二󰀖
妨	女方ノ
䦨	門木日󰀌
膧	󰀼冫立土
醧	西一匚口
錯	釒󰁺日󰀝
茯	艹亻犬󰁧
譖	言󰀄󰁜日
䠠	廿儿冖󰁾
㽋	言糹糹丶
眊	目毛󰁀
䛁	言冂二󰀝
鋓	釒禾刂󰀢
苓	艹人丶󰁻
罌	貝貝𠂉凵
拓	扌石󰀝
彌	弓一八乂
佌	亻止匕󰁀
㽌	󰀙󰁚丶丶
廫	广月羽彡
鈀	釒巴󰁀
鈁	釒方󰁥
鈈	釒丆卜󰁶
䓷	艹氵彳丁
鈊	釒心󰁶
圠	土乚󰁀
霠	󰀙立人乛
㭨	木󰀄亅阝
䅯	禾广󰁬口
孨	子孑子󰀘
慯	忄𠂉曰󰁤
㖦	口木日󰀝
䐎	月日一󰁾
匋	勹𠂉十凵
論	言人一艹
梟	󰁟木󰁧
篧	⺮冖亻󰁷
喉	口亻ユ大
屃	尸贝󰀦
煯	火󰁴匕白
腯	月⺁十目
酯	西一匕日
鈴	釒人丶󰁻
㧄	扌凵󰀢
绤	纟八人口
䣠	夫夫日阝
鈼	釒𠂉丨二
鉀	釒甲󰀢
㣜	彳一廾刂
鉇	釒𠂉也󰁀
忱	忄冖󰁜󰁀
二	二一一
厓	厂土土󰀌
⺌	⺌丨丶丿
㺌	犭󰁥䒑八
莓	艹𠂉母󰁧
麌	󰁙󰁴匕大
掓	扌上小又
玓	王勹丶󰁶
炯	火冂口󰀝
悯	忄门文󰁶
邯	艹二阝󰀢
肯	止月󰀘
鉑	釒白󰀝
盙	甫皿󰀘
鉗	釒甘󰀝
鉙	釒口八󰁶
徴	彳山王攵
賲	亻口木貝
睠	目丷夫⺋
訤	言乂乂󰁶
㠨	山木乂寸
㸰	牜宀匕󰁀
堨	土曰勹󰄃
䂯	石广土󰀝
謧	言亠乂厶
篗	⺮亻󰁷又
臋	尸󰁺八几
鉫	釒力口󰀝
渓	氵爫夫󰁶
牬	牜丿ㄅ丿
瓄	王士罒貝
岞	山𠂉丨二
㻌	王人一朩
䘠	衤󰁧乂
卓	󰀥早󰀬
䍓	罒󰀄亅丿
绌	纟凵山󰀢
捓	扌󰀄亅阝
鍓	釒口耳󰀝
荓	艹䒑廾󰀬
胯	月大二ㄅ
郯	火火阝󰀢
惯	忄󰅂十贝
矨	𠂉大丿大
銇	釒二木󰁶
䑧	丿󰁪亻寸
銊	釒戊一󰀝
旞	方𠂉䒑辶
筄	⺮儿󰀪󰁧
藐	艹豸白儿
銒	釒一干
㤜	忄戈人󰁶
侩	亻人二厶
僯	亻米夕㐄
矠	󰁻乛亅日
㾩	疒丿十匕
銖	釒丿未󰁶
喐	口月阝
贆	貝犬犬犬
訿	言止匕󰁀
鐓	釒󰁸孑攵
䋗	糹匚丨丨
謌	言丁口口
镋	钅⺌冖儿
吓	口一卜󰁶
渌	氵󰁭氺󰁶
琓	王宀二儿
踌	口止三寸
秄	禾子󰀝
銪	釒月󰀝
㸌	火󰀙亻󰁷
丌	一󰀯󰀵
戯	虍业戈󰁶
刯	一曰󰀞刂
䪨	立日勹丶
㪨	羊䒑口又
暠	曰󰁸冂口
皠	白山亻󰁷
䧄	阝夂口󰀝
媅	女󰀎八󰄃
銵	釒丿󰀽丿
贝	贝丨󰁈丶
棻	艹八刀木
鋁	釒口口󰀝
鋅	釒辛󰀢
鈯	釒凵山󰀢
舯	丿󰁪口丨
窨	宀八立日
晠	日戊𠃌󰁀
陠	阝甫󰁶
㦜	忄艹亻又
縼	糹方𠂉󰁾
噠	口土羊辶
䙠	衤󰁧厂人
鋑	釒厶八夂
鋒	釒夂三丨
叓	一口丨又
乌	勹ㄅ一󰀌
㹌	牜立丿
喨	口󰁸冖几
鹌	大日󰁐一
菓	艹曰木󰁧
珓	王六乂󰁶
湌	氵人丶艮
息	丿目心󰁧
灯	火丁󰀢
聯	耳幺幺一
顨	丆貝丆󰀯
樆	木亠乂厶
賊	貝戈󰁥
虨	虍木木彡
鋠	釒厂二󰀖
栄	󰀧冖木󰁧
䬷	人良夕夕
誋	言己心󰁶
跥	口止乃木
䂋	古㐄󰁻木
㡨	冂丨人󰀞
䡨	⺶工車󰀬
偯	亻󰁸󰀔󰁶
㔠	日勹人力
攠	扌广木三
鋪	釒甫󰁶
濵	氵宀󰁅貝
镨	钅䒑󰅊日
鋰	釒曰土󰀝
鋲	釒丘八󰁶
鋵	釒禾几󰁀
啨	口月󰀝
敨	立口攵󰁶
紩	糹丿夫󰁶
贩	贝⺁又󰁶
䠡	口止虍一
鱓	󰁢灬口十
㴩	氵巛口巴
䴩	󰁙󰁴匕小
汓	氵子󰀝
吒	口丿七󰁀
萒	艹六厶儿
籓	⺮氵丿田
錀	釒人一艹
蛠	虫力力力
䐒	月大夕夕
㱓	止人丶󰁻
曠	日广󰁺八
䛄	言夕⺋󰁀
䛠	言一口䒑
㺡	犭󰁥厂止
錁	釒曰木󰁶
錂	釒土八夂
㼅	王广󰁺八
䳢	󰀎八󰁟灬
毟	小丿毛󰀅
繑	糹丿大口
錏	釒一󰀚一
錐	釒亻󰁷󰀝
皪	白白幺木
䶭	ヒ丶王
賝	貝冖八木
訋	言勹丶󰁶
厨	厂一口寸
䎨	二木大乚
㯩	又又又人
焋	爿士火󰁧
鯩	󰁢灬人艹
莨	艹丶彐󰀖
铒	钅耳󰀝
推	扌亻󰁷󰀝
瓒	王丿土贝
貓	豸艹田󰀝
哒	口大辶󰁶
沓	水日󰀘
㓒	冫七人⺗
䓒	艹勹田󰀘
㾇	疒目󰀌
鄋	臼丨又阝
㖠	口大二小
話	言丿古󰀝
濦	氵爫工心
皣	白艹一󰀟
冐	󰀰月󰀘
䲝	󰁢󰀞人⺋
錴	釒土八土
嬳	女艹亻又
僋	亻人丶貝
䃋	石人一刂
罍	田田田凵
䪜	󰁆口㐄言
㕠	冫亻󰁷又
畠	白田󰀘
鲩	󰁢󰀞宀儿
㱡	一夕丿儿
瓨	工一󰁐丶
蓨	艹亻丨月
岩	山石󰀘
㴌	氵女古󰀝
㓨	大人人刂
崌	山尸古󰀝
洌	氵一夕刂
甓	尸口立丶
蔓	艹日罒又
璒	王癶一䒑
撒	扌󰁺月夂
峓	山一弓人
䒒	艹𠃌󰀞󰀘
㳓	氵口󰀝
仚	人山󰀬
鍊	釒木󰀹󰀝
迶	月辶󰀌
縅	糹戊一女
楒	木田心󰁶
㔓	丿十力󰁥
螄	虫丿󰃧丨
偃	亻匚日女
琠	王ㄇ󰁺八
鍝	釒曰冂丶
栧	木曰󰁒丿
珄	王丿󰀝
菄	艹木曰󰀘
踑	口止󰀎八
稶	禾戈口󰁤
锨	钅斤⺈人
忈	二心󰁧
鍴	釒山丆〢
浩	氵丿土口
嵩	山󰁸冂口
赩	土󰁖⺈巴
用	用丿𠃌丨
嗠	爫孑夂口
㶡	几火󰀦
䔨	艹󰁲丿󰁷
㵩	氵艹廿木
痠	疒厶八夂
泱	氵ㄇ大󰁶
䣸	亻丿士一
䰺	󰁢灬斤󰀢
䐸	月󰁬土一
躓	口止斤貝
鎌	釒䒑󰁬八
岳	󰅍一山󰀬
縟	糹厂二寸
膹	月十艹貝
狌	犭󰁥丿
囅	口口曰󰀖
䜄	言尸氺󰀟
㜄	女几丿虫
鎚	釒丿󰃧辶
彸	彳八厶󰁶
㞤	山人󰁧
鎢	釒󰁞灬󰁶
歲	止戊一󰀤
誥	言丿土口
帯	一〣一丨
婜	匚丨󰁃女
鎪	釒臼丨又
蝄	虫冂䒑󰄃
靄	󰀙言日󰄃
㲌	毛乃󰀏
侅	亻亠ㄥ人
坄	土几又󰁶
沌	氵一凵乚
粌	米弓丨󰀢
䲌	󰁢灬士人
喓	口覀女󰀝
㐑	夂󰁦乙󰀅
摠	扌丿囗心
薓	艹氵彐又
鲌	󰁢󰀞白󰀝
娨	女曰干󰀢
䨨	󰀙丿󰃧辶
犯	犭ノ⺋󰁀
抯	扌󰀐一󰀝
銯	釒幺小󰁶
芯	艹心󰁧
鎴	釒丿目心
鎵	釒宀一󰀓
筀	⺮土土󰀘
彜	彑米八廾
﨨	釒土䒑十
罸	罒言寸󰁧
菙	艹丿士󰁺
鏁	釒巛曰木
調	言󰀼土口
鏇	釒方𠂉󰁾
躧	口止一匕
巬	工几夫󰁧
鏌	釒艹曰大
钨	钅勹ㄅ一
蒨	艹亻月
璨	王󰀥夕米
㳌	氵甲󰀢
咨	冫⺈人口
䒨	艹𠂉大󰁧
㳩	氵工󰀼亠
糌	米夂卜日
泌	氵心丿ノ
鳌	主󰁡夂一
蕓	艹󰀙二厶
緔	糹⺌冂口
䗯	虫亻󰁷辶
拯	扌了󰀩一
狯	犭ノ人厶
䧨	阝业䒑未
姨	女一弓人
鏙	釒山亻󰁷
鏚	釒戊上小
苯	艹木一󰀘
駨	󰀋灬勹日
覈	覀白方攵
桗	木乃木󰁶
鏤	釒󰀻女󰀝
鏥	釒宀亻日
鏦	釒彳人󰁾
鏧	士󰁅几金
幦	尸口辛丨
祾	礻󰁶土夂
鏪	釒一ㄇ日
鏭	釒丿米心
裄	衤󰁧彳丁
䣄	人一朩阝
㘓	口門木󰀹
䰌	󰂞彡彳󰁾
嘓	口囗戈󰀞
易	日勹󰁤󰁣
鏲	釒亠幺󰀟
鏴	釒口止口
鏵	釒艹一󰀟
㺲	王󰁈丨一
屵	山厂󰁣
鐂	釒一〢田
鐄	釒󰁺由八
蹧	口止一日
簌	⺮一口人
谌	讠艹三󰄃
鰌	󰁢灬丷一
醦	西一厶彡
礃	石⺌冖手
緮	糹𠂉曰夂
䯡	󰀾月䒑八
䚩	⺈用丿口
釟	釒八󰁶
姣	女亠八乂
泿	氵艮󰁶
妅	女工󰀝
鐣	釒⺌冖手
鐥	釒羊䒑口
䬡	土丿日丨
㬡	日󰀙人󰁻
鐪	釒虍田力
戠	亠丷戈日
爠	火目目󰁷
舠	丿󰁪刀󰁥
㱌	耳耳耳人
鈠	釒几又󰁶
鐫	釒亻󰁷𠃌
鐮	釒广䒑八
籌	⺮士乛寸
汌	氵川󰀢
嗓	口又又木
䗓	虫勹󰁤心
䯶	󰂞彡󰀐一
婀	女阝丁口
闓	門山一䒑
豌	一口䒑⺋
䩨	廿󰀜󰀍󰀖
副	一口田刂
扯	扌止󰀝
牯	牜古󰀝
良	丶彐󰀖󰀦
驨	󰀋灬山口
寉	宀亻󰁷󰀘
羣	󰁬丿口羊
鑁	釒󰁘凵夂
蹽	口止大小
礣	石艹罒人
鑍	貝貝金󰀘
缩	纟宀亻日
蝨	⺄十虫虫
鼩	臼󰁐󰁦口
鏠	釒夂三辶
㝨	宀土口󰀔
伩	亻文󰁶
坨	土宀匕󰁀
漩	氵方𠂉󰁾
嚓	口宀󰁯小
殌	一夕一工
㮌	木丆囗二
䮌	󰀋灬亻木
態	厶月匕心
鑚	釒夫夫貝
睵	目十戈口
鑜	釒⺌冖貝
鑟	釒士罒貝
鑥	釒󰁢灬日
銠	釒土丿匕
犠	牜丷王丶
隓	阝工工
鑦	釒匚丨貝
皓	白丿土口
蚓	虫弓丨󰀢
鑧	釒宀艹丶
夘	夕卩󰀢
鑴	釒山亻口
鑵	釒艹口󰁷
羍	大羊󰀬
斺	方人󰀯󰀢
钂	釒⺌冖灬
牠	牜也󰁀
疨	疒󰀄亅丿
斨	爿斤󰀢
巩	工几丶󰁶
䖨	虫石󰀝
屘	尸毛子󰀌
吜	口󰁈丨一
閨	門土土󰀌
薨	艹罒冖匕
䯌	󰀾月尸九
㙓	土土土土
晓	日弋丿儿
富	宀一口田
㟬	山臼丨又
㨡	扌囗一󰀓
䶜	止󰀆丿口
劄	⺮人一刂
䄠	礻󰁶亠一
礽	礻󰁶乃󰁥
拠	扌夂几󰁀
勠	羽人彡力
诌	讠⺈彐󰀝
篌	⺮亻ユ大
蹏	口止⺁几
陓	阝大二ㄅ
䥬	釒艹甫寸
磳	石丷󰀺日
爄	火厂艹丶
礿	礻󰁶勹丶
㖨	口󰁭氺󰁶
醠	西一ㄇ皿
㧡	扌亠ㄥ人
鉄	釒丿夫󰁶
雨	雨一丨丶
兯	丷卩󰀬
纩	纟广ノ
蛨	虫丆日󰀝
囨	囗丆卜󰀦
㬌	日亠日小
䜓	言艹廿木
亩	亠田󰀘
兠	白丬匕儿
徖	彳宀二小
杮	木一冂丨
䲙	󰁢灬⺮卩
䭅	人良囗古
䎆	羽人丶󰁻
掄	扌人一艹
㭅	木三󰀝
䀠	目目󰀝
㔤	宀丿米力
䞰	土󰁾土󰁖
㿱	扌斤皮󰁧
釠	釒几󰁀
臠	言糹糹人
儸	亻罒糹󰁷
懠	忄󰀴󰀳󰀝
欌	木艹戈丨
笌	⺮󰀄亅丿
蜓	虫丿士廴
鬌	󰂞彡月
忓	忄干󰀢
錄	釒彑氺󰁶
䑦	丿󰁪勹口
奛	大日月󰀘
轩	车干󰀢
罩	罒󰀥早󰀬
㫅	方人二󰀯
齩	止󰀆六乂
佩	亻几一丨
㽩	田厶厶彡
木	木木木木
在	丨土󰀌
歌	丁口丁人
囓	口三丨󰀆
䭌	古月人艮
㛓	女乂丨
邠	八刀阝󰀢
炠	火甲󰀢
坋	土八刀󰁥
睋	目丿扌丶
蝋	虫󰀧几󰀟
㲘	貝毛󰁀
踧	口止上又
獄	犭󰁥言犬
㮅	木亻󰁷󰀘
魌	白󰁜厶八
蛓	十戈虫󰀦
筌	⺮人王󰀘
産	立丿丿
錼	釒大二小
梽	木士心󰁶
馇	⺈󰁐木一
钄	釒艹門󰀹
潹	氵木木木
飍	几丿虫虫
䴜	󰀥囗󰁘厶
㵱	氵覀二寸
䞍	贝月󰀝
帢	冂丨人口
镻	󰂞丿夫󰁶
䞓	土󰁖一工
媌	女艹田󰀝
憙	士口䒑心
㪌	󰁻用󰀥又
閁	門丿󰀏
㰩	虫⺈人󰁶
䰩	土丿日厶
周	󰀼土口󰀌
氩	󰅎⺄一一
瑨	王一业日
谩	讠日罒又
鑨	釒立月三
閄	門人󰁶
閈	門干󰀵
烠	火月󰀝
閌	門亠几󰁫
茀	艹弓󰀯󰀬
畄	󰀧田󰀘
閘	門甲󰀵
閙	門亠冂丨
螓	虫三人禾
鞓	廿󰀜口王
枓	木󰁦十󰀢
瞓	目言川󰀢
䴇	󰀙人丶灬
閛	門一丷十
㐄	㐄一ㄥ丨
㜡	女彳人󰁾
朡	月乂凵夂
隨	阝工辶
蚨	虫二人󰁶
绩	纟主贝󰁶
滩	氵又亻󰁷
嚨	口立月三
䚨	⺈用癶又
㚨	女⺄十󰀢
圡	土丶󰀦
閟	門心丿󰀏
閤	門人一口
閧	門󰁺八󰀦
紎	糹犬󰁶
閪	門西󰀌
㑄	亻母󰁶
䲅	󰁢灬夫儿
䳜	人一朩灬
㟡	山丷夫⺋
呄	乃古󰀘
矡	󰁻乛亅又
埡	土一󰀚一
韡	󰁆口㐄󰀟
閻	門⺈臼󰀌
滣	氵厂二口
竌	立几󰁀
櫌	木丆󰀐夂
靓	主月ㄇ󰁜
蝓	虫人一刂
闈	門󰁆口㐄
䴕	一夕刂一
跶	口止大辶
䘟	衤󰁧弓丨
瓉	王夫夫貝
䗙	宀󰀀八虫
㨌	士冖手又
䁒	目口耳󰀝
瞡	目夫目儿
闙	門丶尸攵
闛	門⺌冖土
關	門幺幺一
䮩	󰀋灬󰀾月
叨	口刀ノ
闝	門貝攵󰀦
㮩	木丿目心
让	讠上󰀝
鏨	車斤金󰀘
揨	扌󰁸冖丁
箩	⺮罒夕󰁧
棟	木木曰󰀝
闥	門土羊辶
釄	西一广三
穭	禾󰁢灬日
闬	门干󰀵
癡	疒匕𠂉󰁾
兀	一儿󰁫
噡	口⺈厂言
遒	丷西一辶
䄂	礻󰁶由󰀝
䱶	󰁢灬丶阝
䵇	广木木攵
偒	亻曰一󰁤
恒	忄一日一
稌	禾人一朩
蠓	虫艹冖󰀓
䄻	禾儿󰀪󰁶
趲	土󰁾丿貝
蘡	艹貝貝女
㘡	囗甲󰀵
埓	土爫寸󰁶
䟓	口止丁󰀢
㟓	山乂丨
阞	阝力󰁥
㱩	一夕十大
阤	阝也󰁀
吨	口一凵乚
䱩	󰁢灬冂󰄃
琨	王日󰁴匕
搨	扌曰羽󰀝
鱩	󰁢灬󰀙田
萨	艹阝立丿
雡	羽人彡󰁷
䛡	言󰁚󰀁口
敄	󰁻乛亅丿
阦	阝火󰁶
穙	禾业䒑夫
阫	阝丆卜󰁶
阬	阝亠几󰁀
憘	忄士口口
驌	󰀋灬󰁬󰀲
蟓	虫⺈口󰀓
矓	目立月三
染	氵九木󰁧
䎜	土丿󰁴匕
䋬	糹一大⺗
陁	阝𠂉也󰁀
隡	阝立丿
蚡	虫八刀󰁥
郑	䒑大阝󰀢
暡	日八厶羽
䚡	⺈用田心
惑	戈口󰀞心
堒	土曰󰁴匕
蠒	一八冂虫
砒	石󰁴匕󰁀
㽆	⺌冖口丶
鞯	廿󰀜艹子
䃑	石丿󰁪又
㠒	山覀二刂
枯	木古󰀝
垯	土大辶󰁶
螯	主󰁡夂虫
瞯	目門月󰀝
㟯	山宀夂口
䀮	目亠󰄃󰀸
陙	阝厂二󰀖
蜅	虫甫󰁶
䛀	言⺁又󰁶
䞳	土󰁾立口
笀	⺮亠󰄃󰀅
沶	氵二小󰁶
䑂	月󰀗一八
椉	亠夕㐄木
毡	丿二乚口
攡	扌亠乂󰁷
陫	阝丨三三
埳	土⺈臼󰀝
癅	疒一〢田
㹈	未攵丿󰀟
陰	阝人丶厶
忇	忄力󰁥
逑	一氺丶辶
䨆	㡀攵亻󰁷
瀑	氵日󰁺氺
耑	山丆冂〢
壒	土艹土皿
棒	木三人󰀟
靯	廿󰀜土󰀝
䀑	目又丶󰁶
㺭	王子󰀝
険	阝人一人
坯	土丆卜一
杯	木丆卜󰁶
睯	󰁂󰀁攵目
蝯	虫爫一又
陼	阝土丿日
泙	氵一丷十
䞯	土󰁾爫子
㞯	己山󰀬
痡	疒甫󰀦
藡	艹亠丷辶
遲	尸氺丿辶
皅	白巴󰁀
灲	火刂󰀢
壖	土󰀙丆〢
邜	夕阝󰀢
禡	礻󰁶󰀋灬
燴	火人一日
䛌	言勹巳󰁀
喡	口󰁆口㐄
閡	門亠ㄥ人
進	亻󰁷辶󰀌
際	阝󰁯二小
㐅	乂丿丶
遑	白王辶󰀌
袒	衤󰁧日一
灑	氵一ㄇ匕
恑	忄⺈厂⺋
墒	土亠丷口
郮	󰀼土口阝
辨	辛丶丿辛
礯	石火火小
澨	氵⺮工人
叅	厶厶厶⺗
隟	阝巛曰木
㳅	氵丆卜󰁶
隣	阝米夕㐄
隤	阝口丨貝
鑡	釒止󰀆󰀢
㝯	宀丿大口
䝯	貝𠂉也󰁀
瑡	王丿󰃧丨
僲	亻覀夕㐄
㝅	士冖一又
鐅	㡀攵金󰀘
險	阝人一人
隫	阝十艹貝
隮	阝󰀴󰀳󰀝
䳘	󰁟灬丿丶
価	亻覀󰀝
廰	广耳十心
隸	木二小氺
簙	⺮十甫寸
杅	木一󰀛󰀢
坅	土人丶乛
㞅	乚日木
雂	人丶乛󰁷
雃	一廾亻󰁷
雈	丨一󰀥󰁷
雊	勹口亻󰁷
籞	⺮彳𠂉小
迨	厶口辶󰀌
鄮	󰁚丶刀阝
愮	忄爫𠂉凵
翨	羽曰一󰁾
員	口貝󰁧
㓡	𠂉十凵刂
琫	王三人󰀟
㛅	女耳󰀝
雖	口虫亻󰁷
雗	十早人󰁷
雙	亻󰁷亻又
雜	亠人人󰁷
徨	彳白王󰀝
侨	亻丿大󰀯
㾨	疒大丁口
㤓	忄木一󰀝
䅒	禾艹亠󰄃
兒	臼儿󰀅
慒	忄一ㄇ日
礓	石一田一
褓	衤󰁧亻木
酒	氵西一󰀝
雟	凵丿亻口
愄	忄田一󰀖
儲	亻言土日
咡	口耳󰀝
䄄	礻󰁶囗大
阥	阝水󰁶
䏂	耳臼丨又
辉	⺌一儿车
雤	󰀗乂乂󰁷
雥	亻󰁷亻󰁷
雦	亻󰁷亻󰁷
雧	亻󰁷亻木
櫟	木白幺木
滆	氵一口丨
雮	󰀙毛󰀅
㜮	女匚丨皿
蟸	一󰀓虫虫
雴	󰀙立󰀘
噮	口罒一󰀔
䙮	衤󰁧艹󰁷
纯	纟一凵乚
普	䒑󰅊一日
麯	木人人󰁺
虮	虫几󰁀
㥓	忄大丁口
惄	上小又心
儒	亻󰀙丆〢
䥓	釒󰀎八土
祓	礻󰁶丶
愒	忄日勹󰄃
鄒	勹凵丿阝
脒	月米󰁶
䤅	西一人刂
䇲	⺮一丷大
簰	⺮丿丨十
㸪	牜川󰀢
槇	木匕目八
澢	氵⺌冖田
霅	󰀙言󰀘
霊	󰀙二业󰀘
嗼	口艹曰大
獡	犭󰁥臼灬
鍡	釒田一󰀖
愥	忄艹ㄇ大
膲	月亻󰁷灬
醲	西一ㄇ󰀖
㧳	扌八刀手
䆲	宀八广氺
㺯	王大󰁧
殸	士󰁅几又
乯	丿丷󰀛乙
嚮	󰁲丿丶口
暮	艹日大日
皮	󰅌又󰀦
蹯	口止丿田
鹯	亠囗口一
酗	西一乂凵
霚	󰀙󰁻乛攵
懒	忄一口贝
燒	火土土儿
䦓	門󰀥口󰀌
妓	女十又󰁶
寊	宀󰀥貝󰁧
俆	亻人一朩
覓	爫目儿󰀅
馓	⺈󰁐󰁺夂
閝	門人丶󰁻
霢	󰀙月⺁󰀕
霥	󰀙冖二󰀓
霦	󰀙木木彡
霧	󰀙󰁻乛力
㺥	犭󰁥⺈丶
碦	石宀夂口
溳	氵口貝󰁶
䬚	几丿虫灬
鏡	釒立曰儿
㺆	犭󰁥讠贝
頯	󰁝廾丆貝
蠯	广白丿虫
砯	石丶水󰁶
栯	木月󰀝
堯	土土土儿
乆	ㄥ人󰀦
墴	土󰁺由八
欆	木亻󰁷又
靌	󰀙宀王貝
㧓	扌⺁厶󰂃
萬	艹曰冂丶
䭸	󰀋灬八乂
鉡	釒丷󰀟󰀢
熒	火火冖火
槓	木工貝󰁶
冒	曰目󰀘
䧓	阝󰀼土口
㫳	厂二󰀖日
冄	冂二󰀌
醒	西一日主
膒	月匚口口
﨓	木艹亻寸
犲	犭󰁥󰀛丿
毣	羽毛󰀅
嶆	山一ㄇ日
靝	月气米
靟	丨三丨毛
腄	月丿士󰁺
酄	艹口口阝
靤	丆囗〢巳
靦	丆囗〢儿
逮	󰁬氺辶󰀦
靧	丆囗〢貝
矯	𠂉大丿口
蟯	虫土土儿
埯	土大日乚
柯	木丁口󰀝
䠯	口止人艹
㠯	󰃧丨󰁈一
鋡	釒人丶口
挅	扌乃木󰁶
䣧	西一󰀁丶
㺪	王卜󰁶
鍗	釒亠丷丨
冹	冫又丶
牒	丿丨一木
訓	言川󰀢
鉒	釒丶王󰀝
扗	扌土󰀝
㨓	扌宀八󰀟
䉒	⺮丿米田
剒	󰁺日刂󰀢
扒	扌八󰁶
腡	月ㄇ󰁈口
鞞	廿󰀜白十
䩧	廿󰀜言󰀝
䅡	禾丆貝󰁶
腮	月田心󰁶
煮	土丿日灬
鞧	廿󰀜丷一
酮	西一冂口
兟	丿土󰁜儿
嚸	口󰀹土口
僸	亻木木小
鉅	釒匚󰁃󰀝
牅	爿广󰁬丨
䄡	礻󰁶⺈言
愡	忄勹󰁤心
䀫	目人一口
䇅	立戈󰁶
懅	忄虍一󰀓
鞾	廿󰀜艹一
韂	廿󰀜⺈言
韇	廿󰀜士貝
釡	八金󰀘
韈	廿󰀜艹人
臡	廿口夫人
刮	丿古刂󰀢
戮	羽人彡戈
㧯	扌土丿匕
䈮	⺮立勹口
䩓	廿󰀜勹厶
㩓	臼工几手
戒	戈廾󰀵
划	戈刂󰀢
迠	󰀥口辶󰀌
韍	󰁆口㐄丶
犅	牜冂䒑山
芅	艹󰀁丶󰁧
祯	礻󰁶󰀥贝
膮	月土土儿
醮	西一亻灬
懡	忄广木厶
罀	𠂉十凵󰀪
韒	󰁆口㐄月
韕	󰁆口㐄子
韖	󰁆口㐄木
韗	󰁆口㐄車
韘	󰁆口㐄木
韙	日一󰁾㐄
韚	󰁆口㐄󰀜
䬀	几丿虫力
韜	󰁆口㐄臼
韝	󰁆口㐄土
韞	󰁆口㐄皿
韟	󰁆口㐄十
醡	西一宀二
熡	火󰀻女󰀝
韠	󰁆口㐄󰀟
䅮	禾人丶口
㦯	戈厶󰀞󰀌
榯	木日土寸
誓	扌斤言󰀘
媓	女白王󰀝
拒	扌匚󰁃󰀝
㪓	丿十丬又
䋒	糹󰁻乛丿
韣	󰁆口㐄虫
韤	󰁆口㐄人
鬯	󰁘凵匕󰀅
苮	艹亻山󰀬
韥	󰁆口㐄貝
憡	忄⺮木冂
冡	冖二󰀓󰁧
䆡	宀八丶艮
獅	犭󰁥丿丨
韨	二𠃌丨丶
竍	立十󰀢
韯	十戈丨󰀞
韴	立日一丨
聡	耳八厶心
韷	立日凵山
韸	立日夂丨
偡	亻󰀎八󰄃
㟄	山羊󰀢
韺	立日艹大
韻	立日口貝
嫃	女十󰀣八
韽	人丶乛日
韾	士󰁅几日
響	󰁲丿丶日
㥯	爫工彐心
䥯	釒罒厶匕
芒	艹亠󰄃󰀅
楯	木⺁十目
抒	扌󰁻乛亅
嫓	女⺈ㄇ匕
䊒	米亻󰁷󰀝
㫓	日𠂉乙󰁀
頂	丁丆貝󰁶
頃	󰁴丆貝󰁶
茮	艹上小󰁧
髯	󰂞彡冂土
頄	九丆貝󰁶
順	川丆貝󰁶
剦	大曰乚刂
頉	止丆貝󰁶
贃	貝口口心
耡	二木󰀐力
頋	厂⺋丆貝
穾	宀八丿大
䣢	二木󰁺阝
㣢	彳丷弓丿
狅	犭󰁥丿士
頑	二儿丆貝
頒	八刀丆貝
㬓	日覀二小
䬓	几丿虫日
卒	亠人人十
捒	扌木口󰀝
獒	󰁡攵犬
荒	艹亠󰄃󰀸
鬓	󰂞彡宀八
㬯	日󰄹月丶
領	人丶󰁻貝
頙	一止丆貝
頛	二木丆貝
狮	犭ノリ丨
欯	士口⺈人
嬯	女士口土
䬯	人良󰀥口
頝	六乂丆貝
頞	宀女丆貝
頟	夂口丆貝
頠	⺈厂⺋貝
惡	一󰀚一心
烡	火󰁺八󰁧
䠢	艹罒冖󰁾
頡	士口丆貝
碯	石巛丿乂
梯	木丷弓丿
遮	广廿灬辶
聮	耳幺幺灬
頢	丿古丆貝
頣	匚丨󰁃貝
頤	匚丨口貝
頥	丨匚丨貝
㭓	木厶廾󰀢
頦	亠ㄥ丿貝
孓	了󰂃󰀦
䭓	人良山䒑
俨	亻一󰅊厂
忨	忄二儿󰁀
錒	釒阝丁口
㿨	白厂禾止
頨	羽丆貝󰁶
頩	䒑廾丆貝
摽	扌覀二小
䵆	木人人󰀓
唅	口人丶口
頫	儿󰀪丆貝
頬	一丷大貝
䍲	⺶臼儿󰁀
頱	爫寸丆貝
頲	丿士廴貝
悡	禾刂心󰁧
頵	󰁬丿口貝
頶	丿土口貝
妷	女丿夫󰁶
頹	禾儿丆貝
頺	禾乃丆貝
悮	忄口一大
炮	火勹巳󰁀
肮	月亠几󰁀
邮	由阝󰀢
頼	木口丆貝
旼	日文󰁶
顁	宀一󰁾貝
顂	木人人貝
䮓	󰀋灬󰀥早
宓	宀心丿󰁣
顃	火火丆貝
㮓	木忄一一
㢯	弓󰁂󰀁󰁀
鏒	釒厶厶彡
偮	亻口耳󰀝
珒	王󰁬󰀟󰀢
脀	了󰀩一月
祁	礻󰁶阝󰀢
愀	忄禾火󰁶
奁	大匚乂󰁧
䥁	釒󰁻囗十
㥁	十罒󰄃心
顅	丶尸月貝
顆	曰木丆貝
顇	亠人人貝
顈	匕幺小貝
顉	釒丆貝󰁶
贘	貝⺌冖貝
攅	扌夫夫貝
釮	釒󰀛丿󰁥
訯	言乃󰂃󰁶
燮	言火火又
額	宀夂口貝
顎	口口二貝
顑	戊一口貝
顒	曰冂丨貝
顓	山丆冂貝
陧	阝日土󰀝
灃	氵山三䒑
顖	丿囗乂貝
寓	宀日冂丶
䎒	羽戈戈󰁶
㯓	木人一羽
願	厂白小貝
鯓	󰁢灬丿丿
莒	艹口口󰀘
䂮	三丨刀石
塯	土󰁚丶田
礁	石亻󰁷灬
褁	曰木󰀔󰁧
兀	一儿󰁫
椁	木󰁸子󰀝
㤁	一大心󰁧
䤁	西一󰀎󰄃
顜	󰀀冂土貝
顝	󰀾月丆貝
類	米犬丆貝
顟	羽人彡貝
㯆	木立丿
顠	覀二小貝
鈮	釒尸匕󰁀
顡	立󰀓丆貝
爮	⺁丨󰂃巳
觯	⺈用丷十
葅	艹人人一
呅	口文󰁶
顢	廿冂丨貝
顣	戊上小貝
鰓	󰁢灬田心
顤	土土土貝
顥	曰󰁸小貝
顦	亻󰁷灬貝
尓	𠂉小󰁧
氓	亠󰄃󰁃弋
瑒	王日一󰁤
葒	艹糹工󰀘
顧	丶尸亻貝
駁	󰀋灬乂乂
㑒	人一口人
䑒	一厶土丶
槁	木󰁸冂口
姁	女勹口󰀝
见	ㄇ󰁜󰀅
熀	火日⺌儿
顩	人一口貝
宸	宀厂二󰀖
䧁	阝勹口󰀝
㧁	丶尸土厶
洨	氵六乂󰁶
崨	山一󰁬󰁾
莯	艹氵木󰁧
环	王丆卜󰁶
顬	󰀙丆冂貝
顭	艹罒冖貝
䴨	󰁙󰁴󰁴小
㴨	氵月䒑大
鰠	󰁢灬又虫
顯	曰幺幺貝
顱	虍田皿貝
顲	火火亠貝
顴	艹口口貝
氝	气冂人󰀦
璅	王巛曰木
咅	立口󰀘
穓	禾田󰁺八
䩆	丆囗〢二
刅	刀八󰀦
钪	钅亠几󰁀
颙	曰冂丨贝
燅	土八土火
釅	西一口攵
風	几丿虫󰀦
颩	几丿虫彡
颪	一卜几虫
颫	几丿虫夫
颬	几丿虫丿
鵨	人干口灬
芫	艹二儿󰀅
颮	几丿虫巳
颯	立几丿虫
糨	米弓口虫
賨	宀二小貝
可	丁口󰀌
注	氵丶王󰀝
㳨	氵巛一夕
䳨	白王󰁟灬
游	氵方𠂉子
颳	几丿虫古
颴	几丿虫󰁾
颵	几丿虫月
颶	几丿虫八
爅	火󰀹土土
鈅	釒月󰀝
颷	几丿虫火
颸	几丿虫心
颹	几丿虫㐄
颺	几丿虫󰁤
颻	爫𠂉十虫
僓	亻口丨貝
颾	几丿虫虫
颿	󰀋灬几虫
飀	几丿虫田
飁	羽白几虫
飂	几丿虫彡
飃	几丿虫小
飄	覀二小虫
飅	几丿虫田
飇	几丿虫犬
飉	几丿虫小
鎯	釒丶󰁮阝
飋	几丿虫丿
穬	禾广󰁺八
唯	口亻󰁷󰀝
䮨	󰀋灬宀辛
㔯	匚几口󰀌
飏	几乂ㄋ󰁤
锯	钅尸古󰀝
讨	讠寸󰁶
甯	宀心用󰀬
支	十又󰁧
飐	几乂󰀥口
妗	女人丶乛
枥	木厂力ノ
笃	⺮󰀊一󰀘
帔	冂丨󰅌又
飜	丿米田丨
飝	⺄〈丿丨
䶆	臼󰁐󰁦󰁷
飠	人良丿丶
飢	人良几󰁀
飣	人良丁󰀢
飤	人良人󰁶
飥	人良丿七
閅	門丁󰀵
飦	人良干󰀢
䜠	言斤斤貝
飩	人良一乚
飪	人良丿士
飫	人良丿大
飬	丷夫丶艮
飭	人良𠂉力
飮	人丶彐人
飯	人良⺁又
㱮	一夕口贝
卯	󰁚丿卩󰀢
浨	氵宀木󰁶
獯	犭ノ丿灬
药	艹纟勹丶
䕒	艹士口口
啒	口尸凵山
敒	亻曰丨攵
畒	亠田人󰁶
贓	貝戈爿丨
镒	钅䒑八皿
飲	人良⺈人
飳	人良丶王
飴	人良厶口
飶	人良心丿
飹	人良󰁚卩
飻	人良人彡
飽	人良勹巳
飾	人良𠂉丨
飿	人良凵山
㲭	火火火毛
餁	人良亻士
餂	人良丿古
眆	目方󰁥
朆	丷󰀺日󰁤
䜆	广木木言
餃	人良六乂
㗬	⺌冖口夕
餅	人良䒑廾
餆	人良儿󰀪
餇	人良冂口
䱢	󰁢灬⺈亅
餉	人良丿口
鉮	釒曰丨󰀢
艮	彐󰀖󰀦
㵓	氵宀日󰁾
餋	丷夫人艮
唒	口西一󰀝
䔒	艹阝立口
絓	糹土土󰀝
攒	扌丿土贝
鵓	十冖孑灬
蔒	艹󰁬丿灬
餏	人良亠󰀔
餑	人良十子
餒	人良爫女
餓	人良丿丶
餔	人良甫󰁶
尌	士口䒑寸
劈	尸口立刀
餗	人良木口
餘	人良人朩
餙	人良乂丨
餚	人良乂月
餛	人良日匕
餜	人良曰木
餝	人良艹方
餞	人良戈戈
㫯	日日一儿
餟	人良又又
餠	人良丿干
挮	扌丷弓丿
献	十冂䒑犬
䫯	方大丁貝
匮	匚口丨贝
芮	艹冂人󰁧
㗒	口󰁸󰀔󰁶
餣	人良大乚
餤	人良火火
涓	氵口月󰀝
痒	疒䒑󰀟󰀵
䗒	虫䒑业󰀝
嗒	口艹人口
㲇	士󰁅几󰁦
䑆	月丷王艮
藒	艹禾曰󰄃
闒	門曰羽󰀌
餥	丨三丨艮
餦	人良󰀍󰀖
餧	人良禾女
餩	人良人人
餫	人良冖車
餬	人良古月
餭	人良白王
餯	人良彑󰀓
餰	人良彳丁
餱	人良亻大
㳃	氵九十󰀢
餳	人良曰󰁤
餴	人良大廾
餵	人良田󰀖
㪯	文󰀟󰀬
餷	人良木一
媯	女丶丿灬
䉮	⺮門亻󰁷
牮	亻󰀁丶󰀟
檯	木士口土
㖒	口丷弓丿
粨	米丆日󰀝
搯	扌爫臼󰀝
岨	山󰀐一󰀝
䐯	月田幺小
㲨	艹耳毛󰁀
喒	口夂卜日
䖒	虍一口䒑
㒆	亻人一羽
撆	㡀攵手󰀬
鷓	广廿灬灬
薒	艹󰀥夕米
蒆	艹工几女
餹	人良广口
餺	人良甫寸
餻	人良丷灬
㸇	火夫夫貝
闆	門口口口
康	广󰁬氺󰀦
餾	人良󰁚田
餿	人良臼又
饀	人良爫臼
饁	人良土皿
饂	人良曰皿
饃	人良艹大
郳	臼儿阝󰀢
饆	人良曰󰀟
㩯	扌𠂉母小
䩯	廿󰀜了一
婯	一ㄇ丶女
抮	扌人彡󰁥
穯	禾土口口
㙒	田󰁻乛土
专	二󰁓丶󰀦
帓	冂丨一木
晒	日西󰀝
㔝	一冂丨力
饉	人良廿
饊	人良󰁺攵
饋	人良口貝
饌	人良巳八
饍	人良羊口
嘆	口廿口夫
饎	人良士口
縓	糹厂白小
踓	口止亻󰁷
陒	阝⺈厂⺋
饒	人良土儿
饓	人良⺌木
饖	人良止󰀤
悳	十目󰄃心
饘	人良亠一
饙	人良十貝
饚	人良艹皿
㰁	木石石石
饝	人良广石
饞	人良⺈丶
饟	人良亠󰀔
蝆	虫丨一干
饠	人良罒󰁷
饡	人良丿貝
坆	土攵󰁶
饤	⺈󰁐丁󰀢
鲨	氵小丿一
乓	󰅍一丶󰁧
㘒	禾丿一匕
湓	氵八刀皿
嘒	口三丨彐
饦	⺈󰁐丿七
酳	西一幺月
䞆	貝⺌貝󰁶
枆	木毛󰁀
薯	艹罒土日
缨	纟贝贝女
縐	糹勹凵丿
閯	門氵小丿
伨	亻勹冫󰀝
㖯	冂一口匕
斯	艹三八斤
阒	门目犬󰀦
饸	⺈󰁐人口
饹	⺈󰁐夂口
饻	⺈󰁐亠󰀔
饾	⺈󰁐一䒑
馂	⺈󰁐厶夂
鄳	黽阝󰀢
脳	月󰀧乂凵
馃	⺈󰁐曰木
䏠	月立󰀝
馉	⺈󰁐󰀾月
馌	⺈󰁐土皿
馎	⺈󰁐甫寸
䱬	󰁢灬乛月
馚	禾日八刀
紧	〢又ㄠ小
馝	禾日心丿
库	广车󰀵
曒	日白方攵
㛒	女一口䒑
亓	二󰀯󰀬
醳	西一罒十
䆳	宀八一辶
㺇	犭󰁥匚犬
馪	禾日宀貝
闯	门󰀊一󰀌
馳	󰀋灬也󰁀
绨	纟丷弓丿
軨	車人丶󰁻
嗯	口囗大心
旯	日九󰀅
盒	人一口皿
仨	亻三󰀝
牳	牜母󰁶
蚆	虫巴󰁀
馽	󰀋灬口丨
馿	󰀋灬丶尸
駊	󰀋灬皮󰁶
駍	󰀋灬一十
銳	釒八口儿
駓	󰀋灬丆一
駕	力口󰀋灬
駖	󰀋灬人󰁻
肅	󰁬十󰀲󰀵
駛	󰀋灬口乂
駜	󰀋灬心丿
勳	丿一󰀹力
駡	口口󰀋灬
駣	󰀋灬儿󰀪
滓	氵宀辛󰀢
廓	广亠口阝
仓	人⺋󰀅
㻓	王耳又󰁶
㜯	女匚丨灬
駦	丷夫󰀋灬
俇	亻犭󰁥王
恅	忄土丿匕
眯	目米󰁶
术	木丶󰀦
圯	土巳󰁀
䶨	止󰀆人人
駯	󰀋灬丿未
黓	󰀹土灬丶
蚒	虫󰀼亠󰀝
结	纟士口󰀝
弦	弓亠ㄠ󰁶
獲	犭󰁥艹又
捲	扌丷夫⺋
焅	火丿土口
駷	󰀋灬木口
駹	󰀋灬丶
殙	一夕󰁚日
騀	󰀋灬丿丶
猲	犭󰁥日󰄃
匲	匚大口口
胅	月丿夫󰁶
䃅	石丷日十
騊	󰀋灬勹凵
騌	󰀋灬宀小
騍	󰀋灬日木
騏	󰀋灬󰀎八
杒	木刀丶󰁶
睒	目火火󰁶
輓	車⺈口󰁜
鼓	士口䒑又
騐	󰀋灬人心
騑	󰀋灬丨三
騖	󰁻乛亅灬
倪	亻臼儿󰁀
罨	罒大日乚
轨	车九󰁀
镯	钅罒勹虫
騘	󰀋灬勹心
㕯	冂人口󰀌
佨	亻勹巳󰁀
啯	口囗王丶
坒	󰁴匕土󰀘
騙	󰀋灬丶艹
騛	󰀋灬⺄丨
騞	󰀋灬三石
騟	󰀋灬人刂
騣	󰀋灬乂夂
騦	󰀋灬田心
騨	󰀋灬󰀧十
狆	犭󰁥口丨
騫	宀󰀀八灬
愐	忄丆囗二
騯	󰀋灬亠方
粱	氵刀八米
騸	󰀋灬丶羽
騺	土䒑十灬
㫇	方人󰁦乛
殮	一夕人人
眒	目曰丨󰀢
朒	月冂人人
咯	口夂口󰀝
轓	車丿米田
簨	⺮巳巳八
氨	󰅎⺄宀女
钯	钅巴󰁀
谨	讠廿口主
㰳	一󰀚󰀞人
驁	󰁡攵灬
驄	󰀋灬丿心
驇	土八土灬
㜒	女臼廾󰀢
驎	󰀋灬米㐄
当	⺌彐󰀘
体	亻木一󰀝
驒	󰀋灬口十
驓	󰀋灬丷日
鎲	釒⺌冖儿
弃	亠厶廾󰀬
驘	󰄹月󰀋丶
驚	艹勹口灬
搲	扌宀八󰂃
䱳	󰁢灬厂土
驜	󰀋灬业未
驞	󰀋灬宀貝
驟	󰀋灬耳乑
驥	󰀋灬丬八
驩	󰀋灬艹󰁷
驲	󰀊󰀞日󰀝
釆	丿米󰀦
燆	火丿大口
䓯	艹母󰁧
哯	口目儿󰁀
柒	氵七木󰁧
㓯	巛田刂󰀢
诨	讠冖车󰀢
铯	钅⺈巴󰁀
毨	毛丿土儿
瓯	匚乂一丶
撲	扌业䒑夫
骃	󰀊󰀞囗大
鈆	釒八厶󰁶
骉	󰀊一󰀊󰀞
侓	亻󰁬󰀟󰀢
埒	土爫寸󰁶
䈆	⺮丶尸犬
㾓	疒口月󰀌
骎	󰀊󰀞彐又
骔	󰀊󰀞宀小
骕	󰀊󰀞󰁬八
骙	󰀊󰀞癶大
鍆	釒門󰀝
卆	九十󰀬
獆	犭󰁥白十
骦	󰀊󰀞󰀙目
骪	󰀾月几丶
骬	󰀾月一󰀛
骯	󰀾月亠几
骳	󰀾月皮󰁶
鎆	釒䒑月刂
歺	󰀥夕󰁧
髃	󰀾月曰丶
髄	󰀾月辶
鞒	廿󰀜丿󰀯
螒	十早人虫
瞒	目艹一人
枒	木󰀄亅丿
浳	氵󰀁丶月
髆	󰀾月甫寸
髇	󰀾月󰁸口
髈	󰀾月亠方
髉	󰀾月冖󰁷
麨	木人人丿
蘯	艹氵日皿
纨	纟九丶󰁶
垒	厶厶厶土
䞒	土󰁖冂口
㞒	尸丿目󰀌
㺨	王厶󰁶
髍	󰀾月广木
髏	󰀾月󰀻女
髕	󰀾月宀貝
䔆	艹犭󰁥土
髚	󰁸冂口几
鐳	釒󰀙田󰀝
髜	󰁸冂口廾
髝	󰁸冂口力
髞	󰁸冂口木
髠	󰂞彡几󰀅
髢	󰂞彡也󰀅
髣	󰂞彡方󰁣
斲	匚󰁃󰀚斤
薲	艹宀一貝
髬	󰂞彡丆一
髮	󰂞彡丶
邑	口巴󰀅
㱨	一夕宀󰁾
䑯	丿󰁪丷丿
屨	尸彳󰀻女
汨	氵日󰀝
桒	十艹木󰁧
硒	石西󰀝
肑	月勹丶󰁶
髸	󰂞彡󰁺八
髼	󰂞彡夂丨
㡒	冂丨⺁目
䂑	𠂉大止匕
犆	牜十󰀣󰀝
晲	日臼儿󰁀
噲	口人一日
鬀	󰂞彡丷丿
鬂	󰂞彡丘八
抆	扌文󰁶
鬉	󰂞彡乂夂
鬋	󰂞彡䒑刂
㛲	女丆貝󰁶
瘲	疒彳人󰁾
鬑	󰂞彡䒑八
鬒	󰂞彡十八
鏆	釒毌貝󰁶
鬕	󰂞彡艹大
鬙	󰂞彡丷日
鬚	󰂞彡彡貝
䚲	言彡󰁥
囲	囗二󰀯󰀵
㯇	木丨三土
鬧	丨王王丨
鬨	丨王王八
鬮	丨王王󰁵
頮	水廾丆貝
鬳	虍一口丨
砮	女又石󰀘
蠮	虫匚𠂉羽
忯	忄󰁚󰀁󰁀
濯	氵羽亻󰁷
㠮	䒑业日工
俯	亻广亻寸
鬴	一口冂甫
鬵	󰀄󰁜󰀄丨
喁	口日冂丶
斁	罒土䒑攵
疁	田羽人彡
赂	贝夂口󰀝
鬶	夫冂󰁜丨
乘	禾丬匕󰁫
䗁	虫大丁口
㴂	氵工冂土
嚲	󰁸孑口十
㶇	氵木󰁺八
䕆	艹木人刂
鬸	一口冂田
鬹	夫目儿丨
鬺	一口冂󰁤
鬽	白󰁜厶彡
鬾	白󰁜厶又
敆	人一口又
鬿	白󰁜厶斤
魀	白󰁜厶󰀯
魆	白󰁜厶󰁐
魊	白󰁜厶󰀞
魋	白󰁜厶󰁷
魐	白󰁜厶八
韮	艹丨三一
蟮	虫䒑󰀟口
矮	𠂉大禾女
柮	木凵山󰀢
埮	土火火󰁶
鲂	󰁢󰀞方ノ
葁	艹丷王女
瑁	王曰目󰀝
摁	扌囗大心
閆	門三󰀌
魒	白󰁜厶小
魓	白󰁜厶󰀟
魕	白󰁜厶人
魖	白󰁜厶业
喪	土口口󰀖
㖁	口乂厶
䵂	木人人古
魘	厂曰月厶
魙	氵車斤厶
魚	󰁢灬󰁧
魛	󰁢灬刀󰁥
魝	󰁢灬刂󰀢
魞	󰁢灬丿󰂃
魟	󰁢灬工󰀝
魠	󰁢灬丿七
魡	󰁢灬勹丶
魢	󰁢灬己󰁀
魣	󰁢灬󰁻亅
魤	󰁢灬亻ヒ
魥	󰁢灬乃󰂃
魦	󰁢灬小丿
魧	󰁢灬亠几
䘬	衤󰁧戈
㷭	夂三丨火
䛇	言几口󰀝
魨	󰁢灬一乚
魩	󰁢灬勹󰁤
萁	艹艹三八
鳂	󰁢󰀞田󰀖
搁	扌门夂口
琁	王𠂉乛󰁾
魪	󰁢灬人󰀯
魫	󰁢灬冖󰁜
魬	󰁢灬⺁又
魭	󰁢灬二儿
魮	󰁢灬󰁴匕
鴩	丿夫󰁟灬
魰	󰁢灬文󰁶
魱	󰁢灬一彑
岂	山己󰀅
䲂	󰁢灬方󰁾
㲂	⺌冂口又
㛭	女󰁺日󰀝
亮	亠口冖几
园	囗二儿󰁫
曭	日⺌冖灬
盭	幺土䒑皿
蛭	虫一厶土
麮	木人人厶
魴	󰁢灬方󰁥
魵	󰁢灬八刀
魶	󰁢灬冂人
魷	󰁢灬丶
魸	󰁢灬丿󰁈
魹	󰁢灬毛󰁀
魺	󰁢灬丁口
魼	󰁢灬土厶
魽	󰁢灬甘󰀝
魾	󰁢灬丆一
簂	⺮囗戈󰀞
氂	未攵厂毛
铁	钅󰅎人󰁶
谂	讠人丶心
䗬	夂三丨虫
朇	人一󰀺十
䜇	言六厶󰀔
圇	囗人一艹
呇	水口󰀘
㚬	女勹冫󰀝
魿	󰁢灬人󰁻
鑇	釒󰀴󰀳󰀝
䳂	刀口󰁟灬
峂	山夂󰁦󰁶
㹮	犭󰁥丆日
㐁	一囗人󰀦
幮	冂丨广寸
䜭	󰀥冖一口
眭	目土土󰀝
札	木乚󰁀
霭	󰀙讠日󰄃
蹮	口止覀巳
鮂	󰁢灬囗人
鮃	󰁢灬一十
聭	耳白󰁜厶
餮	一夕人󰀖
椮	木厶大彡
灭	一火󰀦
鮄	󰁢灬弓󰀯
鮅	󰁢灬心丿
鮆	止匕󰁢灬
鮈	󰁢灬勹口
求	一氺丶󰀦
璁	王丿囗心
蒁	艹木丶辶
钁	釒目目又
䁭	目犬犬犬
央	ㄇ大󰀦
鮉	󰁢灬刀口
㤮	犭󰁥王心
鮋	󰁢灬由󰀝
鮌	󰁢灬亠幺
鮎	󰁢灬󰀥口
鮏	󰁢灬丿
㰂	木宀丿田
鮐	󰁢灬厶口
専	一由寸󰁧
䓁	艹土寸󰁧
鮑	󰁢灬勹巳
隬	阝一八乂
鮒	󰁢灬亻寸
鮓	󰁢灬𠂉二
㵀	氵方𠂉大
咇	口心丿󰁥
鮔	󰁢灬匚󰁃
高	󰁸冂口󰀘
邭	勹口阝󰀢
肭	月冂人󰁶
炭	山火󰁧
悭	忄〢又土
熌	火門人󰁶
鍁	釒斤⺈人
荁	艹一曰一
箂	⺮木人人
䮏	󰀋灬五口
鮘	󰁢灬亻丶
鮙	󰁢灬羽󰀝
鮚	󰁢灬士口
傭	亻广󰁬丨
䂭	石六乂󰁶
㣮	彳十冂十
鮜	󰁢灬⺁口
鮝	丷夫󰁢灬
鮞	󰁢灬丆〢
鮟	󰁢灬宀女
鮠	󰁢灬⺈⺋
鮡	󰁢灬儿󰀪
㒁	亻囗土十
䱂	󰁢灬幺力
层	尸二厶󰀦
鮤	一夕刂灬
鮥	󰁢灬夂口
鮦	󰁢灬冂口
鮧	󰁢灬一人
鮨	󰁢灬匕日
䒇	丿󰁪宀田
鮩	󰁢灬䒑廾
鮪	󰁢灬月
鞮	廿󰀜日󰁾
鮫	󰁢灬六乂
鮭	󰁢灬土土
鮮	󰁢灬羊󰀢
垮	土大二ㄅ
潯	氵彐工寸
猁	犭ノ禾刂
诂	讠古󰀝
鳨	󰁟灬力󰁥
鮰	󰁢灬囗口
㞮	山⺈丶󰁧
佯	亻䒑󰀟󰀢
鮱	󰁢灬土匕
鮲	󰁢灬亻犬
鮴	󰁢灬亻木
鮵	󰁢灬丷儿
鮶	󰁢灬󰁬口
缜	纟十󰀣八
鮸	󰁢灬⺈󰁜
鮹	󰁢灬⺌月
旇	方𠂉皮󰁶
鮺	⺶󰁢灬󰁧
鮻	󰁢灬厶夂
鮼	󰁢灬彐又
殂	一夕󰀐一
十	十一丨
䍁	纟䒑󰀓辶
㮂	目大木󰁧
鮾	󰁢灬爫女
鮿	󰁢灬耳乚
鯀	󰁢灬丿小
鯁	󰁢灬一乂
鯂	󰁢灬西一
靮	廿󰀜勹丶
鯃	󰁢灬五口
鯆	󰁢灬甫󰁶
菁	艹主月󰀘
坮	土厶口󰀝
蝮	虫𠂉日夂
羯	䒑󰀠日󰄃
鯇	󰁢灬宀儿
癧	疒厂禾止
侯	亻ユ𠂉大
㝮	宀凵山又
擬	扌匕𠂉󰁾
阇	门土丿日
鯌	󰁢灬丿口
鯎	󰁢灬戊𠃌
㹀	牜十冖子
鯐	󰁢灬土󰁾
鯑	󰁢灬乂丨
鯒	󰁢灬󰁻用
玿	王刀口󰀝
鯕	󰁢灬󰀎八
鯖	󰁢灬月
愌	忄⺈ㄇ大
寂	宀上小又
毂	士冖车又
㯂	木廿儿丨
䯂	󰀋灬󰀋木
鯘	󰁢灬禾女
鯙	󰁢灬󰁸子
鯚	󰁢灬禾子
鯛	󰁢灬󰀼口
六	六丶一丶
慭	一丷木心
㨮	扌白󰁚儿
䨮	󰀙三丨彐
筂	⺮氵也󰀅
莁	艹工人人
魂	二厶白厶
鯟	󰁢灬木曰
鯠	󰁢灬木人
鯡	󰁢灬丨三
鯢	󰁢灬臼儿
砾	石丿󰄃小
騮	󰀋灬󰁚田
䵭	󰀹土灬日
種	禾丿一土
腭	月口口ㄅ
㵭	氵土丿灬
斬	車斤󰀢
乀	丿󰂃󰀦
鯤	󰁢灬日匕
鯥	󰁢灬土土
鯦	󰁢灬夂口
㸀	火󰁸冂土
鯧	󰁢灬日曰
䏁	耳宀辛󰀢
㬂	日日冂丶
欂	木艹氵寸
叁	厶大三󰀘
鯪	󰁢灬土夂
鯫	󰁢灬耳又
鯬	禾勹丿灬
鯭	󰁢灬子皿
槮	木厶厶彡
姮	女一日一
鉁	釒人彡󰁥
誂	言儿󰀪󰁶
鯯	󰁢灬𠂉刂
婚	女󰁚弋日
谭	讠覀早󰀢
鯲	󰁢灬方󰁦
鯴	󰁢灬⺄虫
鯵	󰁢灬厶彡
鯶	󰁢灬冖車
鯷	󰁢灬日󰁾
鯸	󰁢灬亻大
駮	󰀋灬六乂
觮	⺈用󰁭氺
熭	三丨三火
鯹	󰁢灬曰
鯺	󰁢灬土日
㶭	火幺力󰁥
䞇	土八土貝
垇	土丨󰁎一
鯽	󰁢灬󰁮卩
鯾	󰁢灬亻乂
鯿	󰁢灬丶艹
㭂	木小󰁶
䭂	人良口巴
孂	女⺮艮皿
歂	山丆冂人
鰂	󰁢灬貝刂
鰃	󰁢灬田󰀖
鰄	󰁢灬戊女
鰅	󰁢灬曰丶
惭	忄车斤󰀢
碮	石日一󰁾
胭	月囗大󰁶
髂	󰀾月宀口
鰆	󰁢灬三日
鰈	󰁢灬廿木
臊	月口口木
䰬	白󰁜厶口
䐬	月一ㄇ日
㯭	木虍田力
䄆	礻󰁶丿古
㣇	彑󰁤冂丨
鰍	󰁢灬禾火
㢮	弓𠂉也󰁀
䃭	石戊一心
僭	亻󰀂󰁜日
鰑	󰁢灬日󰁤
鰒	󰁢灬𠂉夂
傥	亻⺌冖儿
脿	月󰀔󰁶
霌	󰀙󰀼土口
鰗	󰁢灬古月
鰘	󰁢灬宀土
鰙	󰁢灬艹口
㪂	气󰀥又󰁶
糯	米󰀙丆〢
鰜	󰁢灬䒑八
鰝	󰁢灬󰁸口
窂	宀八丿󰀟
扁	丶尸冂艹
剁	几木刂󰀢
䪂	廿󰀜木ㄇ
确	石⺈月丨
苁	艹人人󰁧
顮	宀一󰀤貝
衮	六厶󰀔󰁧
㰭	大二ㄅ人
䏬	月厶丿󰀟
烆	火彳一丁
䃆	石󰀎八󰁶
尭	十艹一儿
鰢	󰁢灬󰀋灬
妊	女丿士󰀝
鏬	釒虍丿󰀛
㡮	幺幺戈气
鰥	󰁢灬罒󰀫
塮	土丿󰀽寸
䄭	禾丿十󰀢
鰨	󰁢灬日羽
鰩	󰁢灬爫凵
鰪	󰁢灬土皿
鰫	󰁢灬宀口
鰬	󰁢灬虍文
鰮	󰁢灬囗皿
鰯	󰁢灬弓冫
鰰	󰁢灬礻丨
鰱	󰁢灬車辶
㫂	广廿灬斤
鰲	󰁡攵灬
鰳	󰁢灬廿力
櫂	木羽亻󰁷
爁	火匚丨皿
䫂	夕夕丆貝
刁	𠃌󰀞󰀌
詂	言亻寸󰁶
銁	釒勹日󰀝
䦜	門五口󰀌
鰸	󰁢灬匚口
扭	扌󰁈丨二
笮	⺮𠂉丨二
䉭	⺮巛囗󰁒
嬮	厂曰月女
璬	王白方攵
鰹	󰁢灬匚土
謮	言貝󰁶
鉭	釒日一󰀝
噇	口立曰土
虇	艹弓艹󰁷
鰺	󰁢灬厶彡
鰼	󰁢灬羽白
鰽	󰁢灬一日
鰾	󰁢灬覀小
鰿	󰁢灬貝
鱀	󰁮󰀄󰁜灬
鞘	廿󰀜⺌月
鱂	󰁢灬爿寸
鱃	󰁢灬⺶一
鱄	󰁢灬一寸
鱇	󰁢灬广氺
鱈	󰁢灬󰀙彐
㨂	扌木日󰀝
鱊	󰁢灬󰁻口
娂	女󰁺八󰁶
䋁	糹亠几󰁀
狁	犭ノ厶儿
餀	人良艹乂
㫮	止匕日󰀘
䑬	丿󰁪儿󰀪
呬	口四󰀝
隇	阝戊一女
竮	立尸䒑廾
櫮	木王口口
嫮	女󰀙二ㄅ
䊭	米士乛寸
鱌	󰁢灬⺈󰀓
鱍	󰁢灬癶又
銭	釒二戈󰁶
芭	艹巴󰀅
鱎	󰁢灬丿口
鱏	󰁢灬覀早
鱐	󰁢灬󰁬󰀲
鱑	󰁢灬󰁺八
鱒	󰁢灬丷寸
鱔	󰁢灬羊口
鱕	󰁢灬丿田
鱖	󰁢灬厂人
庻	广廿人人
鱘	󰁢灬彐寸
鱙	󰁢灬土儿
鱚	󰁢灬士口
笋	⺮󰁬丿󰁣
鱜	󰁢灬󰁲阝
鱝	󰁢灬十貝
㩂	扌⺈用十
䩂	丆囗〢乛
婂	女白冂丨
橂	木丷西大
犁	禾刂丿󰀟
灇	氵业䒑又
聇	耳一止󰀝
假	亻󰁃丨又
恇	忄匚王󰀝
㥀	忄十󰀣󰀝
䥀	釒凵丨虫
鱠	󰁢灬人日
鱡	󰁢灬貝
鱢	󰁢灬口木
鱣	󰁢灬亠一
鱤	󰁢灬戊心
鱥	󰁢灬止󰀤
燭	火罒勹虫
覮	火火冖儿
馮	冫󰀋灬󰁶
鱦	󰁢灬黽󰀝
鱧	󰁢灬ㄇ䒑
鱨	󰁢灬⺌日
鱫	󰁢灬爫夂
鱬	󰁢灬󰀙〢
鱭	󰁢灬󰀴󰀳
鱮	󰁢灬󰀗八
鱯	󰁢灬艹又
鱰	󰁢灬罒日
鱱	󰁢灬厂丶
鱲	󰁢灬巛󰁒
鱳	󰁢灬白木
鱴	󰁢灬艹人
鱵	󰁢灬⺮口
馀	⺈󰁐人木
鱶	󰁢灬䒑艮
鱷	󰁢灬王口
䈭	⺮白󰁜厶
㥮	忄勹凵丿
椀	木宀夕⺋
傇	亻艹耳󰀝
䂇	󰁻乛亅一
㤀	丿󰂃󰄃心
鱺	󰁢灬一匕
鱽	󰁢󰀞刀󰁥
鱾	󰁢󰀞己󰁀
鲀	󰁢󰀞一乚
鲃	󰁢󰀞巴󰁀
鲄	󰁢󰀞丁口
舭	丿󰁪󰁴匕
爭	爫󰁬亅󰀬
㭭	木口力刂
鈭	止匕金󰀘
䥇	釒丶尸羽
鲉	󰁢󰀞由󰀝
鲊	󰁢󰀞𠂉二
鲓	󰁢󰀞土ㄅ
猳	犭󰁥󰁃又
䤩	釒宀丿七
囘	冂巳󰁫
慆	忄爫臼󰀝
鲘	󰁢󰀞⺁口
鲙	󰁢󰀞人厶
鲝	⺶󰁢一󰀘
鏳	釒丷󰀺日
鋇	釒貝󰁶
鲪	󰁢󰀞󰁬口
遇	日冂丨辶
鲯	󰁢󰀞󰀎八
鲹	󰁢󰀞厶彡
㪬	羽亻󰁷又
猇	犭󰁥虍几
鲾	󰁢󰀞一田
鲿	󰁢󰀞⺌厶
鳀	󰁢󰀞日󰁾
鳁	󰁢󰀞日皿
鑳	釒宀󰀀󰁾
鳈	󰁢󰀞白水
鳉	󰁢󰀞丬寸
䧬	阝宀一貝
鳑	󰁢󰀞亠方
鳒	󰁢󰀞䒑八
鳚	󰁢󰀞尸二
鳛	󰁢󰀞羽白
鳠	󰁢󰀞艹又
鳡	󰁢󰀞戊心
鳣	󰁢󰀞亠一
鳤	󰁢󰀞⺮󰃧
鳧	󰁟灬几󰀅
馁	⺈󰁐爫女
鮯	󰁢灬人口
鳯	几󰁟灬󰀦
鳳	几一󰁟灬
据	扌尸古󰀝
榁	木宀一土
荮	艹纟寸󰁧
臀	尸󰁺八月
怪	忄又土󰀝
臇	月亻󰁷𠃌
䮯	󰀋灬攵
䦁	钅三丿阝
鳸	丶尸󰁟灬
鳹	人丶乛灬
鳺	夫󰁟灬󰁶
鳻	八刀󰁟灬
鳾	一冂丨灬
鴀	丆卜󰁟灬
爇	艹土八灬
䒳	艹几木󰁧
㦬	忄罒糹󰁷
妬	女石󰀝
鴋	方󰁟灬󰁶
鴏	󰁟灬亻丶
鴐	力口󰁟灬
鴒	人丶󰁻灬
鴓	心丿󰁟灬
畳	田冖󰀐一
鴡	󰀐󰀞󰁟灬
鴥	󰁟灬宀八
鴧	宀几󰁟灬
㔳	匚人良几
魯	󰁢灬日󰀘
鴪	宀八󰁟灬
鴭	丿󰃧󰁟灬
鴯	丆冂〢灬
塁	田󰀪土󰀘
歯	止米凵󰀬
㡁	冂丨大ㄅ
譯	言罒土十
退	彐󰀖辶󰀦
耀	⺌一儿󰁷
㭯	木耳乚󰁀
䭯	禾日凵山
娀	女戈󰁥
鴵	儿󰀪󰁟灬
鴷	一夕刂灬
㪮	󰀙口口又
䋭	糹亠厶月
媮	女人一刂
檮	木士乛寸
狭	犭ノ一大
誮	言艹亻ヒ
鋭	釒丷口儿
鴾	厶丿󰀟灬
鴿	人一口灬
痳	疒木木󰀦
藳	艹󰁸冂禾
鵃	丿󰁪󰁟灬
鵅	夂口󰁟灬
鵆	彳󰁟灬丁
峀	山由󰀘
鵋	己心󰁟灬
鵌	󰁟灬人朩
鵏	甫󰁟灬󰁶
鵒	八人口灬
岃	山刀丶󰁧
鵙	貝󰁟灬󰁶
䁀	目扌斤󰀬
偀	亻艹ㄇ大
㓮	󰀼土口刂
㠁	山厶厶彡
蠁	󰁲丿丶虫
遀	工月辶
栁	木夕卩󰀢
灀	氵󰀙木目
鵚	禾几󰁟灬
岀	山山󰀬
㩮	扌󰀗一手
鵝	丿扌󰁒灬
婮	女尸古󰀝
䩮	廿󰀜󰁭氺
穮	禾󰁙󰁴灬
挭	扌一曰乂
錭	釒󰀼土口
茭	艹六乂󰁧
鵞	丿扌󰁒灬
鵟	犭󰁥王灬
鵠	丿土口灬
鵣	木口󰁟灬
陳	阝木曰󰀝
鵮	⺈臼󰁟灬
鵱	土八土灬
鵳	丶尸月灬
鵶	一󰀚󰀞灬
㠬	工口夫󰁧
鵻	󰁟灬亻󰁷
犇	丿󰀟牜󰀟
昳	日丿夫󰁶
嘳	口口丨貝
㣁	弓󰁺丿用
售	亻󰁷口󰀘
壁	尸口立土
䂀	目丷王丶
蔮	艹囗戈󰀞
悀	忄󰁻用󰀢
攮	扌一口󰀔
甮	勹󰁤用󰀬
鶀	󰁟灬󰀎八
鶂	臼儿󰁟灬
劇	虍一󰀓刂
抇	扌日󰀝
鶃	󰁟灬臼儿
鶇	木曰󰁟灬
㝬	宀三丨夫
鶏	爫夫󰁟灬
鶒	木口力灬
鶔	󰁻乛亅灬
鶕	立日󰁟灬
鶙	亠丷冖灬
鶚	口口二灬
鶜	艹󰁻乛灬
鶝	一口田灬
搇	扌人丶󰀔
鶟	宀八犬灬
佭	亻夂㐄󰀢
㞬	山工󰀘
嚳	󰀗乂乂口
皳	一氺丶皮
鶣	丶尸冂灬
鶩	󰁻乛亅灬
鶫	木󰀹󰁟灬
鶭	糹方󰁟灬
㢁	广夕夕󰀦
䃀	石一󰁬女
僀	亻廿儿丨
梁	氵刀八木
烀	火丿丷󰀛
袁	土口󰀔󰁧
郀	大二ㄅ阝
鶮	󰁸冂口灬
㐇	九乙󰀅
鶰	口貝󰁟灬
鶱	宀󰀀八灬
鶲	八厶羽灬
鶳	󰁟灬丿丨
敇	木冂攵󰁶
鶹	󰁚丶刀灬
鶽	亻󰁷十灬
㕇	厂立󰀌
䱀	󰁢灬ㄇ大
鷁	䒑八皿灬
鷂	爫𠂉十灬
鷇	士冖一又
鷈	󰁟灬⺁几
鷉	⺁虍几灬
鷊	一口冂灬
靁	󰀙田田田
辂	车夂口󰀝
羂	罒糹口月
杁	木丿󰂃󰁶
坁	土󰁚󰀁󰁀
䝁	火火冖䒑
㾂	疒厶口󰀌
鷏	十󰀣八灬
鷐	日厂二灬
䖇	艹木𠂉彡
鷔	󰁡攵灬
鷕	口亻󰁷灬
鷘	木口攵灬
鷜	󰀻女󰁟灬
鷝	曰艹󰀟灬
鷟	方𠂉𠂉灬
鷡	𠂉一󰀷灬
鷤	口口曰灬
鷦	亻󰁷灬灬
峐	山亠ㄥ人
鷩	㡀攵󰁟灬
鷫	󰁬十󰀲灬
鷬	󰁺由八灬
冼	冫丿土儿
鷰	廿口丬灬
鷵	尸土丿灬
鷶	罒貝󰁟灬
鷷	丷西一灬
鷸	󰁻乛亅灬
鷹	广亻亻灬
鷺	口止夂灬
霁	󰀙文󰀯󰀬
鷽	󰀗乂乂灬
省	小丿目󰀘
蜁	虫𠂉乛󰁾
忂	彳目目󰁷
濂	氵广䒑󰁗
㿂	疒山王攵
係	亻丿幺小
菮	艹广󰁬人
簯	⺮木󰀎八
揮	扌冖車󰀢
叮	口丁󰀢
䰯	白󰁜厶󰁾
㰯	一口䒑人
鸃	󰁟灬丷丶
鸄	白方攵灬
鸈	业䒑未灬
鸋	宀心皿灬
鸎	貝貝󰁟灬
鸏	艹冖二灬
鸐	羽亻󰁷灬
摗	扌木口人
㑗	亻丿󰀽丿
鸑	犭󰁥言灬
鸒	󰀗一󰁕灬
鸖	󰀙亻󰁷灬
鸙	人一口灬
鸚	貝貝女灬
郗	乂冂阝
鸜	目目亻灬
鸞	言糹糹灬
撗	扌󰁺由八
蟁	󰁂󰀁虫虫
缂	纟廿󰀜󰀢
嬐	女人一人
韁	廿󰀜一一
伂	亻一冂丨
㟁	山厂干󰀢
柁	木宀匕󰁀
异	巳廾󰀬
琮	王宀二小
误	讠口一大
吮	口厶儿󰁀
毯	丿二乚火
㐮	六󰀀󰀔󰁧
䯯	󰂞彡小丿
蛿	虫人丶口
鸻	彳一丁一
甽	田川󰀢
屾	山山󰀢
攽	八刀攵󰁶
㱾	亠ㄥ丿又
䱾	󰁢灬󰀻女
眿	目丶𠃌󰀩
霿	󰀙󰁻乛目
瓽	⺌冖口丶
鹐	⺈臼󰁠一
冰	冫水󰁶
擽	扌白幺木
閐	門毛󰁫
鹝	一口冂一
鹟	八厶羽一
碏	石󰁺日󰀝
恎	忄一厶土
罂	贝贝󰅎山
畮	田𠂉母󰁶
齂	丿目田氺
镮	钅罒一󰀔
䕮	艹土䒑米
佂	亻一止󰀝
垁	土𠂉大󰁶
潂	氵山䒑业
除	阝人一木
捗	扌止󰀤󰁥
悟	忄五口󰀝
噤	口木木小
纥	纟𠂉乙󰁀
荗	艹戈人󰁧
鹢	䒑八皿一
䨘	󰀙目儿󰀅
慎	忄十󰀣八
挻	扌丿󰀥廴
闐	門十󰀣八
旐	方𠂉儿󰀪
㶑	氵人一人
洯	三丨刀水
鹮	罒一口一
㰃	木白冂小
䎗	丿大口羽
尐	小乙󰀅
掗	扌一󰀚一
帴	冂丨戈戈
玗	王一󰀛󰀢
莗	艹車󰀬
鹥	匚𠂉大一
啽	口人一廾
纂	⺮目大小
赯	土󰁖广口
鵯	白丿十灬
亂	爫󰁻冂乚
㖮	口人一艹
䖮	虫丿冂口
嵯	山䒑󰀠工
浯	氵五口󰀝
讯	讠⺄十󰀢
偟	亻白王󰀝
暤	日白大十
穘	禾土土儿
聟	𠂉大口耳
侗	亻冂一口
鹵	󰀥囗󰁘󰁧
㚤	女󰀁丶󰁶
䩘	廿󰀜一幺
鷴	門木󰁟灬
鹶	󰀥囗󰁘乛
蔐	艹亠丷古
鹷	󰀥囗󰁘󰁻
鹸	󰀥囗󰁘人
攐	扌宀󰀀󰀔
掸	扌丷曰十
鹹	󰀥囗󰁘口
鹺	󰀥囗󰁘工
鹻	󰀥囗󰁘八
羈	罒廿󰀜灬
㙁	土𠂉母󰁶
䃎	石大夕夕
鹼	󰀥囗󰁘人
鹽	匚丨󰁃皿
缯	纟丷󰀺日
绂	纟又丶
囮	囗亻ヒ󰁫
嘁	口厂󰀥丶
郎	丶彐厶阝
闤	門罒一󰀔
蘁	艹王口口
輯	車口耳󰀝
脟	月爫寸󰁶
焟	火󰁺日󰀝
榘	𠂉大匚木
嗤	口凵丨虫
㗤	戊上小口
麀	󰁙󰁴匕匕
麁	ク󰁙󰁴匕
溴	氵丿目犬
麴	木人人米
麃	󰁙󰁴匕灬
麄	八刀󰁙󰁴
竟	立日儿󰀅
琽	王土丿日
麅	󰁙󰁴匕巳
麆	󰁙󰁴匕一
呈	口王󰀘
麊	米󰁙󰁴匕
㤏	忄夂󰁦󰁶
愎	忄𠂉日夂
又	又又又又
㛮	女宀火又
㻂	王䒑廾󰀢
儎	亻十戈車
敐	厂二󰀖攵
囁	口耳耳耳
丂	一ㄅ󰁫
仯	亻小丿󰁥
曁	白匕󰀄一
鸂	氵爫幺灬
蛁	虫刀口󰀝
蜮	虫戈口󰀞
黯	󰀹土灬日
鷥	糹幺小灬
瘤	疒󰁚丶田
觘	⺈用小丿
嘤	口贝贝女
様	木丷王水
㧘	止匕手󰀬
㕐	厂臼勹灬
麍	󰁙󰁴匕󰀸
繴	尸口辛小
拻	扌火󰁶
苻	艹亻寸󰁧
麎	󰁙󰁴匕󰀖
敾	羊䒑口攵
麐	󰁙󰁴匕口
麑	󰁙󰁴匕儿
鄟	一曰丨阝
麕	󰁙󰁴匕禾
麖	󰁙󰁴匕小
钘	钅一廾󰀢
啎	𠂉十五口
麙	󰁙󰁴匕口
麚	󰁙󰁴匕又
㸂	䒑󰀓辶火
麞	󰁙󰁴匕早
乂	乂丿󰂃
幂	冖日大丨
暁	日十艹儿
繂	糹亠幺十
蹂	口止󰁻木
隁	阝匚日女
暐	日󰁆口㐄
嘟	口土丿阝
㑮	亻冖車󰀢
㤘	忄⺈彐󰀝
岯	山丆卜一
䑮	丿󰁪几木
瑮	王覀木󰁶
摮	󰁡攵手
鑮	釒艹氵寸
貯	貝宀丁󰀢
憟	忄覀米󰁶
醟	火火冖一
膟	月亠幺十
嘻	口士口口
昻	曰工卩󰀬
麡	󰁙󰁴匕󰀳
麢	󰁙󰁴匕口
逃	儿󰀪辶󰀦
麤	󰁙󰁴匕匕
麥	木人人夕
撽	扌白方攵
镁	钅丷王大
蕁	艹彐工寸
綂	糹󰁸儿󰁀
敁	󰀥口󰀥又
㚁	土土土儿
嬈	女土土儿
笴	⺮丁口󰀘
蘻	艹車凵小
锂	钅日土󰀝
嵈	山爫一又
麰	木人人󰀟
兎	丿口󰁜丶
㺑	犭󰁥厶彡
嫜	女立早󰀢
㱯	一夕山䒑
䱯	󰁻乛亅灬
屯	一凵乚󰁫
汯	氵厶󰁶
璮	王亠囗一
豯	一󰀓爫大
钮	钅󰁈丨二
罥	罒口月󰀘
腟	月宀一土
鞤	土土寸󰀜
嫴	女古辛󰀢
狴	犭ノ󰁴土
麳	木人人人
麵	木人人二
麹	夕勹米
麺	夕丆二
魈	白󰁜厶月
锁	钅⺌贝󰁶
㑽	亻⺌冖土
緂	糹火火󰁶
蔁	艹立早󰀬
唁	口言󰀝
淂	氵日一寸
䶂	臼󰁐󰁦丶
㕁	乂厶卩
踯	口止䒑阝
痮	疒󰀍󰀖󰀦
旮	九日󰀘
嗮	口日西󰀝
䗮	虫大乂乂
㗮	夕口广人
髴	󰂞彡弓󰀯
筈	⺮丿古󰀘
竴	立丷西寸
麼	广木木幺
麿	广木木口
黀	广木木又
欻	火火⺈人
黂	广木木貝
黃	廿一由八
刟	刀口刂󰀢
䢘	宀寸辶󰀦
㹑	牜󰀁二丶
鈟	釒弓丨󰀢
輥	車曰󰁴匕
碘	石ㄇ󰁺八
梘	木目儿󰁀
含	人丶乛口
鴂	ユ人󰁟灬
喻	口人一刂
幑	彳山丿攵
洂	氵亠󰁖󰁶
崂	山艹冖力
藁	艹󰁸冂木
痁	疒󰀥口󰀌
㔁	癶一口刂
䔁	艹覀木󰁧
瘮	疒厶厶彡
蘮	艹罒厂刂
巯	ス工亠󰀸
淯	氵亠厶月
㘮	土尸󰂃󰁶
䘮	土人人󰀖
昐	日八刀󰁥
黅	󰁺由八乛
黆	󰁺由八󰁜
黇	󰁺由八口
腞	月彑󰀓󰁶
鈏	釒弓丨󰀢
爏	火厂禾止
檈	木罒一󰀔
修	亻丨夂彡
㞭	大山󰀬
黊	󰁺由八土
黋	⺌一儿八
黌	󰀗乂乂八
襁	衤󰁧弓虫
壘	田田田土
黒	曰土灬󰁧
㻥	王丷西一
蜤	木斤虫󰁧
霤	󰀙󰁚丶田
朤	月月月月
眤	目尸匕󰁀
䭴	󰀋灬十󰀬
嗻	口广廿灬
赏	⺌冖口贝
鶁	󰁸小󰁟灬
黕	󰀹土灬󰁜
㸑	󰀗ㄇ一火
晐	日亠ㄥ人
嶁	山󰀻女󰀝
涁	氵木彡󰁥
痀	疒勹口󰀌
藀	艹火火火
黖	󰀹土灬󰁜
黗	󰀹土灬乚
㗀	口山幺幺
䶁	士口䒑日
迮	𠂉丨二辶
翮	一口冂羽
枭	󰁠木󰁧
垭	土一󰅊一
㝭	宀忄日
䝭	貝勹口󰀝
黙	曰土犬灬
意	立日心󰁧
黚	󰀹土灬甘
點	󰀹土灬口
垐	冫⺈人土
翵	羽󰁟灬󰁶
俵	亻󰀔󰁶
丈	󰂃󰀦
縈	火火冖小
悦	忄丷口儿
脻	月一󰁬󰁾
栲	木土丿ㄅ
匫	匚勹󰁤曰
栤	木冫水󰁶
㠤	山亠口󰀔
門	門丨󰁈一
侙	亻󰀁工丶
黣	󰀹土灬母
淁	氵立女󰀝
喀	口宀夂口
薀	艹氵囗皿
疀	巛田一󰁾
黤	󰀹土灬乚
黦	󰀹土灬⺋
靭	廿󰀜刀丶
㷁	火󰁻用󰀢
睭	目󰀼土口
蝭	虫曰一󰁾
坭	土尸匕󰁀
杭	木亠几󰁀
弭	弓耳󰀝
伭	亻亠幺󰁶
缭	纟大丷小
曬	日一ㄇ匕
鼭	臼󰁐󰁦寸
輭	車丆冂大
瀗	氵宀三心
黨	⺌冖口灬
対	文寸󰁶
黫	󰀹土灬土
錫	釒日勹󰁤
羙	丷王火󰁧
茫	艹氵亠󰄃
宗	宀二小󰁧
未	二󰅇󰀦
黰	󰀹土灬八
葀	艹扌丿古
鑀	釒爫冖夂
氁	毛艹曰大
簁	⺮彳止󰁾
黲	󰀹土灬彡
黴	彳山一攵
㙏	土𠂉日夂
么	丿厶󰁧
虏	󰅋七力󰀏
鹈	丷弓丨一
濙	氵火火火
垘	土亻犬󰁶
䑀	月尸口辛
封	土土寸󰁶
㼭	土󰀥口丶
㑀	亻大丶󰁶
仭	亻刀󰂃󰁶
圬	土二ㄅ󰁀
本	木一󰀌
续	纟十乛大
蜬	虫了󰀪凵
黭	󰀹土灬廾
㟤	山󰁭氺󰁧
黵	󰀹土灬言
蔝	艹目米󰁧
黸	󰀹土灬皿
韐	󰁆口㐄口
蟐	虫⺌冖丨
矐	目󰀙亻󰁷
偨	亻止匕木
黺	业㡀八刀
质	⺁十贝󰀦
鱁	󰁢灬一辶
豁	宀三丨口
籁	⺮一口贝
汁	氵十󰀢
螘	虫山一䒑
翙	山夕羽󰀝
黽	黽󰄃󰁈一
黿	二儿黽󰀘
榱	木亠口󰀔
灵	彐火󰁧
鼂	曰一黽󰀘
够	勹口夕夕
吀	口丿十󰀢
䐀	月大丁口
㐀	丨一󰀥一
㻭	王亠幺十
䂻	石󰀍󰀖󰁶
梴	木丿󰀥廴
炻	火石󰀝
鶈	一󰁬丨灬
墭	土戊𠃌皿
䢭	丷王冫辶
㢭	弓󰀥又󰁶
朏	月凵山󰀢
䢤	禾木丶辶
劫	土厶力ノ
披	扌󰅌又󰁶
鼃	土土黽󰀘
䜐	阝工言
幆	冂丨曰󰄃
鼅	𠂉大口黽
鼆	冖日六黽
擀	扌十日干
粁	米丿十󰀢
蓀	艹孑丿小
铀	钅由󰀝
鼇	󰁡攵黽
鈾	釒由󰀝
喤	口白王󰀝
硘	石囗口󰀝
颭	几丿虫口
袭	ヒ丶󰀔
灬	灬丶丶丶
梭	木厶八夂
銫	釒⺈巴󰁀
㲁	宀八工又
䓀	艹士口󰀘
哀	󰁸󰀔󰁧
䧿	󰁺日亻󰁷
爾	一八冂乂
鼊	尸口辛黽
䊘	米由月󰀝
䡭	車⺶󰁈一
塭	土曰皿󰀝
鼘	士口䒑一
㡭	幺幺一󰄃
榨	木宀八二
䝐	一󰀓阝月
塴	土山月月
䃻	石󰀙廿月
硴	石艹亻ヒ
桴	木爫子󰀝
郻	目󰄃巛阝
曏	曰󰁲丿阝
糁	米厶大彡
況	氵口儿󰁀
钀	釒虍一犬
蒀	艹曰皿󰀘
緈	糹土䒑十
栘	木夕夕󰁶
鼚	士口䒑󰀖
鼛	士口䒑口
衭	衤󰁧夫󰁶
邬	勹ㄅ󰀞阝
悬	󰀐一厶心
硭	石艹亠󰄃
㳁	氵厂人󰁶
鼝	氵󰀲一又
峁	山󰁚丿卩
䳁	󰁟灬丶
鼟	士口䒑䒑
䇾	⺮言󰀘
䠭	口止木貝
㠭	工工工工
苫	艹󰀥口󰀘
硤	石大人人
鼣	臼󰁐󰁦犬
鼤	臼󰁐󰁦文
鼥	臼󰁐󰁦丶
鼦	臼󰁐󰁦口
圖	囗口十口
鼨	臼󰁐󰁦󰁦
漯	氵田ㄠ小
鼪	臼󰁐󰁦
鼫	臼󰁐󰁦石
喜	士口䒑口
嬁	女癶一䒑
欁	木ㄇ󰁺木
㬁	日氵人口
䍀	纟〢𠂉皿
鼰	臼󰁐󰁦貝
鼱	臼󰁐󰁦月
㤤	忄日乂󰁶
鼲	臼󰁐󰁦車
鼳	臼󰁐󰁦犬
齮	止󰀆大口
椤	木罒夕󰁶
亙	一丨󰁈一
鬁	󰂞彡禾刂
堭	土白王󰀝
轮	车人匕󰁀
砭	石丿之󰁶
㐻	亻冂人󰁶
䴴	木人人口
㾮	疒白王󰀌
䀬	目人王󰀝
蛘	虫䒑󰀟󰀢
雘	冂亠艹又
砃	石󰀼亠󰀝
唿	口勹󰁤心
鼴	臼󰁐󰁦女
悾	忄宀八工
焾	火人丶乛
鼸	臼󰁐󰁦八
鼺	臼󰁐󰁦田
㽟	田爫寸󰁶
齅	丿目田犬
齇	丿目田一
挀	扌⺁󰀕󰁶
匀	勹冫󰀌
䭁	扌斤人艮
㭁	木乃󰁥
齌	󰀴󰀳火󰁧
㻙	王亠厶月
䁾	目艹罒人
齍	󰀴󰀳皿󰀘
韭	丨三丨一
鳴	口󰁟灬󰁶
皘	白月󰀝
怟	忄󰁚󰀁丶
倬	亻󰀥早󰀢
柭	木又丶
短	𠂉大一䒑
筁	⺮ㄇ󰁺󰀘
剫	广廿又刂
䀟	目弓󰀯󰀢
速	一口󰅇辶
軙	車󰀥又󰁶
鱿	󰁢󰀞丶
齏	󰀴󰀳丨一
齒	止󰀆󰀬
齓	止󰀆乚󰁀
慬	忄廿口
妭	女又丶
䦭	門禾日󰀌
㦭	忄󰀙口人
齔	止󰀆匕󰁀
齕	止󰀆𠂉乙
齖	止󰀆󰀄丿
齗	止󰀆斤󰀢
㮁	木乂月
䮁	󰀋灬厶廾
叀	一由厶󰁧
殁	一夕几又
齙	止󰀆勹巳
馭	󰀋灬又󰁶
覭	冖曰六儿
煬	火日一󰁤
齚	止󰀆𠂉二
齛	止󰀆廿󰄃
齜	止󰀆止匕
齝	止󰀆厶口
箁	⺮立口󰀘
菀	艹宀夕⺋
鏀	釒󰀥囗󰁘
齞	止󰀆口八
齟	止󰀆󰀐一
齠	止󰀆刀口
齢	止米凵󰁻
齣	止󰀆勹口
䦤	門又又又
涴	氵宀夕⺋
漙	氵一曰寸
睘	罒一口󰀔
奭	大丆日日
憬	忄日亠小
㥭	忄三人氺
䆬	宀八口貝
靘	月⺈巴
䶴	火⺈人艹
钝	钅一凵乚
齤	丷夫止󰀆
䯁	󰀋灬󰄹丶
㯁	木阝立口
掀	扌斤⺈人
厀	木人氺卩
饭	⺈󰁐⺁又
陗	阝⺌月󰀝
熬	主󰁡夂灬
襭	衤󰁧士貝
齥	止󰀆曰丿
齦	止󰀆艮󰁶
齨	止󰀆臼󰀝
怎	𠂉丨二心
证	讠一止󰀝
篁	⺮白王󰀘
锦	钅白冂丨
鎀	釒亻丨彡
齪	止󰀆口󰁾
齫	止󰀆囗木
齬	止󰀆五口
齭	止󰀆⺁斤
㤭	忄丿大󰀯
齯	止󰀆臼儿
夭	丿大󰀦
䃬	石山白厶
齰	止󰀆󰁺日
齱	止󰀆耳又
瘞	疒大人土
㽙	田厶儿󰁀
齳	止󰀆冖車
團	囗一曰寸
䥤	釒󰀙勹巳
眘	大丷目󰀘
潙	氵爫丿灬
㨁	扌十󰀣󰀝
臫	丿目乚󰁀
齴	止󰀆立彡
所	⺁󰁃斤󰀢
稁	󰁸冖禾󰁧
䉀	⺮广廿灬
剀	山󰁁刂󰀢
烬	火尸󰂃󰁦
椭	木阝月
郬	月阝󰀢
胬	女又冂人
齵	止󰀆日丶
垿	土广󰁻亅
噜	口󰁢一日
䎸	耳五口󰀝
齸	止󰀆䒑皿
囊	一口丨󰀔
沙	氵小丿ノ
擫	扌厂日犬
齹	⺶工止󰀆
㣭	彳乂凵夂
䣭	西一犬󰁶
儬	亻月儿
剴	山一口刂
專	一曰丨寸
檵	木幺幺󰄃
骵	󰀾月木一
撏	扌彐工寸
騤	󰀋灬癶大
殷	⺁彐𠃌又
稤	禾󰁸小󰁶
㩁	扌宀亻󰁷
愫	忄主ㄠ小
䗘	虫土厶皿
另	口力󰁣
爀	火土󰁖󰁖
橁	木⺮勹日
刀	刀𠃌丿
䩁	丨三丨毛
棭	木亠亻丶
焬	火曰勹󰁤
脬	月爫子󰀝
鄬	爫丿乛阝
龂	止人凵斤
醾	西一广米
膾	月人一日
垧	土丿冂口
膐	方𠂉󰀕人
憐	忄米夕㐄
蜉	虫爫子󰀝
龒	立月一小
龓	月立三
龔	立月一八
㝧	宀女人土
颇	󰅌又丆贝
㪭	虍田皿又
灆	氵艹匚皿
梇	木王廾󰀢
偆	亻三人日
䁆	目大日乚
檭	木釒艮󰁶
剬	山丆冂刂
䉬	⺮广癶又
龜	丿󰁵󰀌
䊴	米⺮人人
骭	󰀾月干󰀢
読	言士冖儿
䋀	丶尸幺小
勀	古儿力󰁥
拀	扌口儿󰁀
突	宀八犬󰁧
誁	言䒑廾󰀢
鋀	釒一口䒑
銴	扌斤金󰀘
葏	艹氵󰁬󰀟
龝	禾丿󰁵󰀝
駤	󰀋灬一土
觤	⺈用⺈⺋
煫	火䒑󰀓󰁶
斘	夕󰁦十󰀢
姤	女⺁一口
䅫	禾亠日小
㧤	扌亠厶儿
龞	㡀攵丿󰁵
慾	八人口心
邆	癶一口辶
龡	人一口人
硇	石丿囗乂
肆	󰀍厶󰁬󰀟
傆	亻厂白小
桇	女口木󰁧
㡇	冂丨耳乚
犬	大丶󰀦
䩭	廿󰀜大口
劬	勹口力ノ
龢	人一口禾
龣	人一口氺
㫁	幺幺一斤
驭	󰀊󰀞又󰁶
嫁	女宀一󰀓
䊀	米古󰀝
犀	尸氺丿󰀟
櫁	木宀心虫
髁	󰀾月日木
諁	言又又又
瘇	疒丿一土
龴	󰁻乛丶
龵	丿一丿
瀾	氵門木󰀹
㔏	石石石刂
怾	忄口八󰁶
騵	󰀋灬厂小
攏	扌立月三
稵	禾䒑幺幺
懴	忄十戈󰀞
邫	三丿口巴
龶	一一一
龷	󰁺一丨一
傫	亻田幺小
䨭	󰀙二厶月
㨭	扌丶尸巴
樭	木󰀎八土
娭	女厶𠂉大
龹	丷夫󰀦
㙘	土覀女󰀝
丙	一冂人󰀦
龺	十早󰀬
龻	言糹糹󰁶
赸	土󰁾山󰀵
崈	宀二小山
蛉	虫人丶󰁻
臬	丿目木󰁧
稭	禾󰁴匕白
儐	亻宀一貝
騭	阝止󰀤灬
㣡	彳亻口丨
涧	氵门日󰀝
﨑	山立口亅
䵞	󰀹土灬刂
﨔	木󰀧一手
擏	扌艹勹攵
篈	⺮土土寸
䯈	󰀾月二儿
爴	囗戈口󰂃
頿	彡止匕貝
驤	󰀋灬亠󰀔
蓏	艹⺁厶󰂃
鯈	亻丨夂灬
湙	氵亠󰁖大
婤	女󰀼土口
胫	月ス工󰀝
㧭	工阝手󰀬
䧭	阝丿囗心
刬	一戈刂󰀢
槭	木厂󰀥丶
诞	讠丿止廴
簀	⺮貝󰁧
䩤	廿󰀜目儿
趍	土󰁾夕夕
㓸	匚󰁃󰀚刂
夑	言火火夂
绶	纟爫冖又
䤑	西一󰁺八
秭	禾丿ㄅ丿
觭	⺈用大口
鈬	釒尸󰂃󰁶
黶	厂曰月灬
枵	木口一ㄅ
垵	土宀女󰀝
慐	工貝心󰁧
老	土丿匕󰀅
嫑	丆卜覀女
娶	耳又女󰀘
銐	一夕刂金
犐	牜禾󰁦十
姀	女禾󰁶
槀	󰁸冂口木
秀	禾乃󰁣
觀	艹口口儿
㖎	口匕人󰀯
悉	丿米心󰁧
㧀	丶尸乃󰂃
䧀	阝厶󰁶
擦	扌宀󰁯小
嬖	尸口立女
䣿	西一一皿
䓘	艹夂卜口
岙	丿大山󰀬
匚	匚一󰄃
鍭	釒亻ユ大
㬤	日日幺灬
獭	犭ノ一贝
荭	艹纟工󰀘
卭	工卩󰀢
氮	󰅎⺄火火
㰮	厂二󰀖人
䍭	⺶母󰁶
杵	木𠂉十󰀢
夿	大巴󰀅
惾	忄乂凵夂
撑	扌⺌冖手
扐	扌力󰁥
蜈	虫口一大
四	四丨󰁈一
鑫	金釒金󰀘
涏	氵丿士廴
蒘	艹女口手
榀	木口口口
倇	亻宀夕⺋
覀	覀一丨一
禀	亠囗口小
竤	立宀厶
恫	忄冂一口
䦀	钅羽󰀝
㦀	忄夂三辶
玐	王八󰁶
嫤	女廿口
䳙	由一ㄅ灬
㳙	氵厶月󰀝
䞿	宀󰀀八󰁾
罶	罒󰁚丶田
㼸	宀八人丶
鯮	󰁢灬宀小
莭	艹󰁮卩󰀬
玭	王󰁴匕󰁀
掭	扌一大⺗
寮	宀大丷小
䯮	󰂞彡乃󰁣
㯮	木罒勹虫
匝	匚冂丨󰀵
嘼	口口田口
剰	禾󰁺刂󰀢
鉂	釒口乂󰁶
洙	氵󰅎󰅇󰁶
箤	⺮亠人十
駀	󰀋灬丶
淏	氵曰一大
㷏	禾𠂉十火
扂	丶尸󰀥口
䡀	丿󰀽三一
塀	土尸䒑廾
鴣	古󰁟灬󰁶
㡀	㡀丶丿丶
腇	月禾女󰀝
顀	亻󰁷丆貝
桀	夕󰀂丨木
煇	火冖車󰀢
工	工工工工
䴙	尸口辛一
㬭	日爫罒寸
啘	口宀夕⺋
勬	丷夫幺力
䬭	口刀人艮
独	犭ノ虫󰁶
欭	囗大⺈人
鋬	扌⺁又金
謭	言䒑月刀
㛵	女爫冂土
已	已已已已
箼	⺮尸一土
憝	󰁸孑攵心
弿	宀󰀀八弓
㳑	氵皿󰀝
䳑	月󰁟灬
瑛	王艹ㄇ大
筤	⺮丶艮󰁧
此	止匕󰁀
嗎	口󰀋灬󰁶
丏	一丨󰄃𠃌
朾	木丁󰀢
䲑	󰁢灬丷丶
冇	冂󰀅
䠀	口止⺌口
㠀	󰁟灬山󰀬
缘	纟彑󰀓󰁶
醇	西一亠子
蠀	虫冫⺈貝
砀	石ㄋ󰁤ノ
栀	木⺁一⺋
㔼	扌亻󰁷十
㵙	氵士口口
襞	尸口立󰀔
㫭	日土寸󰁧
䫭	口丨一貝
嫭	女虍丿󰀛
櫭	木󰁮󰀄一
猬	犭ノ田月
茬	艹丨土
髭	󰂞彡止匕
擼	扌󰁢灬日
䓼	艹女丶
摐	扌彳人󰁾
葐	艹八刀皿
䖑	虍几日󰀌
霫	󰀙羽白󰀘
鳏	󰁢󰀞罒󰀫
箙	⺮月卩又
蜫	虫曰󰁴匕
圫	土丿七󰁀
揘	扌白王󰀝
㰤	丁口⺈人
䮙	󰀋灬戈󰀞
閼	門方人󰁦
喼	口⺈彐心
㣀	弓十󰀣八
䃇	石白冂丨
僇	亻羽人彡
惇	忄󰁸子󰀝
烇	火人王󰀝
胇	月弓󰀯󰀢
郇	勹日阝󰀢
攻	工夂󰁶
唻	口木人人
稈	禾曰干󰀢
銏	釒󰀼󰀼一
芏	艹土󰀘
敼	士口䒑又
㕼	口勹乂󰄃
巒	言糹糹山
䴮	木人人山
呭	口廿󰄃󰁀
溫	氵囗人皿
㑭	亻田一󰀯
葭	艹󰁃丨又
鴮	大二ㄅ灬
摭	扌广廿灬
瑭	王广󰁬口
攑	扌󰀗一󰀟
㔑	艹丿󰃧刀
搼	扌丷夫手
䶒	󰀴󰀳女󰀘
嶒	山丷󰀺日
靫	廿󰀜又丶
莘	艹辛󰀬
篤	⺮󰀋灬󰁧
㢀	广木冂󰁫
寙	宀⺁厶󰂃
儇	亻罒一󰀔
䢀	车𠂉乙󰁀
焇	火⺌月󰀝
愇	忄󰁆口㐄
鄇	亻ユ𠂉阝
袀	衤󰁧勹冫
秒	禾小丿ノ
䰽	󰁢灬一丨
幒	冂丨丿心
郝	土󰁖阝󰀢
詈	罒言󰀘
驈	󰀋灬󰁻口
新	立木斤󰀢
眠	目󰁃󰁐弋
咭	口士口󰀝
䒭	艹ユ寸󰁧
㳮	氵尸水󰁶
鑼	釒罒糹󰁷
钭	钅󰁦十󰀢
蒭	艹勹凵丿
璭	王冖車辶
播	扌丿米田
猼	犭󰁥甫寸
昑	日人丶乛
嘑	口虍丿󰀛
䫽	几丿虫毛
匏	大二ㄅ巳
皫	白󰁙󰁴灬
葘	艹巛一田
鑘	釒田田田
䙑	衤󰁧亠󰀔
㚫	女乃󰂃󰁶
尙	小冂口󰀘
暫	車斤曰󰀘
瘑	疒冂󰁈口
銸	釒耳乚󰁀
憕	忄癶一䒑
䒻	艹山巳󰀅
鼁	土厶黽󰀘
蒻	艹弓冫冫
缁	纟巛田󰀝
輁	車󰁺八󰁶
址	土止󰀝
杀	乂木󰁧
㝀	母子󰀝
企	人止󰀘
宮	宀口丿口
揭	扌日勹󰄃
箮	⺮宀一一
菭	艹氵厶口
挏	扌冂一口
典	ㄇ󰁺八󰁧
㮮	木三丨手
䮮	󰀋灬木夕
颉	士口丆贝
䍼	⺶󰀄󰁜日
舽	丿󰁪夂㐄
奾	女山󰀢
㜑	氵甫女󰀘
韑	⺌一儿㐄
臽	⺈臼󰀘
懽	忄艹口󰁷
蛫	虫⺈厂⺋
籤	⺮人人󰀞
䦾	丿󰃧厶儿
雫	󰀙一卜󰁧
䐘	月爫一又
㛫	女日勹󰁤
汤	氵ㄋ󰁤ノ
屙	尸阝丁口
垓	土亠ㄥ人
齁	丿目田口
蜀	罒勹虫󰁧
罁	𠂉十凵冂
最	日耳又󰁧
彁	弓丁口口
佁	亻厶口󰀝
㽁	厂禾禾丶
歮	止止止󰀘
吭	口亠几󰁀
譮	言人一日
琭	王󰁭氺󰁶
瓻	乂冂丶
铻	钅五口󰀝
䭮	󰂞彡䒑目
㐭	亠囗口󰀘
駈	󰀋灬丘󰀝
翟	羽亻󰁷󰀘
䫾	几丿虫丿
柜	木匚󰁃󰀝
䣑	厂日土阝
楮	木土丿日
烐	火丿󰁪󰁶
刭	ス工刂󰀢
鄡	󰁟木阝󰀢
馵	󰀋灬廾󰀬
牽	亠幺冖󰀟
愽	忄甫寸󰁶
䴈	丿ㄇ米灬
妵	女丶王󰀝
䘫	女口亠󰀔
鄽	广曰土阝
羁	罒廿口一
蟀	虫亠ㄠ十
韀	廿󰀜󰁙灬
鴤	󰁟灬夂󰁦
㾁	疒木丶󰀦
䟀	土󰁾⺶工
埀	丿一丬土
澁	氵止止止
䠑	口止大土
哨	口⺌月󰀝
树	木又寸󰁶
膽	月⺈厂言
鴈	厂亻󰁟灬
醽	西一󰀙口
憽	忄艹勹心
熽	火󰁬十󰀲
鸮	口一ㄅ一
桨	丬夕木󰁧
縮	糹宀亻日
踮	口止广口
啭	口车二丶
渮	氵艹丁口
㕭	口丿大󰁶
丮	⺄󰀟󰀵
枙	木厂⺋󰁀
归	リ彐󰀝
掮	扌丶尸月
怽	忄未󰁶
醴	西一ㄇ䒑
瀽	氵宀󰀀󰁾
䝾	一󰀁止貝
䤒	西一幺人
螀	丬夕寸虫
翁	八厶羽󰀘
冴	冫󰀄亅丿
鞀	廿󰀜刀口
俁	亻口󰁕大
㞀	乚火
濁	氵罒勹虫
垀	土丿丷󰀛
熴	火山曰󰁴
浈	氵󰀥贝󰁶
森	木木木󰁧
愑	忄󰁻用力
髙	亠〢二口
忉	忄刀ノ
壾	士口䒑󰁃
酑	西一一󰀛
䦒	門石󰀌
鷮	丿大口灬
薭	艹禾白十
疭	疒人人󰀦
断	米󰄃斤󰀢
喭	口立丿彡
䖭	丷夫虫󰁧
㷮	火一ㄇ日
素	主ㄠ小󰁧
值	亻十󰀣󰀝
災	巛火󰁧
䩒	廿󰀜一󰀛
傀	亻白󰁜厶
㸁	火业䒑未
㙾	土󰀗乂子
䫒	󰁚󰀁日貝
渁	氵水水󰁶
癀	疒󰁺由八
丁	丁一亅
币	丿冂丨󰀵
㹿	犭󰁥󰀥早
颁	八刀丆贝
踁	口止一工
陀	阝宀匕󰁀
㪒	臼儿󰀥又
㓭	日勹人刂
䲮	二儿󰁟灬
岮	山宀匕󰁀
沮	氵󰀐一󰀝
瓭	冖󰁜一丶
蓭	艹广大乚
铭	钅夕口󰀝
䪒	󰁆口㐄王
胴	月冂一口
礵	石󰀙木目
欙	木田田小
綤	刀口阝小
薫	艹丿一灬
鶤	冖車󰁟灬
牑	丿丨一艹
䟾	口止又又
谡	讠田八夂
嚼	口爫罒寸
孒	了一󰀌
㹁	牜󰁸小󰁶
鐏	釒丷西寸
叩	口卩󰀢
骨	󰀾月󰀘
瘀	疒方人󰁦
昀	日勹冫󰀝
嘀	口亠丷古
䘀	丿󰃧十虫
鏑	釒亠丷古
揑	扌臼工󰀝
鹁	十冖孑一
蘀	艹扌罒十
㔭	󰁴日一󰁾
䬒	几丿虫又
屮	凵丨󰀵
䔭	艹宀心用
甭	丆卜月丨
攭	扌彑󰀓虫
锭	钅宀一󰁾
蔭	艹阝人厶
嬒	女人一日
警	艹勹口言
猥	犭ノ田󰀖
挥	扌冖车󰀢
猑	犭󰁥曰匕
沈	氵冖󰁜󰁀
㦂	⺌冖口心
㵤	氵羽大人
䦂	钅丶尸羽
叏	ユ丨又󰁧
儴	亻亠口󰀔
䳈	󰁟灬勹巳
鵤	⺈用󰁟灬
藫	艹氵覀早
⺁	⺁丿丿
㛀	女⺈彐󰀝
亁	十曰干乙
囀	口車一寸
溁	氵艹冖木
纁	糹丿一灬
蛀	虫丶王󰀝
雀	小亻󰁷󰀘
㲸	氵乙󰁀
捑	扌日󰁕󰂃
獑	犭󰁥車斤
䮒	󰀋灬甫󰁶
糈	米乛󰁾月
宒	宀毛󰀅
蛪	三丨刀虫
㙭	土厂䒑人
㷸	火日一󰀟
擿	扌亠丷辶
漮	氵广󰁬氺
缮	纟䒑󰀟口
伮	亻女又󰁶
噭	口白方攵
璑	王𠂉一灬
屒	尸厂二󰀖
輮	車󰁻乛木
陭	阝大丁口
燘	火門文󰁶
臘	月巛囗󰁒
帤	女口冂丨
攫	扌目目又
䦙	門士寸󰀦
贿	贝月󰀝
㻁	王囗口󰀝
撿	扌人一人
嚀	口宀心丁
仁	亻二󰀝
绁	纟廿󰄃󰁀
滁	氵阝人木
黁	广木木日
蚀	⺈󰁐虫󰁶
㒿	󰀰亠乂󰁷
㰒	木󰀗乂子
䰒	󰂞彡艹󰀓
擑	扌口耳丶
䥂	釒冖二󰀓
啿	口󰀎八󰄃
㻮	王󰁯二小
洒	氵西󰀝
熁	火力力月
憁	忄丿囗心
皭	白爫罒寸
暭	日白󰀪十
嚭	士口䒑口
仮	亻⺁又󰁶
驙	󰀋灬亠一
聁	耳八刀󰁥
黮	󰀹土灬󰄃
蚭	虫尸匕󰁀
觙	⺈用乃󰂃
淤	氵方人󰁦
冘	冖󰁜󰁫
态	大丶心󰁧
䢂	车立󰀝
墂	土覀二小
沸	氵弓󰀯󰀢
岒	山人丶乛
瑑	王彑󰀓󰁶
嗿	口人丶貝
𠃌	𠃌𠃌〇〇
恭	󰁺八⺗󰁧
遭	一ㄇ󰁺辶
殒	一夕口贝
薿	艹匕𠂉󰁾
斿	方𠂉子󰀝
喿	口口口木
焍	火丷弓丿
鴁	丿大󰁟灬
桎	木一厶土
畀	田一󰀯󰀬
贁	貝貝攵󰁶
崁	山土⺈人
洁	氵士口󰀝
痭	疒月月󰀌
䴁	宀日冂灬
闭	门󰀛丿󰀏
拉	扌立󰀝
㶮	一冂人火
䶮	匕丶大
嗭	十󰀣口匕
涮	氵尸冂刂
纤	纟丿十󰀢
旰	日干󰀢
毖	󰁴匕心丿
㨙	扌爫幺大
䨙	󰀙氵丿士
屸	山工󰀝
鋺	釒宀夕⺋
琐	王⺌贝󰁶
䡂	車󰁐丨󰀢
屑	尸⺌月󰀌
迲	土厶辶󰀦
㐿	亻手󰀢
䪸	󰁂󰀁丆貝
瞂	⺁十目丶
鐿	釒立曰心
汆	丿󰂃水󰁧
㯸	木󰁬丨皿
苿	艹未󰁧
椎	木亻󰁷󰀝
鵁	六乂󰁟灬
蔀	艹立口阝
絁	糹𠂉也󰁀
攀	木乂乂手
嵁	山󰀎八󰄃
䵁	木人人寸
㔀	日󰁸小刂
略	田夂口󰀝
阭	阝厶儿󰁀
䵮	󰀹土灬󰁤
㘭	土幺𠃌󰁀
昭	日刀口󰀝
嘭	口士口彡
廽	囗〢二廴
滽	氵广󰁬丨
绽	纟宀一󰁾
軽	車又土󰀝
樐	木󰀥囗󰁘
娐	女爫子󰀝
䆗	宀八口丨
份	亻八刀ノ
繤	艹目大小
㰸	人一口人
䓫	艹大丁口
銄	釒丿冂口
犿	犭󰁥亠卜
镥	钅󰁢一日
學	󰀗乂乂子
伃	亻󰁻乛亅
蝂	虫丿丨又
䄣	礻󰁶士貝
儣	亻广󰁺八
愣	忄罒方ノ
埋	土日土󰀝
怠	厶口心󰁧
蹊	口止爫大
搞	扌󰁸冂口
曂	日󰁺由八
磎	石爫幺大
壎	土丿一灬
鉘	釒弓󰀯󰀢
焣	耳又灬󰁧
脣	厂二󰀖月
鄣	立早阝󰀢
䃘	石匚丨土
曼	日罒又󰁧
囼	囗厶口󰀌
煗	火丆冂大
腗	月由一󰀯
兗	六口儿󰀅
橐	一口丨木
㩐	扌⺮土寸
䩐	廿󰀜𠂉乙
僘	亻⺌冂攵
宣	宀一日一
萫	艹禾日󰀘
楏	木大土土
発	癶二儿󰀅
膎	月爫幺大
粿	米曰木󰁶
䬸	一夕又艮
䅣	禾白王󰀝
路	口止夂口
慣	忄毌貝󰁶
兣	古儿厂土
泊	氵白󰀝
黄	󰁺由八󰁧
㸃	󰀹土󰀥灬
戸	一尸󰁣
寔	宀曰一󰁾
䩹	廿󰀜一丨
㖂	口日󰁒丿
寞	宀艹日大
霼	󰀙二厶米
煣	火󰁻乛木
斂	人一口攵
酣	西一艹二
佽	亻冫⺈人
彽	彳󰁚󰀁丶
釸	釒夕󰁶
㞼	了󰀩山󰀬
螼	虫廿口
齽	止󰀆木小
潽	氵䒑业日
罽	罒厂火刂
㮐	木小丿目
呫	口󰀥口󰀝
吗	口󰀊一󰀝
䮐	󰀋灬冂口
箐	⺮主月󰀘
搗	扌󰁟山󰀢
鐗	釒門月󰀝
讐	亻󰁷亻󰁷
㻤	王艹勹口
葫	艹古月󰀘
磙	石六厶󰀔
閺	門曰文󰀦
患	口口丨心
炣	火丁口󰀝
䂣	石止匕󰁀
傣	亻三人氺
㶃	氵氵𠂉灬
旂	方𠂉斤󰀢
肣	月人丶乛
那	𠃌󰀠阝󰀢
䵃	木人人八
扸	扌丿丨󰁈
唂	口八人口
牸	牜宀子󰀝
徽	彳山一夂
䝼	貝月󰀝
㝼	乚一󰀛
愸	木人人心
靼	廿󰀜曰一
蝼	虫米女󰀝
羽	羽𠃌丶󰀞
杼	木󰁻乛亅
峃	󰀧冖山󰀬
㯐	阝工木
䯐	󰀾月冂人
寐	宀󰄃丨󰅇
揗	扌⺁十目
篐	⺮木匚丨
菗	艹扌由󰀘
鏗	釒匚丨土
厸	厶厶󰁶
渻	氵小丿目
䙺	火目儿󰁀
岁	山夕󰁧
烣	火火󰁶
惣	牜勹󰁤心
僣	亻夫夫日
䃣	石爫丿灬
褛	衤󰁧米女
䅘	禾木人人
郣	十冖孑阝
胣	月𠂉也󰁀
痺	疒白丿十
舎	人土口󰀘
鶻	󰀾月󰁟灬
慸	廿儿冖心
礐	󰀗乂乂石
㠼	冂丨斤󰀢
夐	⺈ㄇ人夂
䊗	米白王󰀝
格	木夂口󰀝
砼	石人工󰀝
銗	釒⺁一口
芗	艹󰁲丿󰁣
葂	艹⺈口力
玂	犭󰁥艹斤
莂	艹口力刂
䞹	土󰁾白王
䯃	󰀊󰀞宀女
䠹	丿󰀽三人
㿺	日󰁺八皮
猂	犭󰁥曰干
聸	耳⺈厂言
稣	󰁢󰀞禾󰁶
准	冫亻󰁷󰀝
鍂	釒金󰀝
䀣	目心丿󰁥
倣	亻方攵󰁶
怣	丿夫心󰁧
瀣	氵󰀥夕一
耣	二木人艹
連	車辶󰀵
滨	氵宀󰅍八
奙	厶大曰乚
㤐	󰀥口心󰁧
潤	氵門王󰀝
樏	木田幺小
脘	月宀二儿
楐	木田人󰀯
祐	礻󰁶口
䉗	⺮扌口耳
剗	戈戈刂󰀢
矼	石工󰀝
柼	木宀八󰁶
韼	立日夂辶
蟼	艹勹口虫
憾	忄厂一心
谓	讠田月󰀝
媃	女󰁻乛木
䋂	糹乂乂󰁶
阈	门戈口󰀞
戂	忄广木三
爂	󰀗ㄇ一火
䩃	丆囗〢匕
涻	氵人干口
婃	女宀二小
忘	亠󰄃心󰁧
熂	火气米󰁶
偣	亻立日󰀝
䁣	目一日寸
灣	氵言糹弓
恣	冫⺈人心
遣	口丨一辶
聣	耳臼儿󰁀
鬫	丨王王攵
䱿	󰁢灬車斤
笫	⺮丿ㄅ丿
㥐	人一口心
㒾	󰀰方𠂉也
茁	艹凵山󰀬
脗	月勹󰁤口
窐	宀八土土
煺	火彐󰀖辶
骐	󰀊󰀞艹八
䪐	󰁆口㐄丿
㪐	丶尸犬又
檐	木⺈厂言
儗	亻匕𠂉󰁾
颼	几丿虫又
䭫	匕日䒑目
碼	石󰀋灬󰁶
袼	衤󰁧夂口
墼	車凵几土
梼	木三丿寸
㢼	弓㡀󰁶
䢼	󰁺八阝󰀢
青	主月󰀘
遗	口丨一辶
材	木󰀛丿ノ
蓑	艹亠口󰀔
辚	车米夕丨
瀘	氵虍田皿
嵿	山丁丆貝
逘	厶𠂉大辶
鼾	丿目田干
呆	口木󰁧
愤	忄十艹贝
绘	纟人二厶
域	土戈口󰀞
跸	口止󰁴十
忹	忄王󰀝
壻	土乛󰁾月
竐	立几又󰁶
胗	月人彡ノ
髐	󰀾月土儿
為	丶丿乛灬
㫐	日匕󰀅
䃗	石󰁭氺刂
僗	亻火火力
櫐	田田田木
躏	口止艹󰁷
顼	王丆贝󰁶
衼	衤󰁧十又
硼	石月月󰀝
桼	木人氺󰁧
塼	土一曰寸
䡼	車󰀙口口
㡼	广日󰁒丿
孙	孑小󰁶
盆	八刀皿󰀘
䡃	車力󰁥
巿	一冂丨󰀵
砙	石一󰁐丶
苪	艹一冂人
骫	󰀾月九丶
熙	匚丨口灬
惂	忄⺈臼󰀝
郂	亠ㄥ丿阝
镾	󰂞一八乂
叾	了口󰀘
番	丿米田󰀘
萾	艹乃又皿
灌	氵艹口󰁷
墻	土土人口
䞗	土󰁾󰀛丿
㞗	尸一氺丶
軏	車一儿󰁀
郺	夕夕巛巴
䡙	車丶艮󰁶
㫫	日一业󰀘
倘	亻⺌冂口
䠃	口止一丶
礼	礻󰁶乚󰁀
褼	衤󰁧覀巳
餼	人良气米
犾	犭󰁥犬󰁶
㤼	忄土厶力
䤼	釒白水󰁶
夼	大川󰀬
椼	木彳氵丁
輚	車戈戈󰁶
䫿	几丿虫口
顷	󰁴丆贝󰁶
鉾	釒厶丿󰀟
俗	亻八人口
彰	立早彡󰁥
肥	月巴󰁀
䴿	木人人󰀓
伦	亻人匕󰁀
琺	王氵土厶
汻	氵𠂉十󰀢
鞗	亻丨夂󰀜
螗	虫广󰁬口
瞗	目󰁟灬󰁶
林	木木󰁶
垗	土儿󰀪󰁶
㝗	宀丶艮󰁧
䝗	豸木󰁶
鼏	冖目󰁕󰁈
蛎	虫厂一󰁡
缏	纟亻一乂
曎	日罒土十
㪫	󰀥冖一又
俚	亻日土󰀝
裼	衤󰁧日󰁤
磼	石亻󰁷木
恘	忄亻木󰁶
飼	人良𠃌口
䣼	西一󰁸小
㣼	忄刀丶󰁶
棼	木木八刀
壼	士冖一一
會	人一󰀺日
䜃	言亻󰁷土
倥	亻宀八工
訫	言心󰁶
鉪	釒廿󰄃󰁀
贾	覀贝󰁧
䮿	󰀋灬宀󰁾
绷	纟月月󰀝
邅	亠囗口辶
眩	目亠ㄠ󰁶
靗	月⺌儿
咽	口囗大󰁶
睗	目曰勹󰁤
蝗	虫白王󰀝
块	土ユ人󰁶
杗	亠󰄃木󰁧
列	一夕刂󰀢
䈗	⺮亻厶夂
禐	礻󰁶爫又
榐	木尸󰁺󰀖
馐	⺈󰁐䒑二
覐	目儿乂乂
呺	口口一ㄅ
捾	扌宀󰃧󰀝
榼	木土厶皿
禼	󰀥囗乂厶
䦼	阝ユ人󰁶
妼	女心丿󰁥
蝹	虫曰皿󰀝
迫	白辶󰀌
覼	一八冂儿
馼	󰀋灬文󰁶
䞎	贝日日󰀝
刪	冂艹刂󰀢
䩫	廿󰀜一丶
駫	󰀋灬⺌儿
蝙	虫丶尸艹
镐	钅󰁸冂口
逞	口王辶󰀌
删	󰀼󰀼一刂
陨	阝口贝󰁶
读	讠十乛大
娸	女󰀎八󰁶
䨸	󰀙阝爫心
煿	火甫寸󰁶
慿	冫󰀋廾心
㦐	忄󰀁二丶
耍	丆冂〢女
䧐	阝󰁸子󰀝
姐	女󰀐一󰀝
槐	木白󰁜厶
秐	禾二厶󰁶
觐	廿口主󰁜
駐	󰀋灬丶王
靎	󰀙釒󰁟灬
䀍	立早夂皿
祼	礻󰁶曰木
楼	木米女󰀝
奼	女丿七󰁀
䥼	钅勹󰁤󰁥
䚙	⺈用一一
娫	女丿󰀥廴
饼	⺈󰁐䒑廾
襼	衤󰁧艹厶
馫	禾日禾日
笑	⺮丿大󰁧
䮸	󰀗乂乂灬
茿	艹工几丶
统	纟亠厶儿
獗	犭ノ厂人
菸	艹方人󰁦
秉	丿一󰁬󰅇
箍	⺮扌匚丨
叺	口丿󰂃󰁶
釿	釒斤󰀢
臿	丿十臼󰀌
瞅	目禾火󰁶
燿	火羽亻󰁷
谥	讠䒑八皿
㧐	扌又又󰁶
即	彐厶卩󰀢
绀	纟艹二󰀝
腚	月宀一󰁾
粮	米丶彐󰀖
増	土丷田日
䁖	目米女󰀝
㼐	丶尸冂󰂃
㨼	田夂口手
䨼	月艹又
娼	女日日󰀝
樼	木尸子子
稼	禾宀一󰀓
証	言一止󰀝
騼	󰀋灬󰁙󰁴
蠎	虫艹大廾
冪	冖艹曰丨
䝙	豸匚乂󰁶
熪	火禾夕夕
憪	忄門月󰀝
约	纟勹丶󰁶
绦	纟夂木󰁶
鳊	󰁢󰀞丶艹
问	门口󰀌
婉	女宀夕⺋
颗	日木丆贝
輐	車宀二儿
碗	石宀夕⺋
漐	土䒑十水
挺	扌丿士廴
㐃	囗丨󰀵
㻹	石一󰀓丶
廹	白廴󰀌
置	罒十󰀣󰀘
肠	月ㄋ󰁤ノ
柸	木丆卜一
徹	彳亠厶攵
佐	亻工󰀝
傖	亻人丶口
㧼	白󰀔󰁶
㽐	甘䒑󰁬八
姼	女夕夕󰁶
䧼	丿土口󰁷
秼	禾丿未󰁶
槼	夫目儿木
駼	󰀋灬人朩
觼	⺈用⺈夂
騴	󰀋灬日女
撎	扌士冖䒑
鹚	䒑ㄠㄠ一
煪	火丷西一
腪	月冖車󰀢
幚	三丿阝丨
慪	忄匚口口
䄪	禾勹丶󰁶
㗙	口勹凵丿
吟	口人丶乛
肖	⺌月󰀘
齐	文󰀯󰀬
悖	忄十冖子
硗	石弋丿儿
参	厶大彡󰁣
鲫	󰁢󰀞彐卩
僵	亻一田一
蝸	虫ㄇ󰁈口
薍	艹爫󰁻乚
杸	木几又󰁶
䜗	言戊一心
㜗	女厶厶彡
㼹	艹亠󰄃丶
泥	氵尸匕󰁀
鞋	廿󰀜土土
䌃	糹⺌月刂
黑	󰀹土灬󰁧
岏	山二儿󰁀
䑎	月人人󰀞
粏	米大丶󰁶
沏	氵七刀ノ
鲡	󰁢󰀞一丶
销	钅⺌月󰀝
書	󰁬土曰󰀘
棫	木戈口󰀞
嶚	山大丷小
骼	󰀾月夂口
乚	乚乚〇〇
窼	宀八巛木
誼	言宀󰀐一
媼	女囗人皿
檼	木爫工心
㪼	丁口斤󰀢
霗	󰀙氵人󰁻
载	土车󰅅丶
啍	口󰁸子󰀝
朗	丶彐厶月
圗	囗厶十二
蜗	虫口冂人
眗	目勹口󰀝
䕍	艹亠󰀔口
辈	丨三丨车
㛗	女人人土
䛗	匚丨󰁃言
焻	火日曰󰀝
泏	氵凵山󰀢
糏	米尸⺌月
唎	口禾刂󰀢
鷚	羽人彡灬
霏	󰀙丨三三
巚	山虍一犬
梫	木彐冖又
瘙	疒又丶虫
跚	口止󰀼一
骤	󰀊󰀞耳乑
㙙	氵乚土
嶺	山人丶貝
鵎	爫女󰁟灬
慃	忄八厶羽
驼	󰀊󰀞宀匕
詼	言火󰁶
穼	宀八木󰁧
橼	木纟󰅂󰀓
婼	女艹口
䩼	廿󰀜夂辶
㩼	夕夕十又
巺	巳巳一八
守	宀寸󰁧
囗	囗丨󰁈一
曗	日业䒑未
盗	冫⺈人皿
蛗	丿󰃧虫󰁧
䓎	艹火勹丶
鴚	󰁟灬丁口
蓙	艹广人土
瀪	𠂉母攵水
蓹	艹彳𠂉卩
䇃	立巳󰁀
伤	亻𠂉力ノ
必	心丿󰀏
渐	氵车斤󰀢
喗	口冖車󰀢
锣	钅罒夕󰁶
㖗	口山人乛
㔣	田田田力
䔣	艹禾刂󰀟
唣	口白七󰁀
攣	言糹糹手
岺	山人丶󰁻
䄃	礻󰁶ㄇ大
稳	禾⺈彐心
㔹	十力󰁥
拢	扌ヒ丶
閗	門󰁦十󰀵
薗	艹囗土󰀔
疗	疒了󰀵
岖	山匚乂󰁶
㶎	氵罒一辶
䱺	󰁢灬山䒑
佻	亻儿󰀪󰁶
㑹	人一由日
瑹	王艹人朩
葹	艹方𠂉也
两	一冂人人
凡	几丶󰀦
蠫	豸刂虫虫
遪	厶厶厶辶
眴	目勹日󰀝
蜴	虫日勹󰁤
圴	土勹丶󰁶
滵	氵宀心山
仵	亻𠂉十󰀢
蕣	艹爫冖㐄
湐	氵木白󰀝
㕗	丷王ク厶
镣	钅大丷小
䕣	艹衤󰁧󰄃
㕣	八口󰀘
散	󰁺月夂󰁶
啣	口𠂉一卩
䓙	艹丿十匕
㡫	幺日勹󰄃
拹	扌力力力
狹	犭󰁥大人
镗	钅⺌冖土
効	六乂力󰁥
繐	糹一曰心
蹐	口止󰀪月
䭾	󰀋灬犬󰁶
珧	王儿󰀪󰁶
䫺	丆厶几虫
藹	艹言曰󰄃
豕	一󰀓󰀦
帺	冂丨󰀎八
骓	󰀊󰀞亻󰁷
矫	𠂉大丿󰀯
柫	木弓󰀯󰀢
輵	車曰勹󰄃
蟫	虫覀早󰀢
扻	扌⺈人󰁶
㠗	山丿ㄇ大
㒣	亻广亻心
徐	彳人一木
侐	亻丿皿󰀝
撣	扌口口十
璣	王幺幺人
䒣	艹冂二󰀘
咣	口⺌一儿
爸	八乂巴󰀅
㗸	口彳𠂉丁
蒣	艹彳人朩
钣	钅⺁又󰁶
䁪	目車斤󰀢
嵚	山钅⺈人
峹	人一朩山
㒙	亻糹白丨
璸	王宀一貝
㒸	䒑󰀓󰁧
陸	阝土八土
虸	虫子󰀝
砗	石车󰀢
栗	覀木󰁧
龐	广立月三
辐	车一口田
䵹	𠂉大口黽
惬	忄匚一大
骞	宀󰀀八一
哎	口艹乂󰁶
數	󰀻女攵󰁶
崹	山亠丷丨
㕸	口立󰀝
㱹	一夕厂止
㓣	人一口刂
㿐	疒土󰁾夕
䀖	目一大󰁶
忐	上心󰁧
瓣	辛⺁厶辛
擣	扌士乛寸
哣	口一口䒑
䓣	艹一冂丶
错	钅󰁺日󰀝
冻	冫󰀂小󰁶
铣	钅丿土儿
蓣	艹󰁻乛贝
潵	氵󰁺月攵
櫹	木艹󰁬󰀲
淼	水水水󰁧
埫	土⺌冂口
㰹	戊一口人
哞	口厶丿󰀟
房	丶尸方󰀏
武	二止󰁒丶
怖	忄冂丨
矗	十󰀣十󰀣
运	二厶辶󰀦
逖	犭ノ火辶
亢	亠几󰀅
㖸	口虍匚一
详	讠䒑󰀟󰀢
獸	口口田犬
嬹	女󰀗ㄇ八
洋	氵䒑󰀟󰀢
懙	忄󰀗一八
迤	𠂉也辶󰁫
矙	目門乛攵
蝴	虫古月󰀝
睴	目冖車󰀢
㐣	广車乙󰁫
㴐	氵目一ㄅ
吣	口心󰁶
搣	扌戊一火
琣	王立口󰀝
皗	白󰀼土口
暗	日立日󰀝
崐	山曰󰁴匕
䚗	⺈用八厶
徵	彳山一夂
釙	釒卜󰁶
隗	阝白󰁜厶
蚗	虫ユ人󰁶
榺	月丷夫木
䦺	阝丁󰀢
姺	女丿土儿
䳚	日干󰁟灬
峚	山大土󰀘
鈹	釒皮󰁶
胹	月丆冂〢
䃹	石門木󰀹
價	亻覀貝󰁶
椺	木亻口木
威	厂一女丶
丞	了󰀩一󰀘
网	冂乂乂󰀦
芎	艹弓󰀅
镺	󰂞丿大󰁶
䅹	禾󰀻女󰀝
焹	火冂䒑󰄃
判	丷󰀠刂󰀢
㑣	亻木木󰁶
㜪	立朩斤女
呣	口母󰁶
㵐	氵厂䒑人
瑣	王⺌貝󰁶
摣	扌虍󰀐一
鑣	釒󰁙󰁴灬
癗	疒󰀙田󰀌
䙗	衤󰁧亠古
噗	口󰅊一人
脙	月一氺丶
鎙	釒䒑凵月
赐	贝日勹󰁤
鵐	工人人灬
䣚	󰀻女阝󰀢
籚	⺮虍田皿
蝪	虫曰一󰁤
弫	弓匚丨丨
掙	扌爫󰁬亅
㝪	宀土䒑丶
伫	亻宀一󰀝
俻	亻夂田󰀝
垺	土爫子󰀝
遹	󰁻乛亅辶
酙	西一󰁦十
錳	釒子皿󰀝
䔺	艹阝月
扎	扌乚󰁀
耹	耳人丶乛
柺	木口力󰁥
摪	扌爿󰁝寸
彻	彳七刀ノ
流	氵亠厶󰀸
蜺	虫臼儿󰁀
亐	二ㄅ󰁫
㔗	弓󰀯力󰁥
攗	扌󰁙󰁴米
庐	广丶尸󰀏
曤	日󰀙亻󰁷
葙	艹木目󰀘
绫	纟土八夂
䱫	木口刂灬
䚪	⺈用罒󰀔
㮚	󰀥囗人木
鎣	火火冖金
摙	扌車辶󰁶
躐	口止巛󰁒
纐	糹六乂貝
厣	厂犬甲󰀵
锗	钅土丿日
杺	木心󰁶
䎣	二木󰁐人
敺	匚口口又
鲻	󰁢󰀞巛田
櫏	木覀大辶
竏	立丿十󰀢
䧚	阝󰁸冂口
㲫	业䒑夫毛
隺	冖亻󰁷󰀌
皺	勹凵丿皮
廻	囗口廴󰀌
㚺	女乃子󰀝
艙	丿󰁪人口
嫏	女丶󰁮阝
妚	女丆卜󰁶
雺	󰀙󰁻乛丿
㓗	冫三丨小
仐	人十󰀬
廐	广白匕󰁜
擗	扌尸口辛
麫	木人人ㄅ
盺	目斤󰀢
㐙	一口䒑乙
䐙	月廿󰀜󰀢
毚	⺈口󰁴丶
䛺	言田八󰀯
㒺	冂䒑人󰄃
鏣	釒广廿灬
绐	纟厶口󰀝
軐	車⺄十󰀢
揣	扌山丆〢
口	口口口口
䏣	月󰀐一󰀝
咺	口一日一
䳻	車斤󰁟灬
系	丿ㄠ小󰁧
泻	氵冖一一
鋎	釒宀二儿
笏	⺮勹󰁤󰁣
橚	木󰁬十󰀲
醙	西一臼又
旙	方丿米田
焪	火宀八弓
鄪	弓󰀯貝阝
摫	扌夫目儿
猙	犭󰁥爫亅
櫚	木門口口
䶫	止󰀆口攵
鍙	氵󰁺八金
圙	囗八丆二
瘪	疒丿目匕
欚	木彑󰀓虫
幫	土土寸丨
䪚	󰁆口㐄羽
魗	士乛工厶
鋙	釒五口󰀝
錣	釒又又又
莖	艹一巛工
字	宀子󰀘
掖	扌亠亻丶
匣	匚甲󰀵
挣	扌⺈󰁬亅
猣	犭󰁥乂夂
茣	艹口一大
㭚	木𠂉󰀕󰁶
犙	牜厶厶彡
晪	日ㄇ󰁺八
䌣	糹⺮宀󰃧
岻	山󰁚󰀁丶
擺	扌罒厶匕
瓺	󰂞一󰁐丶
㭏	木二𠃌丨
䎎	羽耳乚󰁀
厎	厂󰁚󰀁丶
歏	廿口人
䀻	目由一ㄅ
㹫	犭󰁥一人
䛪	言宀八弓
㺫	王刂󰀢
筏	⺮亻戈󰁧
嚪	口門⺈臼
䙪	木乂乂󰀔
孚	爫子󰀘
銙	釒大二ㄅ
屚	尸雨󰀦
䞫	土󰁾󰁬口
蔙	艹方𠂉󰁾
鮗	󰁢灬夂󰁦
讗	言山亻口
算	⺮目廾󰀬
捖	扌宀二儿
卖	十乛󰁦大
䍖	罒勹巳󰀅
卣	󰀥囗󰁃󰀘
荣	艹冖木󰁧
獣	󰀧田一犬
偻	亻米女󰀝
灪	氵木𠂉彡
䍣	罒󰀙田󰀘
逪	󰁺曰辶󰀌
嘙	口氵皮女
晙	日厶八夂
䥫	釒十戈󰁷
燪	火艹勹心
媚	女󰁅目󰀝
䖪	止匕虫󰁧
斪	勹口斤󰀢
荙	艹大辶󰁧
䆪	⺌一儿工
㝙	宀王一八
釪	釒一󰀛󰀢
牪	牜丿󰀟󰀢
㚙	力口大󰁧
拪	扌西󰀝
㶐	氵广亻心
搎	扌孑丿小
嶐	山阝夂一
䶐	丿目田日
瘗	疒一丷土
涐	氵丿扌丶
阗	门十󰀣八
銣	釒女口󰀝
抣	扌勹冫󰀝
犣	牜巛囗󰁒
䄘	礻󰁶亠方
酘	西一几又
煘	火戊一口
㖪	口戈口󰀞
萎	艹禾女󰀘
嫚	女曰罒又
痪	疒⺈ㄇ大
錙	釒巛田󰀝
䊣	米󰁺由八
劣	小丿力󰁣
搫	丿󰁪几手
哫	口口󰁾󰁶
撫	扌𠂉一灬
揎	扌宀一一
小	小亅丿丶
釘	釒丁󰀢
唫	口金󰀝
錘	釒丿士󰁺
挘	扌小丿力
猘	犭󰁥𠂉刂
㗫	口󰁯二小
鍘	釒貝刂󰀢
脪	月乂丨
㗗	口力白十
䗗	虫⺮一廾
嗗	口󰀾月󰀝
淐	氵曰曰󰀝
緐	𠂉母丿小
鋣	釒󰀄亅阝
苣	艹匚󰁃󰀘
狣	犭󰁥儿󰀪
拣	扌󰀂𠃌八
獘	㡀攵犬󰁧
捘	扌厶八夂
嫙	女方𠂉󰁾
犘	广木木󰀟
狘	犭󰁥戈󰁐
嚫	口立朩儿
杫	木止󰀝
玘	王己󰁀
勣	貝力󰁥
䋣	𠂉母幺小
駎	󰀋灬由󰀝
膍	月丿囗匕
㣍	厶口彡󰁥
遫	木口攵辶
鴫	田󰁟灬󰁶
耫	二木貝
膙	月弓口虫
崫	山尸凵山
稺	禾尸辛󰀢
㴫	氵󰁬丿阝
䕪	艹氵罒十
䨺	󰀙二厶厶
昘	曰方󰁣
酫	西一人王
騎	󰀋灬大口
煍	火禾火󰁶
娎	扌斤女󰀘
慍	忄囗人皿
戣	癶一大戈
咖	口力口󰀝
舣	丿󰁪丶乂
㱗	止丿目犬
豗	一儿一󰀓
鱗	󰁢灬米㐄
汗	氵干󰀢
璖	王氵匚木
曺	一由曰󰀘
纻	纟宀一󰀝
榚	木丷王灬
咪	口米󰁶
璪	王口口木
樤	木亻丨朩
䈣	⺮一止攵
刣	厶口刂󰀢
鄫	丷󰀺日阝
䒪	艹厶廾󰀬
醫	匚𠂉大一
杘	尸木󰀦
慩	忄車辶󰁶
兩	一冂丨丶
耟	二木匚󰁃
䚘	彳⺈用丁
牫	牜戈󰁶
楎	木冖車󰀢
䨎	󰀙弓厶󰁧
駚	󰀋灬ㄇ大
軻	車丁口󰀝
岫	山由󰀝
擪	厂曰月手
瓪	一󰁐󰁊又
岗	山冂乂󰁧
扣	扌口󰀝
㲗	爫孑毛󰁀
艣	丿󰁪虍力
鲗	󰁢󰀞贝刂
貗	豸󰀻女󰀝
粗	米󰀐一󰀝
沗	一大氺󰁧
㧚	扌一󰁐丶
䓪	艹日勹󰁤
曘	日󰀙丆〢
狫	犭󰁥土匕
犫	亻󰁷言󰀟
㥪	忄米女󰀝
剣	人一口刂
䉣	⺮臼勹灬
繽	糹宀一貝
蚼	虫勹口󰀝
幽	山ㄠㄠ󰀦
湽	氵巛一田
㚼	女田󰀝
乽	土丿日乙
臟	月艹戈丨
靺	廿󰀜一木
吪	口亻ヒ󰁀
爟	火艹口󰁷
萪	艹禾󰁦十
礚	石艹土皿
錖	上小又金
惙	忄又又又
䤘	西一人󰀞
昤	日人丶󰁻
嫗	女匚口口
挖	扌宀八乙
猖	犭ノ日日
諗	言人丶心
胩	月上卜󰁶
椪	木䒑业󰀝
㫗	日子󰀘
䫗	󰁃丨二貝
嚤	口广木手
潻	氵禾人氺
備	亻󰁺丿用
母	母󰄃𠃌丶
醣	西一广口
鼽	丿目田九
熣	火山亻󰁷
膣	月宀八土
虼	虫𠂉乙󰁀
纽	纟󰁈丨二
晼	日宀夕⺋
噼	口尸口辛
䙼	刀口目儿
㙼	土田田田
鑪	釒虍田皿
悙	忄󰁸了󰀢
瑪	王󰀋灬󰁶
拗	扌ㄠ力ノ
效	亠八乂夂
毁	臼工几又
津	氵󰁬󰀟󰀢
鋖	釒爫女󰀝
芬	艹八刀󰁣
熵	火亠丷口
拖	扌𠂉也󰁀
嬗	女亠囗一
䇣	⺮人小󰁧
笗	⺮夂󰁦󰁧
膀	月亠丷方
誉	󰀧一八言
䬗	日一勹虫
㬗	日󰁝犬灬
貉	豸夂口󰀝
粉	米八刀ノ
覸	門日目儿
惜	忄󰁺日󰀝
拦	扌丷三󰀝
釣	釒勹丶󰁶
隼	亻󰁷十󰀬
燣	火亠囗禾
麟	广󰁃〢丨
悌	忄丷弓丿
矺	石丿七󰁀
傌	亻󰀋灬󰁶
煢	火火冖十
褣	衤󰁧宀口
酢	西一𠂉二
锤	钅丿十一
忾	忄󰅎⺄󰁀
俾	亻白丿十
㿾	宀丁皿󰀘
衍	彳氵一丁
鞽	廿󰀜丿口
螽	夂󰁦虫虫
瞽	士口䒑目
枽	十廿木󰁧
墚	土氵刀木
䢚	一日乂辶
蘩	艹𠂉母小
腙	月宀二小
镤	钅󰅊一人
肚	月土󰀝
忸	忄󰁈丨二
堪	土艹三󰄃
饗	󰁲丿丶艮
㥣	大土土心
祗	礻󰁶󰁚丶
奣	一大日月
冖	冖丶乛
楗	木󰁬󰀟廴
㥗	忄日文󰁶
䆖	宀八厶
阀	门亻戈󰀦
恳	彐󰀖心󰁧
邢	一廾阝󰀢
肢	月十又󰁶
繁	𠂉母夂小
募	艹日大力
铢	钅󰅎󰅇󰁶
壳	士冖几󰀅
䝽	貝厂土土
坽	土人丶󰁻
迻	夕夕辶󰀦
㝽	乚水󰀦
蝽	虫三人日
靽	廿󰀜丷󰀟
杽	木手󰀢
睽	目癶一大
晩	日⺈󰀱󰁜
鶪	目犬󰁟灬
珪	王土土󰀝
菪	艹宀石󰀘
鄙	口十囗阝
极	木乃󰂃󰁶
官	宀丨󰁃󰁃
挟	扌一丷大
㤣	䒑廾心󰁧
馗	九䒑丿目
覗	𠃌一口儿
煖	火爫一又
榗	木一业日
兖	六厶儿󰀅
䅖	禾大日乚
㦗	忄木木小
浅	氵二󰅅丶
牟	厶丿󰀟󰀬
胢	月丁口󰀝
颣	米幺小贝
牲	牜丿主󰀝
鹾	󰀥囗乂工
澐	氵󰀙二厶
稻	禾爫臼󰀝
湾	氵亠󰁗弓
圽	土勹󰁤󰁥
蜽	虫一冂丶
繾	糹口丨辶
键	钅󰁬󰀟廴
懈	忄⺈月󰀟
乾	十早𠂉乙
㜽	巛子󰀘
鲵	󰁢󰀞臼儿
㯗	木門木󰁶
䯗	󰀾月󰁴土
吖	口丷丨󰀢
毗	田󰁴匕󰁀
琖	王戈戈󰁶
诗	讠土寸󰁶
鯗	䒑夫󰁢灬
㣣	彳大人人
㡺	广日一󰀌
圪	土𠂉乙󰁀
功	工力ノ
磣	石厶厶彡
棣	木󰁬氺󰁶
壣	土耳幺一
䂢	石夂󰁦󰁶
逢	夂三丨辶
衣	亠󰀔󰁧
芪	艹󰁚弋󰀅
鬝	󰂞彡門日
麾	广木木乚
芟	艹几又󰁧
汹	氵乂凵󰀢
唐	广󰁬丨口
国	囗王丶󰀦
溾	氵白󰁜厶
盽	目三丨󰀢
躾	丿󰀽三大
氺	氺亅丶丶
尺	尸󰂃󰀦
㛽	女宀米󰁶
䛽	言丿十臼
㰗	木戊上󰁾
赃	贝广土󰀝
取	耳又󰁶
䰗	丨王王乚
簗	⺮氵刀木
揖	扌口耳󰀝
鏖	󰁙󰁴匕金
谗	讠⺈口󰁦
纣	纟寸󰁶
㢣	艹勹口廾
架	力口木󰁧
秮	禾厶口󰀝
惢	心心心󰁧
碣	石日勹󰄃
䃢	石釒⺈人
僢	亻爫冖㐄
聢	耳宀一󰁾
颽	山一口虫
袽	衤󰁧女口
灼	火勹丶󰁶
恼	忄亠乂凵
偼	亻󰀥󰁬󰁾
䁼	目󰀹土土
㢽	弓耳弓󰁀
苤	艹丆卜一
议	讠丶乂󰁶
予	󰁻乛亅󰀬
着	䒑󰀠目󰀘
勤	廿口主力
凭	亻丿士几
设	讠几又󰁶
步	止󰀤󰁣
匩	匚凵丨王
爹	八乂夕夕
非	丨三丨三
燦	火󰀥夕米
频	止󰀤丆贝
㩗	扌山亻乃
讥	讠几󰁀
洮	氵儿󰀪󰁶
橗	木艹日月
穗	禾一日心
䩗	廿󰀜月󰀝
劖	⺈口󰁴刂
倢	亻一󰁬󰁾
䡣	車冖車󰀢
瀢	氵口丨辶
档	木⺌彐󰀝
顽	二儿丆贝
斧	八乂斤󰀬
炼	火󰀂𠃌八
衽	衤󰁧丿士
塽	土大乂乂
桽	木人人土
㡽	广󰁬󰀟󰀵
䂼	石人丶心
溷	氵囗一󰀓
疏	乛止亠󰀸
卤	󰀥囗乂󰁧
检	木人一一
愹	忄宀八口
飺	止匕人艮
娥	女丿扌丶
叙	人一木又
便	亻一日乂
驾	力口󰀊一
檪	木白󰀪木
媪	女日皿󰀝
㪗	立口󰀥又
凤	几又󰀦
塞	宀󰀀八土
脑	月亠乂凵
窗	宀八丿夕
扖	扌丿󰂃󰁶
剖	立口刂󰀢
㠣	山厂禾止
䠣	口止󰁂八
偢	亻禾火󰁶
栣	木亻丿士
砣	石宀匕󰁀
瞣	目口口心
螣	月丷夫虫
垣	土一日一
枣	一ㄇ󰅇󰁦
㞣	凵丨八刀
䞣	土󰁾斤丶
敦	󰁸孑攵󰁶
般	丿󰁪几又
㽾	疒凵山󰀵
墺	土丿ㄇ大
堽	土罒一止
佾	亻八月󰀝
罾	罒丷󰀺日
栽	十戈木󰀦
齾	虍一口󰀆
轾	车一厶土
氧	󰅎⺄䒑󰀟
孪	亠󰁗子󰀘
抩	扌冂土󰀝
韅	廿󰀜曰灬
羟	䒑󰀠ス工
慷	忄广󰁬氺
每	𠂉母󰁧
坐	人人土󰀌
焖	火门心󰁶
脖	月十冖子
飗	几乂󰁚田
呕	口匚乂󰁶
㣗	彳丶尸󰁥
䣗	白大十阝
儖	亻匚丨皿
愖	忄󰀎八󰄃
蟣	虫幺幺人
矣	厶𠂉大󰁧
柣	木丿夫󰁶
埣	土亠人十
䟣	口止木丶
㟣	山木八厶
驶	󰀊󰀞口乂
埍	土口月󰀝
柍	木ㄇ大󰁶
㾾	疒䒑󰁬八
䀼	目厂二󰀖
埽	土彐冖丨
怼	又寸心󰁧
矽	石夕󰁶
达	大辶󰀦
逼	一口田辶
淋	氵木木󰁶
欪	凵山⺈人
祥	礻󰁶䒑󰀟
透	禾乃辶󰀏
律	彳󰁬󰀟󰀢
羲	丷王禾丶
胁	月力八󰁶
骁	󰀊󰀞弋儿
胖	月丷󰀟󰀢
烖	十戈火󰀦
磐	丿󰁪几石
郖	一口䒑阝
䃖	石󰁞灬󰁶
㤗	三人⺗󰁧
鞣	廿󰀜󰁻木
僖	亻士口口
圣	又土󰀘
榽	木爫幺大
鞖	廿󰀜爫女
䅼	禾日罒又
罗	罒夕󰁧
螖	虫󰀾月󰀝
彗	三丨三彐
枖	木丿大󰁶
㞖	尸木冂󰁫
佗	亻宀匕󰁀
还	丆卜辶󰀦
笪	⺮日一󰀘
势	扌九丶力
义	丶乂󰀦
濒	氵止󰀤贝
驰	󰀊󰀞也󰁀
辘	车广󰁃匕
䯀	󰀋灬耳耳
欧	匚乂⺈人
示	二小󰁧
隍	阝白王󰀝
軎	車口󰀘
皍	白󰁴卩󰀬
暍	日曰勹󰄃
芳	艹方󰁣
蟪	虫一日心
逩	大十廾辶
冺	冫󰁂󰀁󰁀
㦽	月戈巛
迦	力口辶󰀌
绊	纟丷󰀟󰀢
郿	󰁅目阝󰀢
楽	白󰀪木󰁧
祽	礻󰁶亠十
蝣	虫方𠂉子
督	上小又目
蝖	虫宀一一
羗	⺶乚厶󰀦
䝣	豸氵匚木
㝣	宀三丨大
䝖	豸⺁丨󰂃
㝖	宀夕夕󰁧
彦	立丿彡󰀏
拭	扌󰀁工丶
圾	土乃󰂃󰁶
侮	亻𠂉母󰁶
努	女又力󰁣
奥	丿ㄇ米大
姊	女丿ㄅ丿
勒	廿口十力
㙍	土又又又
輎	車⺌月󰀝
翫	羽白二儿
濫	氵匚丨皿
嗑	口土厶皿
及	乃󰂃󰀦
庞	广ヒ丶
溺	氵弓冫冫
羧	䒑󰀠厶夂
晦	日𠂉母󰁶
霣	󰀙口貝󰁧
㥽	忄貝󰁶
骑	󰀊󰀞大口
垪	土䒑廾󰀢
䚣	⺈用日󰁾
嚣	口口丆口
挑	扌儿󰀪󰁶
餽	人良白厶
䤽	釒罒󰀫󰁶
㤽	忄三丿寸
椽	木彑󰀓󰁶
夽	大二厶󰁧
践	口止二丶
成	厂𠃌󰅅丶
栈	木二󰅅丶
纺	纟方ノ
度	广廿又󰀦
望	亠󰁐月王
毓	𠂉母亠󰀸
禺	日冂丨丶
鉹	釒夕夕󰁶
服	月卩又󰁶
鹎	白丿十一
剹	羽人彡刂
吠	口犬󰁶
脏	月广土󰀝
商	亠丷冂口
㧗	扌止匕󰁀
䧗	阝𠂉日夂
刖	月刂󰀢
或	戈口󰀞󰀌
爖	火立月三
觗	⺈用󰁚󰀁
駗	󰀋灬人彡
译	讠又󰀟󰀢
铿	钅〢又土
焼	火十艹儿
脼	月一冂󰂃
㛣	女口贝󰁶
郏	一丷大阝
難	廿口夫󰁷
蛣	虫士口󰀝
壽	士乛工寸
愼	忄匕目八
嵃	山立丿彡
㬸	月艹亻ヒ
甥	丿主田力
糜	广木木米
掶	扌广󰁬人
旁	亠丷冖方
篱	⺮亠乂厶
筑	⺮工几丶
验	󰀊󰀞人一
鵫	󰀥早󰁟灬
蔪	艹車斤󰀬
絫	厶厶厶小
空	宀八工󰀘
凙	冫罒土十
㨗	扌󰀥󰁬󰁾
曍	日丿目十
娗	女丿士廴
䨗	󰀙爫子󰀘
稗	禾白丿十
樗	木󰀙二ㄅ
騗	丶尸冂灬
託	言丿七󰁀
烷	火宀二儿
布	冂丨󰀬
袖	衤󰁧由󰀝
㘣	囗口月󰀌
䘣	衤󰁧止匕
嘣	口山月月
昣	日人彡󰁥
瘣	疒白󰁜厶
蘣	艹󰁺由王
阣	阝𠂉乙󰁀
雾	󰀙夂力󰁣
涂	氵人一木
蚁	虫丶乂󰁶
酝	西一二厶
䢖	󰁬󰀟辶󰀵
墖	土人一田
唬	口󰅋七几
㢖	广丿米田
绯	纟丨三三
尤	乚丶󰀦
欹	大丁口人
䓍	艹日干󰀬
霻	󰀙ㄇ󰁺䒑
沎	氵亻ヒ󰁀
粎	米尸󰂃󰁶
扰	扌乚丶
神	礻󰁶日丨
慉	忄亠幺田
䳛	日女󰁟灬
骽	󰀾月爫女
誽	言臼儿󰁀
窽	宀八匕人
扼	扌厂⺋󰁀
媽	女󰀋灬󰁶
逕	一巛工辶
䩽	廿󰀜匚口
噣	口罒勹虫
桖	木丿皿󰀝
癣	疒󰁢󰀞󰀟
晣	日扌斤󰀢
陣	阝車󰀢
虣	一󰀁止几
斸	尸氺罒斤
晁	日儿󰀪󰁧
馊	⺈󰁐臼又
扉	丶尸丨三
塖	土禾丬匕
䀕	目弓丨󰀢
㡖	冂丨丿土
办	力八󰀦
鴅	󰀼亠󰁟灬
怀	忄丆卜󰁶
酱	丬夕西一
兰	丷三󰀘
父	八乂󰁧
薸	艹氵覀小
诽	讠丨三三
斜	人一木十
帝	亠丷冖丨
咒	口口几󰀅
銼	釒人人土
鶍	日勹󰁤灬
穽	宀八二󰀯
詽	言一干
婽	女󰁃丨又
押	扌甲󰀢
凼	水凵󰀵
䇼	⺮口巴󰀅
稽	禾乚日
樽	木丷西寸
廗	广廿儿丨
朖	月丶艮󰁶
眖	目口儿󰁀
蜖	虫囗〢二
閣	門夂口󰀌
䀨	目丿古󰀝
疣	疒乚丶
仗	亻󰂃󰁶
喣	口勹口灬
斣	罒勹虫十
㖣	口立口󰀝
䖣	虫⺁丨󰂃
娜	女𠃌󰀠阝
乐	丿󰄃小󰀦
㷌	火彐冖丨
抬	扌厶口󰀝
漉	氵广󰁃匕
痞	疒丆卜口
泮	氵丷󰀟󰀢
仉	亻几󰁀
廉	广䒑󰁬󰁗
碚	石立口󰀝
呼	口丿丷󰀛
㻟	王工月
骹	󰀾月六乂
鷍	丿目木灬
㨽	扌一口刂
肄	匕𠂉大󰀟
䈼	⺮宀心山
姽	女⺈厂⺋
戼	乛匚一󰁃
秽	禾山夕󰁶
曖	日爫冖夂
駽	󰀋灬口月
輗	車臼儿󰁀
缗	纟󰁃󰁐日
薌	艹󰁲丿阝
闣	門⺌冖田
众	人人人󰁧
痣	疒士心󰀦
旣	白匕󰀄󰁜
嗣	口冂艹口
䗣	甘虫虫󰁧
㗣	口廿儿丨
驮	󰀊󰀞大󰁶
䭹	󰀋灬󰁚卩
烯	火乂丨
晟	日厂𠃌丶
别	口力刂󰀢
禽	人亠乂厶
厉	厂一󰁡󰀏
衢	彳目目丁
男	田力󰁣
婻	女十冂十
䈺	⺮糹夂󰁦
㩻	⺈厂⺋又
筹	⺮三丿寸
挸	扌目儿󰁀
切	七刀ノ
㧽	扌囗古󰀝
喖	口木古󰀝
浗	氵一氺丶
㵗	冫󰀋灬水
䵗	禾人氺田
赌	贝土丿日
麂	广󰁃〢几
抗	扌亠几󰁀
㾹	疒止匕木
焕	火⺈ㄇ大
曦	日丷王丶
肇	丶尸夂󰀟
绞	纟亠八乂
鵗	乂冂灬
谛	讠亠丷丨
疖	疒ㄗ󰀵
赗	贝󰀰目󰀝
鬼	白󰁜厶󰀦
责	主贝󰁧
镢	钅厂䒑人
坑	土亠几󰁀
嬼	女󰁚丶刂
欼	又又又人
崣	山禾女󰀘
敢	󰁈耳夂󰁶
掳	扌󰅋七力
輴	車⺁十目
㬼	月𠂉夂
䬼	人良口月
尹	󰁬丿󰀏
氹	乙水󰀦
颊	一丷大贝
哽	口一日乂
敖	主󰁡夂󰁶
啖	口火火󰁶
䕖	艹孑丿辶
㕖	厶厶厶木
鴎	匚乂󰁟灬
姪	女一厶土
戩	一厶厶戈
镓	钅宀一󰀓
帆	冂丨几丶
蜚	丨三丨虫
墉	土广󰁬丨
鹿	广󰁃〢匕
轴	车由󰀝
鶗	日一󰁾灬
蕖	艹氵匚木
畖	田⺁厶󰂃
糣	米󰀄󰁜日
泣	氵立󰀝
峣	山󰀁丿儿
䳣	十戈󰁡灬
櫼	木人人󰀞
嫼	女󰀹土灬
钢	钅冂乂󰁶
賣	士罒貝󰁧
嫂	女臼丨又
叛	丷󰀠⺁又
䫼	几丿虫人
㫼	日𠂉一刂
剩	禾丬匕刂
䉩	⺮木匚口
榪	木󰀋灬󰁶
飑	几乂勹巳
栖	木西󰀝
砖	石二󰁓丶
蠖	虫艹亻又
頖	丷󰀠丆貝
犊	牜十乛大
囬	囗〢二󰀌
翡	丨三丨羽
糫	米罒一󰀔
臺	士口冖土
釺	釒丿十󰀢
渡	氵广廿又
㦻	羽白戈󰁶
㳣	氵土丿匕
㠖	山丷王丶
䁕	目󰁂󰀁日
堖	土巛丿乂
讼	讠八厶󰁶
粣	米冂冂一
䓢	艹囗古󰀘
岣	山勹口󰀝
诚	讠厂𠃌丶
鸥	匚乂勹一
蓢	艹丶󰁮月
鲣	󰁢󰀞〢土
己	己󰁈一乚
珸	王五口󰀝
呍	口二厶󰁶
铍	钅󰅌又󰁶
䮼	󰀋灬火㐄
宼	宀二儿女
废	广ㄥ丿丶
㮼	木丶尸羽
炕	火亠几󰁀
柖	木刀口󰀝
邕	巛口巴󰀅
肕	月刀丶󰁶
忧	忄乚丶
瘦	疒臼丨又
焺	火曰丿廾
濴	氵火火水
䄺	禾一弓人
抠	扌匚乂󰁶
暞	日丿目木
脺	月亠人十
㟖	山王廾󰀬
㲣	臼丨又毛
埖	土艹亻ヒ
䟖	口止山󰀢
屣	尸彳止󰁾
䐢	月勹凵丿
筼	⺮口贝󰁧
搢	扌一业日
鐢	木乂乂金
萢	艹氵勹巳
琸	王󰀥早󰀢
使	亻一口乂
铞	钅口冂丨
鼹	臼󰁐󰁦女
爰	爫一又
庾	广臼人󰀦
孼	凵丿丿子
䭼	󰀋灬二󰀯
㭼	木水日󰀝
夯	大力󰁣
蠺	一大一虫
㚖	白大󰁧
骊	󰀊󰀞一丶
犟	弓口虫󰀟
湗	氵土土寸
皖	白宀二儿
䚖	󰀙口口儿
幗	冂丨囗󰀞
豢	䒑大一󰀓
座	广人人土
蚖	虫二儿󰁀
鹗	口口二一
级	纟乃󰂃󰁶
讴	讠匚乂󰁶
㐢	氵爫子乙
㳺	氵扌𠂉子
氼	水人󰁧
呢	口尸匕󰁀
谼	八人口八
瑢	王宀八口
葢	艹大丶皿
鰣	󰁢灬日寸
勉	⺈口󰁜力
偷	亻人一刂
楞	木罒方ノ
初	衤󰁧刀ノ
簎	⺮扌󰁺日
霈	󰀙氵一丨
实	宀󰁦大󰁧
㰼	匚大人人
䰼	󰁢灬人乛
尼	尸匕󰁫
㺗	犭󰁥口十
⺗	⺗亅丿丶
菲	艹丨三三
貂	豸刀口󰀝
癖	疒尸口辛
晖	日冖车󰀢
店	广󰀥口󰀌
䙖	衤󰁧山月
若	艹口󰀘
枋	木方ノ
麗	一冂丶匕
鯣	󰁢灬日󰁤
诣	讠匕日󰀝
玢	王八刀ノ
探	扌冖八木
㰣	止󰁴⺈人
篼	⺮白󰁚儿
毼	曰勹人毛
鯼	󰁢灬乂夂
诼	讠一󰀓丶
否	丆卜口󰀘
臼	臼丿丨一
陲	阝丿十一
敬	艹勹口夂
斐	丨三丨文
砜	石几乂󰁶
光	⺌一儿󰀅
筎	⺮女口󰀘
㯼	木艹土皿
愦	忄口丨贝
导	巳寸󰁧
䯼	󰂞彡犭火
㳗	氵又丶土
䔖	艹阝土夂
峗	山⺈厂⺋
泗	氵四󰀝
夹	一丷大󰀦
擸	扌巛囗󰁒
瓸	一󰁐󰁊日
哸	口爫女󰀝
寨	宀󰀀八木
劝	又力ノ
鮣	󰁢灬󰁚卩
冢	冖一󰀓丶
糗	米丿目犬
讣	讠卜󰁶
锖	钅主月󰀝
殣	一夕廿
䎢	二木𠂉乙
沼	氵刀口󰀝
㲼	氵乂󰁶
䲼	丿󰁟灬
漓	氵亠乂厶
耩	三󰅇󰀀土
鼷	臼󰁐󰁦大
瓦	一󰁐󰁊丶
哦	口丿扌丶
睨	目臼儿󰁀
隽	亻󰁷乃󰁣
祷	礻󰁶三寸
鲼	󰁢󰀞十贝
䯿	󰂞彡亠十
粼	米夕󰀂巜
貼	貝󰀥口󰀝
䴗	目犬󰁠一
㴗	氵覀女󰀝
洗	氵丿土儿
崗	山冂䒑山
牧	牜夂󰁶
嵹	山弓口虫
鵹	禾勹丿灬
钧	钅勹冫󰀝
烁	火丿󰄃小
錢	釒戈戈󰁶
疯	疒几乂󰀦
筋	⺮月力󰁣
蓖	艹丿囗匕
瓖	王亠口󰀔
譣	言人一人
铖	钅厂𠃌丶
㮣	󰁮󰀄󰁜木
屼	山一儿󰁀
䱼	󰁢灬尸󰀖
㱼	󰁂几又󰁶
羰	䒑󰀠山火
孎	女尸氺虫
梅	木𠂉母󰁶
豸	豸丿丶丿
牿	牜丿土口
坊	土方ノ
垂	丿十󰁺一
廊	广丶彐阝
遼	大丷日辶
鱼	󰁢一󰀘
豼	豸󰁴匕󰁀
籼	米山󰀢
扮	扌八刀ノ
髎	󰀾月羽彡
较	车亠八乂
床	广木󰀦
麋	广󰁃〢米
夙	几一夕󰀦
鹂	一冂丶一
鲛	󰁢󰀞亠乂
鬣	󰂞彡巛󰁒
驯	󰀊󰀞川󰀢
鼐	乃目󰁕󰁈
堻	氵󰁬󰀟土
嬣	女宀心丁
欣	斤⺈人󰁶
笣	⺮勹巳󰀅
謣	言󰀙二ㄅ
㴼	氵宀亻日
䴼	木人人戈
崼	山曰一󰁾
㭣	木门口󰀝
恸	忄二厶力
鎕	釒广󰁬口
㔪	勹󰀥囗󰁘
赓	广󰁬人贝
櫖	木虍田心
厕	厂贝刂󰀵
莕	艹木口󰀘
竖	〢又立󰀘
紼	糹弓󰀯󰀢
贼	贝戈ノ
䎕	火火冖羽
㫖	上日󰀘
砹	石艹乂󰁶
蚂	虫󰀊一󰀝
趸	一󰁡口󰁾
瘬	疒弓󰀍󰀖
揾	扌曰皿󰀝
飒	立几乂󰁶
欎	木乂乂寸
笎	⺮二儿󰀅
銢	釒二水󰁶
芢	艹亻二󰀘
竣	立厶八夂
抢	扌人⺋󰁀
泹	氵曰一󰀝
䒸	艹丿皿󰀘
箨	⺮扌又󰀟
幞	冂丨󰅊人
䳼	󰁟灬匚口
㳼	戈口󰀞水
㬣	日业丷寸
䍢	罒𠂉一灬
鍕	釒冖車󰀢
噓	口虍〢一
峨	山丿扌丶
镝	钅亠丷古
单	丷曰十󰀬
欖	木匚丨儿
笖	⺮󰁐丶人
謖	言田八夂
購	貝󰀀冂土
糼	糹力󰁥
㬖	日丶尸口
鳼	文󰁟灬󰁶
琥	王󰅋七几
髌	󰀾月宀八
㜔	女立口儿
㘖	口立丿貝
䘖	彳𠂉十丁
嘖	口貝󰁶
淗	氵勹米󰁶
緗	糹木目󰀝
跗	口止亻寸
鋢	釒爫子󰀝
檣	木土人口
窣	宀八亠十
镀	钅广廿又
愋	忄爫一又
廪	广亠囗小
凸	丨一丨一
骛	󰁻乛亅一
㶼	火厶𠂉大
硷	石人一一
骧	󰀊󰀞亠󰀔
嫣	女一止灬
綼	糹白丿十
㫣	日日乚󰀅
嶼	山󰀗一八
吕	口口󰀘
䐕	月口耳󰀝
趼	口止一廾
鶼	䒑󰁬〢灬
鐕	釒󰀄󰁜日
萕	艹文󰀳󰀘
琕	王白丿十
搕	扌土厶皿
嘞	口廿口力
脸	月人一一
㸗	八乂冂口
涩	氵刀丶止
嗖	口臼丨又
䗖	虫一〣丨
痖	疒一业󰀌
渗	氵厶大彡
穣	禾六󰀀󰀔
橣	木宀心用
驣	󰀋灬丷灬
舢	丿󰁪山󰀢
䐼	月三丨小
瀫	氵士冖又
毋	󰅂󰀌
爬	⺁丨󰂃巴
㵼	氵冖臼灬
莸	艹犭ノ丶
黝	󰀹土灬力
蔻	艹宀二又
䪣	一冂丨一
媣	女氵九木
嵼	山立丿
㪣	󰁸冂口攵
䏕	月丿士󰀝
叕	又又又又
鵼	宀八工灬
㲖	⺌月毛󰁀
貖	豸䒑八皿
鲖	󰁢󰀞冂口
沖	氵口丨󰀢
粖	米一木󰁶
茏	艹ヒ丶
﨣	土󰁾󰁦十
樨	木尸氺󰀟
瓿	立口一丶
咐	口亻寸󰁶
弑	乂木󰀁丶
殓	一夕人一
黾	口日乚󰀅
軾	車󰀁工丶
牢	宀丿󰀟󰀬
滾	氵六口󰀔
廾	廾一丿丨
仾	亻一彑󰀝
㻾	亠󰁲丿丶
侠	亻一丷大
鼠	臼󰁐󰁦󰁒
胚	月丆卜一
荦	艹冖丿󰀟
羞	䒑󰀠󰁈二
㸼	牜夂三丨
㩣	扌羽冖車
帼	冂丨囗丶
渼	氵丷王大
䈢	⺮厶口木
踼	口止日󰁤
鸼	丿󰁪󰁠一
郓	冖车阝󰀢
覍	小目儿󰀅
烓	火土土󰀝
䅌	禾口月󰀝
纷	纟八刀ノ
铗	钅一丷大
缠	纟广日土
天	一大󰀦
椩	木广󰁬人
嬷	女广木厶
哚	口几木󰁶
醢	西一皿
陽	阝日一󰁤
秣	禾一木󰁶
白	白白白白
輾	車尸󰁺󰀖
弾	弓󰀧曰十
漾	氵丷王󰀩
㙽	土大丆日
䙽	大丷目儿
晾	日󰁸小󰁶
窈	宀八ㄠ力
鲱	󰁢󰀞丨三
辏	车三人大
㷼	廿口丬火
庠	广䒑󰀟󰀵
巼	巴口匕󰀅
㨣	扌八厶羽
䨣	󰀙廿󰀜󰀬
娣	女丷弓丿
鷼	門日󰁟灬
跼	口止尸口
蛮	亠󰁗虫󰁧
释	丿米又󰀟
崴	山厂一丶
赋	贝二止丶
建	󰁬󰀟廴󰀵
诲	讠𠂉母󰁶
舂	三人臼󰀘
俘	亻爫子󰀝
彘	󰅂一𠂉匕
绾	纟宀丨󰁃
馣	禾日大乚
玑	王几󰁀
禣	礻󰁶甫寸
覣	禾女目儿
蟥	虫󰁺由八
䃨	石弓口虫
虢	爫寸󰅋几
豚	月一󰀓󰁶
蓦	艹日大一
稀	禾乂丨
锒	钅丶艮󰁶
犳	犭󰁥勹丶
沿	氵几口󰀝
蕺	艹口耳丶
蘼	艹广木三
钚	钅丆卜󰁶
沆	氵亠几󰁀
沩	氵丶丿丶
里	日土󰀌
錕	釒日󰁴匕
憢	忄土土儿
猕	犭ノ弓小
歖	士口䒑人
匕	匕丿乚
䭖	人良广灬
㭖	木亻󰀁丶
刚	冂乂刂󰀢
戚	厂󰀥一丶
䇌	立⺌月󰀝
躔	口止广土
劾	亠ㄥ丿力
庄	广土󰀌
脢	月𠂉母󰁶
祣	礻󰁶𠂉󰀕
郊	亠八乂阝
饣	⺈󰁐󰀅
烊	火䒑󰀟󰀢
尕	乃小󰁧
橥	犭ノ土木
庒	广土丶󰀦
霓	󰀙臼儿󰀅
鲠	󰁢󰀞一乂
鎤	釒曰⺌儿
奶	女乃ノ
帳	冂丨󰀍󰀖
评	讠一丷十
糅	米󰁻乛木
桃	木儿󰀪󰁶
邓	又阝󰀢
齑	文󰀯丨一
鮖	󰁢灬石󰀝
膌	月󰀨人月
妣	女󰁴匕󰁀
苕	艹刀口󰀘
宖	宀弓厶󰁧
拕	扌宀匕󰁀
㮖	木廿󰀜󰀢
䮖	󰀋灬日日
缧	纟田ㄠ小
䂓	𠂉大目儿
䓱	艹止匕木
㰲	戈口󰀞人
氲	󰅎⺄日皿
哱	口十冖子
瑠	王󰁚丶田
溆	氵人一又
烂	火丷三󰀝
帩	冂丨⺌月
晨	日厂二󰀖
畤	田土寸󰁶
㡌	冂丨󰀰月
垄	ヒ丶土
蓱	艹氵䒑廾
簲	⺮月白十
辔	车纟纟口
铱	钅亠󰀔󰁶
膕	月囗戈󰀞
磖	石羽白󰀝
濮	氵亻󰅊人
飖	爫𠂉十乂
䣖	󰀋灬口巴
㣖	彳大丶󰁶
棖	木󰀍󰀖󰁶
冕	曰⺈口󰁜
旒	方𠂉亠󰀸
燹	一󰀓一火
插	扌丿十臼
迈	一󰁡辶󰀏
㵜	氵氵十十
兕	丨󰁎󰀽儿
搜	扌臼丨又
驿	󰀊󰀞又󰀟
峲	山禾刂󰀬
泲	氵丿ㄅ丿
㐱	人彡󰁣
䳲	扌厂二灬
貌	豸白儿󰁀
岌	山乃󰂃󰁧
堀	土尸凵山
找	扌戈󰁶
佰	亻丆日󰀝
榧	木匚丨三
兆	儿󰀪󰀦
蕳	艹門日󰀘
鳲	尸󰁟灬󰁶
捧	扌三人󰀟
琱	王󰀼土口
萱	艹宀一一
礖	石󰀗一八
腕	月宀夕⺋
餖	人良一䒑
妞	女󰁈丨二
㤖	忄宀丁󰀢
䅕	禾尸古󰀝
外	夕卜󰁶
慕	艹日大⺗
耪	三󰅇亠方
蠌	虫罒土十
珩	王彳一丁
聚	耳又乑󰁧
钒	钅几丶󰁶
堌	土囗古󰀝
凰	几白王󰀌
骠	󰀊󰀞覀小
摱	扌曰罒又
岲	山口儿󰁀
䑱	丿󰁪宀⺋
㑱	亻󰁻乛木
拮	扌士口󰀝
牾	牜五口󰀝
涝	氵艹冖力
垛	土几木󰁶
壩	土󰀙廿月
庝	广夂󰁦󰀦
嶩	山ㄇ󰁺󰀖
劢	一󰁡力ノ
艿	艹乃󰁣
鑱	釒⺈口丶
葱	艹勹󰁤心
粲	󰀥夕又米
穖	禾幺幺人
戕	󰄃丨丆戈
刕	刀刀刀󰁣
䩖	廿󰀜小丿
莠	艹禾乃󰁣
姚	女儿󰀪󰁶
驖	󰀋灬十王
舕	丿古火火
忤	忄𠂉十󰀢
搓	扌䒑󰀠工
眙	目厶口󰀝
滔	氵爫臼󰀝
泺	氵丿󰄃小
䯧	󰁸冖冂口
戭	宀一由戈
赇	贝一氺丶
浲	氵夂三丨
疱	疒勹巳󰁫
薱	艹业丷寸
鵲	󰁺日󰁟灬
麝	广󰁃〢寸
骄	󰀊󰀞丿󰀯
簏	⺮广󰁃匕
跞	口止丿小
䂘	石又丶󰁶
娛	女口󰁕大
㗨	匚𠂉大口
䈖	⺮禾󰁦十
㩖	扌一田一
㖱	亠亻夂口
䖱	虫匚王󰀝
嵲	山丿目木
檖	木䒑󰀓辶
窖	宀八丿口
䇕	立󰀙丆〢
凕	冫冖曰六
囟	丿囗乂󰀦
勖	曰目力ノ
臕	月󰁙󰁴灬
骖	󰀊󰀞厶彡
㢌	广阝丁口
叟	臼丨又󰁧
姠	女丿冂口
缔	纟亠丷丨
馨	士󰁅几日
螭	虫亠乂厶
姌	女冂土󰀝
滹	氵󰅋七󰀛
痱	疒丨三三
洲	氵丶丿丨
闱	门二𠃌丨
贲	十艹贝󰁧
搴	宀󰀀八手
箯	⺮亻一乂
翔	䒑󰀠羽󰀝
攬	扌匚丨儿
纠	纟󰁐丨󰀢
耢	三󰅇艹力
奰	罒罒罒大
羝	䒑󰀠󰁚丶
㴲	氵⺁虍几
夫	二人󰀦
崲	山白王󰀝
䴲	木人人木
话	讠丿古󰀝
陷	阝⺈臼󰀝
怿	忄又󰀟󰀢
谄	讠⺈臼󰀝
缕	纟米女󰀝
恜	忄󰀁工丶
歃	丿十臼人
胧	月ヒ丶
㒕	亻亠󰁲󰁷
蝌	虫禾󰁦十
寖	宀氵彐又
䯖	󰀾月丶艮
篖	⺮广󰁬口
撕	扌艹三斤
钕	钅女󰀝
蒕	艹囗人皿
跲	口止人口
鷲	󰁸小灬
攱	立十又󰁶
由	由丨󰁈一
杌	木一儿󰁀
㾍	疒丆冂〢
裣	衤󰁧人一
蟊	󰁻乛亅虫
峄	山又󰀟󰀢
犋	牜󰀣八󰁶
鍨	釒癶一大
韫	二𠃌丨皿
䔱	艹扌口耳
唱	口日日󰀝
氖	󰅎⺄乃󰁣
㷲	火丿一力
搶	扌人丶口
躞	口止言又
懋	木󰁻乛心
鳘	𠂉母夂一
俄	亻丿扌丶
练	纟󰀂𠃌八
群	󰁬丿口󰀟
鞢	廿󰀜廿木
螢	火火冖虫
瞢	艹罒冖目
濣	氵十早十
垢	土⺁一口
摕	扌廿儿丨
㞢	凵丨一󰀌
谖	讠爫一又
鰖	󰁢灬月
镱	钅立日心
蕱	艹禾⺌月
網	糹冂䒑󰄃
敱	山一口又
崤	山乂月
庥	广亻木󰀦
褡	衤󰁧艹口
熨	尸二小火
槩	白󰁴󰀄木
鄯	䒑󰀟䒑阝
骜	主󰁡夂一
骟	󰀊󰀞丶羽
啱	口山石󰀝
䶲	冂土丿󰁵
㕱	口乚丶
颓	禾几丆贝
嚏	口十冖󰁾
鄕	󰁲丿白阝
脕	月⺈口󰁜
祖	礻󰁶󰀐一
楖	木󰁮卩󰀢
奖	丬夕大󰁧
䥖	釒丷西大
㥖	󰀼亠八心
矢	𠂉大󰁧
辣	立一󰅇
埢	土丷夫⺋
柢	木󰁚󰀁丶
㟢	山大丁口
侣	亻口口󰀝
鳓	󰁢󰀞廿力
眸	目厶丿󰀟
鹲	艹冖二一
笈	⺮乃󰂃󰁧
郪	一󰁬丨阝
桁	木彳一丁
嚱	口虍一戈
暱	日匚艹口
皱	⺈彐󰅌又
蚱	虫𠂉丨二
豪	亠口冖󰀓
怈	忄廿󰄃󰁀
㹲	犭󰁥土子
䚱	言小󰁶
方	方丶一丿
幺	ㄠㄠㄠㄠ
呦	口ㄠ力ノ
拨	扌ㄥ丿丶
首	䒑丿目󰀘
摩	广木木手
禖	礻󰁶甘木
胕	月亻寸󰁶
妖	女丿大󰁶
惕	忄日勹󰁤
㦖	忄門心󰁶
䃕	火火冖石
潣	氵門文󰁶
彣	文彡󰀏
轣	車厂禾止
眢	夕⺋目󰀘
呖	口厂力ノ
沥	氵厂力ノ
佣	亻用󰀢
㽣	田戈口󰀞
谪	讠亠丷古
鸲	勹口勹一
仂	亻力ノ
啁	口󰀼土口
渲	氵宀一一
囱	丿囗夕󰀦
蛱	虫一丷大
盱	目一󰀛󰀢
戌	厂一󰅅丶
鞕	廿󰀜一乂
串	口口丨󰀵
㛱	女田一󰀖
枕	木冖󰁜󰁀
垕	⺁一口土
螕	虫丿囗匕
瞕	目立早󰀢
㛕	女口巴󰁀
侖	人一冂艹
裒	亠臼󰀔󰁧
诱	讠禾乃ノ
面	丆冂〢三
跺	口止几木
牛	丿󰀟󰀵
疠	疒一󰁡󰀏
弣	弓亻寸󰁶
漣	氵車辶󰁶
缣	纟䒑󰁬󰁗
輣	車月月󰀝
伪	亻丶丿丶
航	丿󰁪亠几
㼣	丆日一丶
䝢	豸日罒又
底	广󰁚󰀁丶
溅	氵贝二丶
阱	阝二󰀯󰀢
纾	纟󰁻乛亅
绲	纟日󰁴匕
軲	車古󰀝
廲	广一ㄇ匕
昱	日立󰀘
鼖	十艹士又
䘱	六人口󰀔
苈	艹厂力󰁣
彪	󰅋七几彡
坕	⺁丨󰂃土
漖	氵土丿攵
睕	目宀夕⺋
輖	車󰀼土口
瞌	目土厶皿
轍	車亠厶攵
䞕	土󰁖󰀙〢
㻖	王󰁬氺󰁶
趿	口止乃󰂃
䞌	贝丿古󰀝
象	⺈口󰀓󰁧
䦕	門䒑廾󰀵
嚢	一口丨󰀔
䚢	⺈用廿木
㻣	王󰀎八󰄃
诵	讠󰁻月丨
隢	阝土土儿
軣	車󰀪󰁧
皢	白土土儿
暢	曰丨日󰁤
闶	门亠几󰁫
矜	󰁻乛亅乛
峡	山一丷大
麲	木人人夕
虱	⺄丿虫󰀦
纲	纟冂乂󰁶
晱	日火火󰁶
庲	广木人人
亲	立木󰁧
㙱	口一ㄅ土
砕	石九十󰀢
栕	木匚丨丨
骘	阝止󰀤一
骝	󰀊󰀞󰁚田
励	厂一󰁡力
䁨	目󰁸孑阝
堩	土忄一一
傅	亻一月寸
㼖	⺁厶丶虫
伖	亻又󰁶
凈	冫爫󰁬亅
轷	车丿丷󰀛
㨯	扌󰁸孑阝
码	石󰀊一󰀝
亣	亠󰀯󰀬
团	囗󰀛丿󰀏
没	氵几又󰁶
㺣	犭󰁥虍戈
蛢	虫䒑廾󰀢
麣	󰁙󰁴匕攵
曢	日宀大小
盢	田犬皿󰀘
㖩	口耳又󰁶
预	󰁻乛亅贝
鲜	󰁢󰀞䒑󰀟
珑	王ヒ丶
悲	丨三丨心
栩	木羽󰀝
聨	耳幺幺廾
魃	白󰁜厶丶
耔	三󰅇子󰀝
途	人一木辶
怔	忄一止󰀝
瀔	氵士冖又
鲆	󰁢󰀞一十
桄	木⺌一儿
瘥	疒䒑󰀠工
巍	山禾女厶
淍	氵󰀼土口
橡	木⺈口󰀓
席	广廿冂丨
叻	口力ノ
堕	阝月土
䠕	口止止木
㠕	山阝丿厶
㼳	小丿目丶
伳	亻廿󰄃󰁀
坲	土弓󰀯󰀢
杲	日木󰁧
缳	纟罒一󰀔
輳	車三人大
昢	日凵山󰀢
阢	阝一儿󰁀
蘢	艹立月三
颦	止󰀤丆十
犹	犭ノ丶
管	⺮宀丨󰁃
碲	石亠丷丨
丕	丆卜一󰀘
跤	口止亠乂
罅	󰅎山󰅋󰀛
舄	臼勹灬󰁧
髩	󰂞彡一𠃌
㐯	󰁸口禾日
加	力口󰀝
畔	田丷󰀟󰀢
塩	土𠂉口皿
㪖	󰁭氺󰀥又
謦	士󰁅几言
蒙	艹冖二󰀓
劕	斤斤貝刂
䊕	米󰁬󰀟廴
秖	禾󰁚󰀁󰁀
槖	士冖石木
銕	釒一弓人
觖	⺈用ユ人
㜲	女󰄹月丶
跫	工几丶󰁾
圲	土丿十󰀢
㙢	土廿冂丶
丣	一󰀯匚󰁃
潳	氵尸土日
晢	扌斤曰󰀘
轳	车󰀥尸ノ
踣	口止立口
院	阝宀二儿
犄	牜大丁口
盌	夕⺋皿󰀘
漍	氵囗戈󰀞
鼍	口口田乚
鹜	󰁻乛亅一
酆	山三丨阝
胱	月⺌一儿
乍	𠂉丨二󰀘
磋	石䒑󰀠工
骡	󰀊󰀞田小
坜	土厂力ノ
嬲	田力女力
碱	石厂一丶
琳	王木木󰁶
㧖	扌丶尸乙
蹟	口止貝
䨖	󰀙月󰀘
鷣	覀早󰁟灬
跣	口止丿儿
稖	禾立口󰀝
訖	言𠂉乙󰁀
㾳	疒冫⺈女
䖢	虫小丿󰁥
㖢	口广止匕
澳	氵丿ㄇ大
矲	𠂉大罒匕
侳	亻人人土
埲	土三人󰀟
徘	彳丨三三
煊	火宀一一
蟲	虫虫虫󰁧
韲	󰀴丨三一
府	广亻寸󰀦
鲋	󰁢󰀞亻寸
㾪	疒小丿目
暌	日癶一大
皌	白一木󰁶
捕	扌一月丶
衡	彳󰁢大丁
廅	广土厶皿
䋈	女又幺小
妤	女󰁻乛亅
驺	󰀊󰀞⺈彐
霕	󰀙二厶乚
轖	車土人口
眕	目人彡󰁥
潖	氵王王巴
彖	彑󰀓󰁧
闢	門尸口辛
骣	󰀊󰀞尸子
痢	疒禾刂󰀵
趣	土󰁾耳又
嗢	口曰皿󰀝
涣	氵⺈ㄇ大
㶣	干火󰁧
䶣	止󰀆山䒑
翳	匚𠂉大羽
枲	厶口木󰁧
忳	忄一凵乚
俳	亻丨三三
缡	纟亠乂厶
湖	氵古月󰀝
鞲	廿󰀜󰀀土
迳	ス工辶󰀌
杩	木󰀊一󰀝
桕	木臼󰀝
姹	女宀丿七
耨	三󰅇厂寸
芈	丨一󰀥󰀟
校	木亠八乂
戤	乃又皿戈
悱	忄丨三三
旹	凵丨一曰
貅	豸亻木󰁶
龖	立月一三
鶌	尸凵山灬
羖	⺶几又󰁶
辖	车宀三口
囕	口匚丨儿
澖	氵門木󰁶
赣	立早夂贝
㜕	女車辶󰁶
铄	钅丿󰄃小
锢	钅囗古󰀝
䔢	艹人人ㄅ
㵣	氵日勹人
浣	氵宀二儿
嵣	山广󰁬口
炱	厶口火󰁧
肱	月厶󰁶
邱	󰅍󰀞阝󰀢
嶌	山󰁟灬󰁧
㡲	广戈󰀦
䂱	石丷口儿
塲	土𠂉曰󰁤
桲	木十冖子
䶌	丿目田巳
靡	广木木三
揩	扌󰁴匕白
毅	立󰀓几又
賖	貝人一朩
糖	米广󰁬口
试	讠󰀁工丶
閕	門󰀄亅丿
镰	钅广䒑󰁗
贱	贝二󰅅丶
鲅	󰁢󰀞丶
挹	扌口巴󰁀
竺	⺮二󰀘
髺	󰂞彡丿古
䍝	罒水日󰀘
蓠	艹亠乂厶
巌	山󰀧厂攵
蒡	艹亠丷方
鳪	卜󰁟灬󰁶
唩	口禾女󰀝
犭	犭ノ丿丿
峍	山󰁬󰀟󰀢
㔩	勹土厶皿
䳪	山丆冂灬
哕	口山夕󰁶
涖	氵亻立󰀝
㶖	氵亻丨灬
䓕	艹二儿辶
锌	钅辛󰀢
庋	广十又󰀦
罘	罒丆卜󰁧
泐	氵阝力ノ
褰	宀󰀀八󰀔
骺	󰀾月⺁口
㤞	忄宀丿七
穟	禾䒑󰀓辶
紖	糹弓丨󰀢
贖	貝士罒貝
鴖	󰁂󰀁󰁟灬
臁	月广䒑󰁗
媺	女山一攵
岪	山弓󰀯󰀬
畩	田亠󰀔󰁶
就	亠口小丶
叽	口几󰁀
䲪	大󰁟灬󰁶
瞀	󰁻乛亅目
谀	讠臼人󰁶
铫	钅儿󰀪󰁶
坳	土ㄠ力ノ
裥	衤󰁧门日
琝	王日文󰁶
锼	钅臼丨又
汲	氵乃󰂃󰁶
霎	󰀙立女󰀘
螋	虫臼丨又
䳖	󰁟灬耳乚
㳖	氵亠󰀔󰁶
泖	氵󰁚丿卩
峖	山宀女󰀝
哓	口弋丿儿
鵪	大曰󰄃灬
撩	扌大丷小
㒩	亻彑󰀓虫
淆	氵乂月
胡	古月󰀝
鹖	曰勹人一
蘕	艹糹夂辶
墘	土十早乙
辽	了辶󰀵
篚	⺮匚丨三
篪	⺮⺁󰅋几
舁	臼廾󰀬
菅	艹宀丨󰁃
麈	广󰁃〢王
孕	乃子󰀘
獬	犭ノ⺈󰀟
梳	木亠厶󰀸
劭	刀口力ノ
偏	亻丶尸艹
平	一丷十󰀵
剨	三丨石刂
㑌	亻匚王󰀝
瓩	一󰁐󰁊十
崪	山亠人十
瑌	王丆冂大
㓩	⺈用刂󰀢
岍	山一廾󰀢
㴖	氵廿󰀜󰀢
䴖	月󰁠一
啕	口勹󰅎山
洖	氵口一大
迭	󰅎人辶󰀦
磅	石亠丷方
吸	口乃󰂃󰁶
寺	土寸󰁧
琹	王王木󰁧
止	止丨一一
藕	艹三󰅇丶
闕	門䒑凵人
劲	ス工力ノ
八	八丿󰂃
狡	犭ノ亠乂
婺	󰁻乛亅女
务	夂力󰁣
茅	艹󰁻乛丿
姆	女母󰁶
词	讠𠃌一口
投	扌几又󰁶
懨	忄厂日犬
溲	氵臼丨又
绣	纟禾乃ノ
㴍	氵了三󰀩
崍	山木人人
代	亻󰀁丶󰁶
擌	扌⺮大人
铌	钅尸匕󰁀
廖	广羽人彡
铅	钅几口󰀝
辗	车尸󰁺󰀖
㘕	口艹匚皿
鲳	󰁢󰀞日日
枢	木匚乂󰁶
籺	米𠂉乙󰁀
瘕	疒󰁃丨又
昕	日斤󰀢
嘕	口一止灬
乖	丿十丬匕
豺	豸󰀛丿ノ
掹	扌子皿󰀝
瓢	覀二小󰂃
豫	󰁻乛亅󰀓
婩	女山厂干
䩩	廿󰀜宀⺋
哪	口𠃌󰀠阝
泼	氵ㄥ丿丶
碕	石大丁口
恔	忄六乂󰁶
颕	匕二小贝
联	耳䒑大󰁶
蒌	艹米女󰀘
凹	丨󰁎󰀽一
裴	丨三丨󰀔
蹲	口止丷寸
戢	口耳󰅅丶
卢	󰀥尸󰁣
銎	工几丶金
凳	癶一口几
䀔	目刀丶󰁶
倔	亻尸凵山
枫	木几乂󰁶
㟕	山口󰁦十
庇	广󰁴匕󰁫
阕	门癶一大
蛤	虫人一口
颅	󰀥尸丆贝
荌	艹宀女󰀘
踪	口止宀小
暖	日爫一又
琢	王一󰀓丶
硫	石亠厶󰀸
岢	山丁口󰀘
笼	⺮ヒ丶
霩	󰀙󰁸孑阝
殳	几又󰁧
謇	宀󰀀八言
鼗	儿󰀪士又
庚	广󰁬人󰀦
悔	忄𠂉母󰁶
硕	石丆贝󰁶
衕	彳冂一丁
顕	日业丆貝
畹	田宀夕⺋
敹	󰀥冖丿攵
镹	󰂞ク󰂃󰁶
绗	纟彳一丁
驽	女又󰀊一
趱	土󰁾丿贝
硖	石一丷大
豳	山一󰀓󰀓
㿖	疒虍田皿
舆	󰀗车一八
墕	土一止灬
䁔	目爫一又
粳	米一日乂
分	八刀󰁣
睩	目󰁭氺󰁶
革	廿󰀜󰀬
谍	讠廿󰄃木
庪	广扌十又
㵺	氵⺮白十
序	广󰁻乛亅
龚	ヒ丶八
浺	氵忄口丨
璹	王士乛寸
悃	忄囗木󰁶
嵺	山羽人彡
鵖	󰁮󰁟灬󰁶
蔕	艹廿儿丨
絖	糹⺌一儿
匪	匚丨三三
钹	钅又丶
挪	扌𠃌󰀠阝
蜣	虫䒑󰀠乚
墰	土覀早󰀢
野	日土󰁻亅
骗	󰀊󰀞丶艹
骇	󰀊󰀞亠人
㴺	氵氵大人
㚩	女冂二󰀝
佪	亻囗口󰀝
㓹	厂火火刂
擹	扌廿口人
㡕	冂丨艹大
䂔	𠂉大土十
傔	亻䒑󰁬八
防	阝方ノ
疫	疒几又󰀦
窍	宀八工ㄅ
吏	一口乂󰀦
麽	广木木厶
盩	土䒑十皿
曩	日亠口󰀔
囩	囗二厶󰀦
㛩	女亠厶月
勘	艹三八力
庭	广丿士廴
鸨	匕十勹一
鶖	禾火󰁟灬
摘	扌亠丷古
綖	糹丿󰀥廴
蓕	艹木土土
谤	讠亠丷方
逓	⺁二冂辶
照	日刀口灬
倓	亻火火󰁶
琩	王日曰󰀝
萩	艹禾火󰁧
舌	丿古󰀌
蔗	艹广廿灬
跏	口止力口
鳙	󰁢󰀞广丨
㙹	土艹罒夕
晹	日曰勹󰁤
悫	士冖几心
壶	士冖󰅊一
瘭	疒覀二小
驵	󰀊󰀞󰀐一
攕	扌人人󰀞
唕	口白十󰀢
䵖	匚丨󰁃氺
㵖	氵女口小
虹	虫工󰀝
娑	氵小丿女
陹	阝丿廾日
笍	⺮冂人󰁧
捔	扌⺈用󰀢
宕	宀石󰀘
荔	艹力力力
箕	⺮艹三八
鋌	釒丿士廴
䮪	󰀋灬夕木
䍔	罒厶󰁧
㮕	木丆冂大
瑩	火火冖丶
葩	艹白巴󰀅
勇	󰁻月丨力
缚	纟一󰀐寸
骀	󰀊󰀞厶口
柘	木石󰀝
饬	⺈󰁐𠂉力
戗	人⺋戈󰁶
荇	艹彳一丁
养	䒑二人󰀯
桫	木氵小丿
銌	釒丨子
抌	扌冖󰁜󰁀
飘	覀二小乂
裘	一氺丶󰀔
汪	氵王󰀝
籪	⺮幺幺斤
婍	女大丁口
汩	氵日󰀝
蠃	亠󰄃口丶
鎔	釒宀八口
佥	人一󰀧一
雳	󰀙厂力󰁣
椴	木亻三又
竕	立八刀󰁥
茔	艹冖土󰀘
匔	勹丿󰀽口
挔	扌亠󰀔󰁶
㫕	日一儿󰀅
䌔	糹匚口口
盼	目八刀ノ
捂	扌五口󰀝
冗	冖几󰀅
楝	木一󰀹󰅇
浮	氵爫子󰀝
烒	火󰀁工丶
胒	月尸匕󰁀
庹	广廿尸󰂃
䧌	阝爫女󰀝
纹	纟文󰁶
絮	女口ㄠ小
超	土󰁾刀口
赠	贝丷󰀺日
赁	亻丿士贝
阐	门丷曰十
锔	钅尸𠃌口
闹	门亠冂丨
駌	夕⺋󰀋灬
鹣	䒑󰁬󰁗一
觥	⺈用⺌儿
桓	木一日一
塓	土冖曰六
耒	三󰅇󰀦
鮕	󰁢灬古󰀝
觉	󰀧冖ㄇ󰁜
鳐	󰁢󰀞爫山
叔	上小又󰁶
䰕	󰂞彡虍皿
㰕	木丷王丶
峥	山⺈󰁬亅
鰕	󰁢灬󰁃又
菔	艹月卩又
珔	王丨子
氕	󰅎⺄丿󰁣
挃	扌一厶土
妸	女丁口󰀝
螨	虫艹一人
翩	丶尸冂羽
爉	火巛囗󰁒
熤	火羽立󰀝
㖟	口爫冖又
裟	氵小丿󰀔
蚧	虫人󰀯󰀢
䄯	禾一廾󰀢
艉	丿󰁪尸乚
綮	丶尸夂小
䥌	宀日日金
㥌	忄勹米󰁶
坸	土勹口󰀝
漠	氵艹日大
竞	立口儿󰀅
传	亻二󰁓丶
韵	立日勹冫
剑	人一󰀧刂
溯	氵䒑凵月
岐	山十又󰁶
趾	口止止󰀝
鲐	󰁢󰀞厶口
厔	厂一厶土
歕	十艹貝人
筕	⺮彳一丁
譕	言𠂉一灬
䭲	禾日大口
孲	孑一󰀚一
掱	手手手󰀬
筲	⺮⺌月󰀘
莱	艹一米󰁧
鎱	釒土口󰀔
帨	冂丨丷儿
鲚	󰁢󰀞文󰀯
绮	纟大丁口
滞	氵一〣丨
薤	艹一夕一
吹	口⺈人󰁶
喽	口米女󰀝
痦	疒五口󰀌
筐	⺮匚王󰀘
曹	一ㄇ󰁺日
呗	口贝󰁶
萤	艹冖虫󰁧
莫	艹日大󰁧
迢	刀口辶󰀌
荟	艹人二厶
曯	日尸氺虫
损	扌口贝󰁶
荬	艹乛󰁦大
鷨	艹一艹灬
涡	氵口冂人
唍	口宀二儿
胆	月日一󰀝
鷖	匚𠂉大灬
跖	口止石󰀝
㬲	一日乂皿
福	礻󰁶一田
叱	口ヒ󰁀
䏱	月尸𠃌口
珱	王󰀧女󰀝
揱	⺌月刂手
鏱	釒立早󰀢
菱	艹土八夂
阡	阝丿十󰀢
哈	口人一口
逿	曰一勹辶
暸	日大丷小
钗	钅又丶󰁶
罢	罒土厶󰁧
酌	西一勹丶
玟	王文󰁶
颐	匚丨口贝
原	厂白小󰀦
赦	土󰁖夂󰁶
梨	禾刂木󰁧
诟	讠⺁一口
替	二人二日
姓	女丿主󰀝
㗕	口󰀀冂土
鸽	人一口一
槽	木一ㄇ日
準	氵亻󰁷十
痕	疒艮󰀦
䗕	宀夕⺋虫
庖	广勹巳󰁫
踖	口止󰁺日
陕	阝一丷大
蹁	口止丶艹
策	⺮一冂󰅇
挱	扌氵小丿
篲	⺮三丨彐
䯲	󰂞彡巴󰀅
匱	匚口丨貝
账	贝丿七󰂃
混	氵日󰁴匕
茱	艹󰅎󰅇󰁧
錱	金王王󰀘
柽	木又土󰀝
拟	扌󰁐丶人
寥	宀羽人彡
该	讠亠ㄥ人
苞	艹勹巳󰀅
鳕	󰁢󰀞󰀙彐
职	耳口八󰁶
銓	釒人王󰀝
贽	扌九丶贝
劓	丿目田刂
抓	扌⺁丨󰂃
冿	冫󰁬󰀟󰀢
谵	讠⺈厂言
鲶	󰁢󰀞人心
㷖	日火刀口
版	丿丨一又
嚕	口󰁢灬日
䚕	一ㄇ丶儿
皕	丆日丆日
淖	氵󰀥早󰀢
㮲	木勹凵丿
笕	⺮ㄇ󰁜󰀅
拔	扌又丶
嬕	女罒土十
箲	⺮氵丿儿
捱	扌厂土土
危	⺈厂⺋󰀅
䍱	⺶人一朩
尥	乚勹丶
煲	亻口木火
鍱	釒廿󰄃木
讲	讠二󰀯󰀢
濌	丿一曰日
剓	禾勹丿刀
棸	耳又木󰁧
壸	士冖一业
脲	月尸水󰁶
淮	氵亻󰁷󰀝
跑	口止勹巳
箸	⺮土丿日
镶	钅亠口󰀔
铐	钅土丿ㄅ
髨	󰂞彡二儿
她	女也󰁀
臯	丿目󰀪十
南	十冂䒑十
撤	扌亠厶夂
㙕	土田月󰀝
世	廿󰄃󰁫
噕	爫丿󰁈口
錔	釒水日󰀝
縖	糹宀三口
㒱	丿󰂃夕󰁧
䒱	艹了󰀩一
咱	口丿目󰀝
撱	扌阝月
眼	目彐󰀖󰁶
锑	钅丷弓丿
隦	阝尸口辛
挓	扌宀丿七
缌	纟田心󰁶
筅	⺮丿土儿
迥	冂口辶󰀌
笥	⺮𠃌一口
籲	⺮人一貝
豲	一󰀓厂小
钱	钅二󰅅丶
轌	車󰀙彐󰀝
奸	女干󰀢
䗑	虫日立󰀝
笄	⺮一廾󰀬
火	火火火火
缉	纟口耳󰀝
鳎	󰁢󰀞日羽
征	彳一止󰀝
鸾	亠󰁗勹一
瀱	氵罒厂刂
嫦	女⺌冖丨
鲥	󰁢󰀞日寸
窳	宀八⺁󰂃
粥	弓米弓󰁀
䎓	羽水日󰀝
庌	广󰀄亅丿
鋔	釒⺈口󰁜
谘	讠冫⺈口
栨	木冫⺈人
掠	扌󰁸小󰁶
筜	⺮⺌彐󰀘
铮	钅⺈󰁬亅
童	立日土󰀘
锐	钅丷口儿
焑	火囗木󰁶
呰	止匕口󰀘
煔	火火󰀥口
㰱	丿一日人
䰱	󰀙口口厶
䅔	禾巛田󰀝
㦕	忄阝夂
榕	木宀八口
妕	女口丨󰀢
筮	⺮工人人
搭	扌艹人口
鄞	廿口主阝
瑞	王山丆〢
鼼	丿目田丨
廌	󰁙一ㄅ灬
瑰	王白󰁜厶
葰	艹亻厶夂
弼	弓丆日弓
漼	氵山亻󰁷
缼	𠂉十凵人
輼	車曰皿󰀝
柨	木冂丨
穋	禾羽人彡
㼼	覀二小丶
似	亻󰁐丶人
需	󰀙丆冂〢
要	覀女󰀘
鸌	󰁟灬艹又
积	禾口八󰁶
吞	一大口󰀘
秦	三人禾󰁧
檨	木丷王人
媨	女丷西一
䒰	艹匚王󰀘
㳱	氵阝日󰀝
焔	火󰁡丨日
咰	口勹日󰀝
儔	亻士乛寸
棕	木宀二小
㣕	彳大󰁶
䣕	󰀋灬阝󰀢
宽	宀艹ㄇ󰁜
秊	禾丿十󰀬
队	阝人󰁶
啐	口亠人十
賱	貝冖車󰀢
環	王罒一󰀔
衲	衤󰁧冂人
鳱	干󰁟灬󰁶
彼	彳󰅌又󰁶
佼	亻亠八乂
㽼	疒弓丨󰀵
班	王丶丿王
齼	止󰀆木󰁾
轼	车󰀁工丶
罼	罒曰艹󰀟
潼	氵立日土
爯	爫冂土󰀘
蟑	虫立早󰀢
禳	礻󰁶亠󰀔
柊	木夂󰁦󰁶
㨕	扌乃又皿
㶱	火木一󰀝
䶱	夂󰁦丿󰁵
嗰	口亻囗古
稕	禾󰁸子󰀝
懔	忄亠囗小
凔	冫人丶口
䨕	󰀙氵一󰀛
禁	木木二小
帛	白冂丨󰀬
騕	󰀋灬覀女
訕	言山󰀢
龊	止人凵󰁾
绑	纟三丿阝
镟	钅方𠂉󰁾
赘	主󰁡夂贝
祟	凵山二小
蕨	艹厂䒑人
巧	工一ㄅ󰁀
䕨	艹月丷小
侼	亻十冖子
痰	疒火火󰀦
藰	艹󰁚丶刂
㾼	疒艮辶󰀦
込	丿󰂃辶󰀦
龟	⺈日乚󰀅
澼	氵尸口辛
羼	尸䒑󰀟󰀟
豓	山三丨皿
寿	三丿寸󰁧
㐾	亻二儿󰁀
㿃	疒廿儿丨
露	󰀙口止口
颀	斤丆贝󰁶
镏	钅󰁚丶田
阮	阝二儿󰁀
搰	扌󰀾月󰀝
吰	口厶󰁶
䐰	月亻丨月
㐰	亻口󰀝
㥕	火火心󰁧
䆔	宀八口丨
奕	亠󰁖大󰁧
楕	木工月
斟	艹三八十
诩	讠羽󰀝
蓒	艹車干󰀬
擒	扌人亠厶
蹦	口止山月
鐰	釒口口木
豱	一󰀓日皿
琰	王火火󰁶
㿼	一廾皿󰀘
贮	贝宀一󰀝
忼	忄亠几󰁀
俼	亻亠厶月
翼	羽田󰁺八
濼	氵白幺木
擨	扌⺁虍人
迼	士口辶󰀌
㑔	亻丆贝󰁶
鴌	一大󰁟灬
岕	山人󰀯󰀬
䲕	󰁢灬䒑日
䴱	木人人匕
沕	氵勹󰁤󰁥
鲕	󰁢󰀞丆〢
葔	艹亻ユ大
闊	門氵丿古
泚	氵止匕󰁀
弈	亠󰁖廾󰀬
宥	宀月󰀘
烽	火夂三丨
车	车一ㄥ丨
霂	󰀙氵木󰁧
鳿	王󰁟灬󰁶
鵩	月卩又灬
蔾	艹禾勹木
唨	口阝󰀐一
蔨	艹囗丷⺋
霞	󰀙󰁃丨又
研	石一廾󰀢
㔨	勹丬匕月
汉	氵又󰁶
蕰	艹氵曰皿
鴱	艹乂󰁟灬
洱	氵耳󰀝
紱	糹又丶
屉	尸廿󰄃󰁫
矍	目目亻又
滋	氵䒑ㄠㄠ
竭	立日勹󰄃
䯕	󰀾月丿廴
寕	宀丆罒丁
擾	扌丆󰀐夂
㐔	󰁸乙󰀅
㷱	厶月土灬
鐔	釒覀早󰀢
喰	口人丶艮
篕	⺮土厶皿
瞟	目覀二小
訾	止匕言󰀘
挽	扌⺈口󰁜
媿	女白󰁜厶
㨨	扌󰁚丶田
生	丿主󰀌
娹	女弓亠幺
直	十󰀣󰀘
目	目目目目
盟	日月皿󰀘
摈	扌宀󰅍八
谚	讠立丿彡
鳩	九󰁟灬󰁶
䳩	西女󰁟灬
䳌	厶月󰁟灬
㧨	扌⺁一口
疰	疒丶王󰀌
深	氵冖八木
鷱	丿目󰀪灬
薰	艹丿一灬
槨	木󰁸孑阝
溦	氵山一攵
括	扌丿古󰀝
觨	⺈用工水
讫	讠𠂉乙󰁀
角	⺈用󰀬
㛰	女󰁂󰀁日
亱	亠亻曰一
础	石凵山󰀢
拽	扌日󰅅ノ
血	丿皿󰀌
杰	木灬󰁧
芤	艹孑乚󰀅
餕	人良厶夂
胔	止匕冂人
烔	火冂一口
惔	忄火火󰁶
僔	亻丷西寸
䃔	石宀口口
㤕	忄凵山󰀢
护	扌丶尸ノ
措	扌󰁺日󰀝
瘓	疒⺈ㄇ大
恝	三丨刀心
裾	衤󰁧尸古
痧	疒氵小丿
授	扌爫冖又
痄	疒𠂉丨二
麱	木人人甫
近	斤辶󰀵
篮	⺮〢𠂉皿
诖	讠土土󰀝
困	囗木󰀦
溱	氵三人禾
纱	纟小丿ノ
蛰	扌九丶虫
悝	忄日土󰀝
㒔	亻罒勹虫
䒔	艹八󰁧
展	尸󰁺󰀖󰀦
撔	扌曰󰁸小
䔰	艹宀一田
㔰	匚夕卜󰀦
钔	钅门󰁀
篿	⺮一曰寸
痓	疒一厶土
膻	月亠囗一
屌	尸口冂丨
褚	衤󰁧土日
沣	氵三丨󰀢
瓤	亠口口󰂃
璧	尸口立丶
莽	艹犬廾󰀬
窥	宀八二󰁜
亠	亠丶一
帘	宀八冂丨
钟	钅口丨󰀢
弩	女又弓󰀅
杨	木ㄋ󰁤ノ
䢃	尸口辛乂
锰	钅子皿󰀝
赱	土丷󰂃󰁧
田	田田田田
浱	氵厂二󰀖
胂	月日丨󰀢
殉	一夕勹日
捭	扌白丿十
然	󰁝犬灬󰁧
㙰	⺈用刀土
丱	󰀯󰁐丨一
箌	⺮一厶刂
尾	尸丿二乚
觞	⺈用𠂉󰁤
淿	氵白冂丨
鵿	󰁟灬日廾
尖	小大󰁧
椒	木上小又
泵	石水󰁧
燧	火䒑󰀓辶
兮	八一ㄅ󰀅
鲸	󰁢󰀞亠小
㶿	火十冖子
舾	丿󰁪西󰀝
㷩	丿匚丨火
瞸	目艹廿木
龕	人一口三
曨	日立月三
戾	丶尸犬󰀦
杔	木丿七󰁀
徕	彳一米󰁶
蝔	虫󰁴匕白
羕	丷王丶󰀩
妯	女由󰀝
狂	犭ノ王󰀝
鸱	󰁚󰀁丶一
㝔	宀六乂󰁧
縱	糹彳人󰁾
踱	口止广又
帱	冂丨三寸
渱	氵虫工󰀝
输	车人一刂
鸸	丆冂〢一
仱	亻人丶乛
㚰	女丆卜一
贵	口丨一贝
掯	扌止月󰀝
褴	衤󰁧〢皿
旆	方𠂉一丨
䖾	虫宀二儿
蜨	虫一󰁬󰁾
眨	目丿之󰁶
尒	人小󰁧
彩	爫木彡ノ
曓	曰凵山十
悂	忄󰁴匕土
稿	禾󰁸冂口
亘	一日一󰀘
烤	火土丿ㄅ
霔	󰀙氵丶王
怕	忄白󰀝
绕	纟弋丿儿
蜔	虫勹田󰀝
廕	广阝人厶
朔	䒑凵丿月
㻕	王尸凵山
隰	阝日ㄠ灬
萝	艹罒夕󰁧
炷	火丶王󰀝
滱	氵宀二又
廱	广巛口󰁷
軱	車⺁厶󰂃
绱	纟⺌冂口
佲	亻夕口󰀝
垱	土⺌彐󰀝
枱	木厶口󰀝
署	罒土丿日
轲	车丁口󰀝
齲	止󰀆丿丶
裂	一夕刂󰀔
蚪	虫󰁦十󰀢
雒	夂口亻󰁷
陋	阝一冂󰄃
䪌	廿󰀜⺈丶
㞓	尸匕日󰀌
㑨	亻口𠂉大
凂	冫⺈口󰁜
技	扌十又󰁶
鼋	二儿口乚
韔	󰁆口㐄󰀖
蟔	虫󰀹土灬
矔	目艹口󰁷
柔	󰁻乛亅木
蓁	艹三人禾
潘	氵丿米田
䳿	󰁝犬灬灬
冤	冖⺈口丶
佘	人二小󰁧
砝	石土厶󰁶
軩	車厶口󰀝
皨	白白白土
埔	土一月丶
䟔	口止卜󰁶
㟔	山人丶口
㽲	疒一ㄅ󰁫
乱	丿古乚󰁀
㘰	土󰁦十󰀢
奃	大󰁚󰀁丶
鳗	󰁢󰀞日又
循	彳⺁十目
忺	忄⺈人󰁶
趵	口止勹丶
涵	氵了󰀪凵
持	扌土寸󰁶
答	⺮人一口
杓	木勹丶󰁶
呾	口曰一󰀝
礅	石󰁸孑攵
艳	三丨⺈巴
端	立山丆〢
热	扌九丶灬
鞔	廿󰀜⺈󰁜
闾	门口口󰀌
䨌	󰀙二儿󰀅
抿	扌󰁃󰁐弋
录	󰁭氺󰁧
枔	木人丶乛
罕	冖八干󰀬
轕	車艹曰󰄃
窭	宀八米女
聆	耳人丶󰁻
㞔	尸夕夕󰀦
鹱	󰁠󰀞艹又
蘰	艹糹曰又
瘰	疒田ㄠ小
湱	氵三丨石
嘰	口幺幺人
濲	氵士冖又
眱	目一弓人
䜱	八人口又
忲	忄大丶󰁶
撙	扌丷西寸
倍	亻立口󰀝
㪕	󰀥早󰀥又
霱	󰀙󰁻乛口
剔	日勹󰁤刂
䉔	⺮一夕戈
窕	宀八儿󰀪
扔	扌乃ノ
鉔	釒匚冂丨
誕	言丿󰀥廴
堓	土山厂干
栓	木人王󰀝
泯	氵󰁃󰁐弋
聒	耳丿古󰀝
榷	木冖亻󰁷
啤	口白丿十
婌	女上小又
挤	扌文󰀯󰀢
觃	冂󰁜子󰀌
姃	女一止󰀝
籩	⺮丿目辶
翘	弋丿一羽
恪	忄夂口󰀝
厦	厂丆目夂
濠	氵󰁸冖󰀓
㜱	女斤斤貝
胪	月󰀥尸ノ
猾	犭ノ󰀾月
弲	弓口月󰀝
伲	亻尸匕󰁀
矱	𠂉大艹又
漲	氵弓󰀍󰀖
韱	人人戈󰀞
㧕	扌󰁚丿卩
橌	木門月󰀝
帿	冂丨亻大
槕	木󰀥曰木
爔	火丷王丶
䈔	⺮󰁃丨又
刔	ユ人刂󰀢
丿	丿丿〇〇
查	木日一󰀘
舔	丿古一⺗
鈔	釒小丿󰁥
傘	人人人十
栒	木勹日󰀝
驃	󰀋灬覀小
軺	車刀口󰀝
炀	火ㄋ󰁤ノ
嘈	口一ㄇ日
胀	月丿七󰂃
鹃	口月勹一
馆	⺈󰁐宀󰁃
州	丶丿丶丨
真	十󰀣八󰁧
屏	尸䒑廾󰀵
疮	疒人⺋󰁫
芦	艹丶尸󰁣
㟱	山丷王灬
洞	氵冂一口
烰	火爫子󰀝
袱	衤󰁧亻犬
郰	耳又阝󰀢
熸	火󰀄󰁜日
㢱	弓厶小󰁶
䃰	石宀󰁯小
墱	土癶一䒑
梱	木囗木󰁶
陈	阝󰀂小󰁶
堵	土土丿日
婳	女一田凵
华	亻ヒ十󰀬
总	丷口心󰁧
启	丶尸口󰀌
鳋	󰁢󰀞又虫
漫	氵日罒又
漪	氵犭ノ口
恻	忄贝刂󰀢
祭	󰁯二小󰁧
鼕	士口䒑󰁦
輕	車一巛工
盔	火皿󰀘
曔	日艹勹攵
囔	口一口󰀔
伕	亻夫󰁶
㛔	女夂三丨
撮	扌日耳又
霖	󰀙木木󰁧
颒	水廾丆贝
䢒	六乂辶󰀦
羨	丷王氵人
㚹	女󰁚丿卩
睱	目󰁃丨又
澲	氵业䒑未
坱	土ㄇ大󰁶
侲	亻厂二󰀖
醐	西一古月
浘	氵尸毛󰁀
靱	廿󰀜刀󰂃
農	ㄇ󰁺厂󰀖
䩕	廿󰀜󰁚卩
婕	女一󰁬󰁾
橕	木⺌冖丿
穕	禾亻󰁷木
芔	凵丨凵丨
驕	󰀋灬丿口
匙	日一󰁾匕
漂	氵覀二小
莲	艹车辶󰁧
静	主月⺈亅
截	十戈亻󰁷
珀	王白󰀝
翥	土丿日羽
翦	䒑月刂羽
秧	禾ㄇ大󰁶
宁	宀丁󰀬
脮	月爫女󰀝
焮	火斤⺈人
荂	艹大二ㄅ
靹	廿󰀜冂人
㾲	疒󰁡攵
碧	王白石󰀘
烦	火丆贝󰁶
馑	⺈󰁐廿主
恤	忄丿皿󰀝
僮	亻立日土
䤯	釒一廾彡
公	八厶󰁧
榭	木丿󰀽寸
腒	月尸古󰀝
臆	月立日心
溧	氵覀木󰁶
绸	纟󰀼土口
魁	白󰁜厶十
翺	丿目󰀪羽
䁸	目ㄇ󰁺󰀖
溢	氵䒑八皿
㟲	山厂白小
奓	大夕夕󰁧
娟	女口月󰀝
䶕	止󰀆巴󰁀
㶕	氵⺮門日
敔	五口攵󰁶
啔	丶尸戈口
源	氵厂白小
璀	王山亻󰁷
昆	日󰁴匕󰀅
炬	火匚󰁃󰀝
蠲	䒑八皿虫
砲	石勹巳󰁀
强	弓口虫󰁶
郱	䒑廾阝󰀢
䃱	石十戈󰀞
㠲	冂丨匕󰁀
惱	忄巛丿乂
堲	󰁮卩土󰀘
㛹	女亻一乂
鏂	釒匚口口
輺	車巛一田
箃	⺮耳又󰁧
菂	艹白勹丶
鳃	󰁢󰀞田心
幯	冂丨⺮卩
湯	氵曰一󰁤
蚮	虫亻󰀁丶
㦓	忄󰁝犬灬
禧	礻󰁶士口
湿	氵日󰅊一
䇒	󰁮󰀄󰁜立
凒	冫山一䒑
荀	艹勹日󰀘
寃	宀⺈口丶
峕	山亠曰󰀘
怛	忄日一󰀝
㔔	力口口󰀘
䳕	爫孑󰁟灬
湮	氵覀土󰀝
颂	八厶丆贝
䋕	亻丿士小
嗵	口󰁻月辶
週	󰀼土口辶
滘	氵冖八口
磲	石氵匚木
耱	三󰅇广石
倱	亻曰󰁴匕
棲	木一󰁬女
糕	米丷王灬
蔔	艹勹一田
嬉	女士口口
酬	西一丶丨
饽	⺈󰁐十子
秓	禾十又󰁶
捆	扌囗木󰁶
抚	扌二󰁜󰁀
瑂	王󰁅目󰀝
靖	立主月󰀝
逸	⺈口󰁜辶
擂	扌󰀙田󰀝
慏	忄冖曰六
塹	車斤土󰀘
䡹	車十冖󰁾
㾺	疒󰀋灬󰀦
鞇	廿󰀜囗大
湃	氵三十
㸕	⺁丨󰂃又
镲	钅宀󰁯小
煸	火丶尸艹
龠	人一口艹
痔	疒土寸󰀦
渕	氵䒑大刂
帕	冂丨白󰀝
䗔	虫亻ユ大
稓	禾󰁺日󰀝
颲	几丿虫刂
鸕	虍田皿灬
藔	艹宀大小
梲	木八口儿
偱	亻⺁十目
䁱	目土土儿
㢲	弓弓一八
娓	女尸毛󰁀
籃	⺮匚丨皿
覯	󰀀冂土儿
鲒	󰁢󰀞士口
馯	󰀋灬干󰀢
酞	西一大丶
滦	氵亠󰁗木
煞	⺈彐夂灬
港	氵󰁺八巳
䨑	󰀙一弓人
哆	口夕夕󰁶
孵	󰁚丶丿子
叫	口󰁐丨󰀢
炜	火二𠃌丨
爒	󰁝火大小
鈒	釒乃󰂃󰁶
㖔	口丿大口
䵕	禾人氺古
䥲	釒匚口人
冱	冫一󰅂一
楲	木戊一女
祲	礻󰁶彐又
襲	立月一󰀔
饲	⺈󰁐𠃌口
熮	火羽人彡
旎	方𠂉尸匕
闺	门土土󰀌
锆	钅丿土口
疔	疒丁󰀵
薔	艹土人口
鵕	厶八夂灬
额	宀夂口贝
㓂	冖二儿女
谱	讠䒑󰅊日
兢	古儿古儿
拈	扌󰀥口󰀝
襟	衤󰁧木小
讵	讠匚󰁃󰀝
鲁	󰁢一日󰀘
络	纟夂口󰀝
䦯	門一厶攵
慮	虍田心󰀦
苒	艹冂土󰀘
烸	火𠂉母󰁶
䃸	石人人󰀞
墹	土門日󰀝
沁	氵心󰁶
宵	宀⺌月󰀘
硔	石󰁺八󰁶
桔	木士口󰀝
顔	立丿彡貝
䤲	釒土󰁖󰁶
礲	石立月三
椲	木󰁆口㐄
餲	人良曰󰄃
褲	衤󰁧广車
腥	月日丿主
偬	亻勹󰁤心
挞	扌大辶󰁶
烘	火󰁺八󰁶
㡔	󰁻乛亅丨
屁	尸󰁴匕󰁫
塔	土艹人口
䡔	車夕夕󰁶
蒾	艹米辶󰁧
髓	󰀾月辶
涨	氵弓丿󰂃
鴃	󰁟灬ユ人
錮	釒囗古󰀝
鄸	艹罒冖阝
敂	勹口攵󰁶
书	󰁈𠃌丨丶
䴃	土土土灬
冋	冂口󰀌
鹦	贝贝女一
削	⺌月刂󰀢
涟	氵车辶󰁶
秘	禾心丿ノ
蜒	虫丿止廴
眦	目止匕󰁀
迕	𠂉十辶󰀵
姲	女宀女󰀝
栔	三丨刀木
㧲	扌宀木󰁶
脱	月丷口儿
鄱	丿米田阝
愱	忄疒𠂉大
秲	禾土寸󰁶
笓	⺮󰁴匕󰀅
嘴	口止匕用
定	宀一󰁾󰁧
笯	⺮女又󰁧
俕	亻宀木󰁶
堔	土冖八木
鉸	釒六乂󰁶
㠔	山尸口辛
㨹	扌三丨彐
䨹	󰀙亻丨灬
蔂	艹田幺小
恮	忄人王󰀝
理	王日土󰀝
程	禾口王󰀝
呀	口󰀂亅丿
踵	口止丿土
间	门日󰀌
猒	曰月犬󰁶
儮	亻厂禾止
茒	艹夕阝󰀬
蹭	口止丷日
日	日日日日
谁	讠亻󰁷󰀝
浚	氵厶八夂
恛	忄囗口󰀝
䅱	禾山一䒑
䓔	艹土丿子
㴕	氵艹禾󰁶
馲	󰀋灬丿七
腱	月󰁬󰀟廴
禲	礻󰁶厂丶
慱	忄一曰寸
溨	氵十戈木
案	宀女木󰁧
磹	石覀早󰀢
悸	忄禾子󰀝
傸	亻大乂乂
鴕	󰁟灬宀匕
蓔	艹丷王灬
紕	糹󰁴匕󰁀
涃	氵囗木󰁶
桯	木口王󰀝
硯	石目儿󰁀
旧	丨日󰀝
浓	氵冖󰀔󰁶
漭	氵艹大廾
楣	木󰁅目󰀝
叒	又又又󰁧
菒	艹曰木󰁧
墯	忄工土
鄀	艹口阝
膝	月木人氺
銱	釒口冂丨
暴	日󰁺八氺
鷃	曰宀女灬
妹	女二󰅇󰁶
婲	女艹亻匕
抱	扌勹巳󰁀
穲	禾一冂匕
颔	人丶乛贝
䇸	⺮口王󰀘
渠	氵匚󰁃木
㩲	扌艹口󰁷
䊱	米人人󰀞
左	工󰀘
濉	氵目亻󰁷
䯓	󰀾月土土
镭	钅󰀙田󰀝
岷	山󰁃󰁐弋
㢔	广彳人󰁾
䢔	人一口辶
墔	土山亻󰁷
煀	火尸凵山
夁	士罒囗古
慀	忄爫幺大
洧	氵月󰀝
醛	西一艹王
瞿	目目亻󰁷
舸	丿󰁪丁口
晴	日主月󰀝
宔	宀丶王󰀘
憛	忄覀早󰀢
箔	⺮氵白󰀘
膛	月⺌冖土
埭	土󰁬氺󰁶
騲	󰀋灬艹早
㮔	木丿一土
䮔	󰀋灬丿󰁺
拱	扌󰁺八󰁶
娲	女口冂人
英	艹ㄇ大󰁧
稲	禾爫丨日
盲	亠󰄃目󰀘
拜	三十󰀢
䨲	󰀙丆冂丶
㨲	扌艹宀木
惴	忄山丆〢
鴗	立󰁟灬󰁶
呒	口二󰁜󰁀
摒	扌尸䒑廾
簓	⺮󰀼土彡
带	一〣冖丨
懮	忄丆󰀐夂
時	日土寸󰁶
私	禾厶󰁶
耕	三󰅇二󰀯
鸦	󰀂亅丿一
偲	亻田心󰁶
寁	宀一󰁬󰁾
提	扌日一󰁾
犰	犭ノ九󰁀
谟	讠艹日大
兛	古儿丿十
䯔	󰀾月宀七
㯔	毛毛毛木
站	立󰀥口󰀝
鯔	󰁢灬巛田
腛	月尸一土
煛	目目火󰁧
比	󰁴匕󰁀
爱	爫冖又
舱	丿󰁪人⺋
刱	二󰀯刀八
戱	虍〢󰄃戈
㫲	日十冖子
䫲	戊一口貝
泶	󰀧冖水󰁧
嬸	女宀丿田
揯	扌忄一一
昼	尸󰂃日一
峦	亠󰁗山󰀬
阪	阝⺁又󰁶
泞	氵宀丁󰀢
苘	艹冂口󰀘
臂	尸口立月
娃	女土土󰀝
魑	白󰁜厶厶
谊	讠宀󰀐一
法	氵土厶󰁶
察	宀󰁯二小
綦	艹三八小
鴨	甲󰁟灬󰁶
鬔	󰂞彡夂辶
叶	口十󰀢
笔	⺮丿二乚
舛	夕󰀂丨󰀢
创	人⺋刂󰀢
欔	木目目又
㬔	日羽人彡
䈛	⺮󰀥冂又
殱	一夕十󰀞
骲	󰀾月勹巳
讱	讠刀丶󰁶
鏰	釒山月月
扱	扌乃󰂃󰁶
媲	女丿囗匕
䪲	一󰀯丆貝
㪲	󰁦十乛󰀅
丽	一冂丶丶
北	丬匕󰁀
涸	氵囗古󰀝
㚂	土一口󰀔
猛	犭ノ子皿
陛	阝󰁴匕土
嚂	口匚丨皿
仃	亻丁󰀢
鶸	弓冫弓灬
蔿	艹爫丿灬
捯	扌一厶刂
赨	土󰁖虫󰁶
崓	山囗古󰀝
㵨	尸口辛水
曀	日士冖䒑
魔	广木木厶
魜	󰁢灬人󰁶
沢	氵尸󰂃󰁶
懛	忄士口土
孔	孑乚󰁀
譔	言巳巳八
燛	󰁃丨匚火
荞	艹丿大󰀯
哭	口口犬󰁧
䭔	人良丿辶
㭔	木丿丷󰀛
崭	山车斤󰀬
震	󰀙厂二󰀖
缃	纟木目󰀝
帧	冂丨󰀥贝
㼃	王巛囗󰁒
漃	氵宀上又
帮	三丿阝丨
沛	氵一冂丨
说	讠丷口儿
潑	氵癶弓又
䀹	目大人人
蹀	口止廿木
蕉	艹亻󰁷灬
璐	王口止口
汽	氵󰅎⺄󰁀
坼	土斤丶󰁶
轃	車三人禾
㜂	土土寸女
銮	亠󰁗金󰀘
污	氵二ㄅ󰁀
嶓	山丿米田
蜾	虫日木󰁶
鶓	艹田󰁟灬
绿	纟󰁭氺󰁶
裕	衤󰁧八口
㬱	丿土儿日
嶂	山立早󰀢
等	⺮土寸󰁧
捰	扌曰木󰁶
笱	⺮勹口󰀘
䬱	人良木一
嬱	氵車斤女
赊	贝人二小
䲨	工󰁟灬󰁶
荰	艹木土󰀘
鍰	釒爫一又
噔	口癶一䒑
井	二󰀯󰀵
癔	疒立日心
晔	日亻ヒ十
陔	阝亠ㄥ人
虔	󰅋七文󰀦
执	扌九丶󰁶
剧	尸古刂󰀢
钉	钅丁󰀢
蓐	艹厂二寸
岑	山人丶乛
駅	󰀋灬尸󰂃
狞	犭ノ宀丁
星	日丿主󰀘
僬	亻亻󰁷灬
媸	女凵丨虫
鏯	釒大乂乂
雁	厂亻亻󰁷
邀	白方夂辶
體	󰀾月ㄇ䒑
諔	言上小又
竔	立丿廾󰀢
扛	扌工󰀝
剛	冂䒑山刂
䉛	⺮丿ㄇ大
䎰	二木󰁺斤
现	王ㄇ󰁜󰁀
掰	八刀手
鯱	󰁢灬虍几
莰	艹土⺈人
洈	氵⺈厂⺋
鸓	田田田灬
昔	󰁺日󰀘
瘔	疒艹古󰀌
䘔	丿皿宀口
嘔	口匚口口
蹼	口止󰅊人
繼	糹幺幺󰄃
跕	口止󰀥口
阔	门氵丿古
乼	氵丶王乙
㹼	犭󰁥勹米
涔	氵山人乛
句	勹口󰀌
猞	犭ノ人口
晭	日󰀼土口
鐯	釒艹土日
䘒	丿皿厶夂
昒	日勹󰁤󰁥
幓	冂丨厶彡
鲦	󰁢󰀞夂木
阁	门夂口󰀌
㓰	一由凵刂
䓰	艹覀土󰀘
岱	亻󰀁丶山
擰	扌宀心丁
鳔	󰁢󰀞覀小
伯	亻白󰀝
蘒	艹禾⺈乚
瘒	疒冖車󰀵
鹓	宀夕⺋一
弯	亠󰁗弓󰀅
㴸	氵門人󰁶
䴸	木人人子
瓰	一󰁐󰁊刀
蓰	艹彳止󰁾
铰	钅亠八乂
疿	疒弓󰀯󰀵
纼	纟弓丨󰀢
躼	丿󰀽三󰀖
庼	广󰁴丆贝
溼	氵一幺土
㺼	王乛󰁾󰁶
亼	人一󰀘
殡	一夕宀八
继	纟米󰄃󰁀
忖	忄寸󰁶
志	士心󰁧
㳸	氵艹亻ヒ
斑	王文王󰀝
旿	日𠂉十󰀢
糸	幺小󰁧
䗿	虫宀心丁
磂	石󰁚丶田
㭱	木匚甲󰀢
摑	扌囗戈󰀞
闿	门山己󰁫
㲒	勹口毛󰁀
筱	⺮亻丨夂
挰	扌口王󰀝
孱	尸子孑子
䭱	禾日㡀󰁶
窟	宀八尸山
㚒	大丿丶丶
錰	釒木灬󰁶
㚔	大䒑十󰀬
乕	⺁二冂丨
嚔	口十冖󰁾
暔	日十冂十
皔	白曰干󰀢
蚔	虫󰁚󰀁󰁀
鹕	古月勹一
軼	車丿夫󰁶
综	纟宀二小
婊	女主󰀔󰁶
殇	一夕𠂉󰁤
仼	亻王󰀝
㻼	王覀早󰀢
玛	王󰀊一󰀝
莛	艹丿士廴
馔	⺈󰁐巳八
凛	冫亠囗小
㦔	日月犬心
䦔	門日一󰀌
厛	厂口斤󰀵
榔	木丶彐阝
於	方人󰁦󰁶
灁	氵門白水
糒	米󰁺丿用
峒	山冂一口
搑	扌艹耳󰀝
䳒	十戈󰁟灬
诶	讠厶𠂉大
钵	钅木一󰀝
掷	扌䒑大阝
尰	乚丿土
䰰	󰀙丆冂厶
㰰	大人人人
汚	氵二ㄅ󰁀
尞	大丷曰小
皇	白王󰀘
懦	忄󰀙丆〢
正	一止󰀌
敯	󰁂󰀁日又
奂	⺈ㄇ大󰁧
㥂	忄日一寸
畿	ㄠㄠ戈田
鎷	釒󰀋灬󰁶
谰	讠门一󰅇
玷	王󰀥口󰀝
秔	禾亠几󰁀
槔	木白大十
委	禾女󰀘
䍛	罒囗古󰀘
鵸	大丁口灬
瓑	王厂禾止
駔	󰀋灬󰀐一
荛	艹弋丿儿
赝	厂亻亻贝
颡	又又又贝
䒯	艹冖九丶
谦	讠䒑󰁬󰁗
蒯	艹月月刂
啮	口止人凵
涯	氵厂土土
欤	一ㄅ󰀞人
旷	日广ノ
痷	疒大曰乚
跰	口止䒑廾
闷	门心󰀦
欢	又⺈人󰁶
園	囗土口󰀔
丸	九丶󰀦
常	⺌冖口丨
䒑	䒑丶丿一
蟒	虫艹大廾
㯨	木覀米󰁶
鑄	釒士乛寸
㧔	扌戊󰁶
㗷	口宀󰀀贝
䗷	虫立日心
嗷	口主󰁡夂
鐛	釒曰󰁸小
呵	口丁口󰀝
礔	石尸口辛
萛	艹目廾󰀬
夔	䒑丿目夂
椔	木巛田󰀝
㤔	忄亻寸󰁶
䐛	月大耳󰀝
㟒	山󰁬丿口
淸	氵冂一
姂	女丿之󰁶
槂	木孑丿小
鳝	󰁢󰀞䒑口
迓	󰀂亅丿辶
翓	士口羽󰀝
脊	󰀪人月󰀘
䲰	二厶󰁟灬
㲰	宀心皿毛
挷	扌三丿阝
岰	山幺力󰁥
俓	亻一巛工
亨	󰁸了󰀬
酁	⺈口󰁴阝
覂	覀丿之󰁧
如	女口󰀝
瘿	疒贝贝女
岸	山厂干󰀬
茑	艹󰁠一󰀘
茷	艹亻戈󰁧
粰	米爫子󰀝
趔	土󰁾一刂
錷	釒車乚󰁀
襔	衤󰁧廿丶
祔	礻󰁶亻寸
塒	土日土寸
饔	亠󰁲丿󰀖
䥔	釒覀米󰁶
㥔	忄亠厶月
換	扌⺈ㄇ大
奔	大十廾󰀬
瑯	王丶󰁮阝
葯	艹糹勹丶
鑯	釒人人󰀞
学	󰀧冖子󰀘
河	氵丁口󰀝
吼	口孑乚󰁀
呿	口土厶󰁶
月	月月月月
屰	䒑凵丿󰁣
汰	氵大丶󰁶
㱰	一夕宀辛
䱰	󰁢灬丿土
氯	󰅎⺄󰁭氺
氽	人水󰁧
谯	讠亻󰁷灬
裳	⺌冖口󰀔
迯	夕卜辶󰀦
鵂	亻木󰁟灬
迂	一󰀛辶󰀵
惰	忄工月
鍷	釒大土土
浂	氵䒑大󰁶
籰	⺮目目又
荷	艹亻丁口
薁	艹丿ㄇ大
㠾	夕⺋冂丨
赞	丿土儿贝
尽	尸󰂃󰁦󰁧
樘	木⺌冖土
性	忄丿主󰀝
粂	ク󰂃米󰁧
沂	氵斤󰀢
臣	匚丨󰁃丨
㲔	辛毛󰁀
䲔	󰁢灬一一
傛	亻宀八口
沔	氵一丨𠃌
炛	火亻ヒ󰀅
肛	月工󰀝
邛	工阝󰀢
鴰	丿古󰁟灬
贰	弋二贝丶
細	糹田󰀝
暷	日一曰寸
媒	女艹二木
徂	彳󰀐一󰀝
睁	目⺈󰁬亅
翠	羽亠人十
唼	口立女󰀝
辩	辛讠辛󰀢
厥	厂䒑凵人
槟	木宀󰅍八
崰	山巛田󰀝
䴰	木人人戈
㚷	女人小󰁶
尬	乚人󰀯
慢	忄日罒又
飔	几乂田心
葛	艹日勹󰄃
磔	石夕󰀂木
棔	木󰁚󰀁日
壔	土士乛寸
䑛	丿古󰁚丶
㑛	亻木口󰀝
轰	车又又󰁧
蹙	戊上小󰁾
泂	氵冂口󰀝
镞	钅方𠂉大
接	扌立女󰀝
竦	立一口󰅇
髒	󰀾月艹廾
舑	丿古冂土
铷	钅女口󰀝
呁	口勹冫󰀝
㑁	亻凵山󰀢
㺮	王二ㄅ󰁀
哷	口爫寸󰁶
滰	氵立曰儿
绰	纟󰀥早󰀢
軰	丬匕車󰀬
纮	纟厶󰁶
粽	米宀二小
㓷	丿目木刂
仰	亻󰁚卩󰀢
钰	钅王丶󰁶
遢	日羽辶󰀌
榫	木亻󰁷十
恩	囗大心󰁧
礤	石艹󰁯小
蜲	虫禾女󰀝
慧	三丨三心
肼	月二󰀯󰀢
酽	西一一厂
蹒	口止艹人
庿	广艹田󰀌
騒	󰀋灬又虫
䰔	󰂞彡丿皿
尔	⺈小󰁧
圭	土土󰀘
㰔	木言火又
脛	月一巛工
鰔	󰁢灬戊口
愛	爫冖心夂
簔	⺮亠一󰀔
綰	糹宀󰃧󰀝
涰	氵又又又
阷	阝一止󰀝
趰	土󰁾一乂
褮	火火冖󰀔
礮	石󰀋灬乂
符	⺮亻寸󰁧
茉	艹一木󰁧
裁	十戈亠󰀔
𢦏	十戈󰀦
峯	山夂三丨
槶	木囗戈󰀞
㘷	土艹乂󰁶
偽	亻丶丿灬
嘷	口丿目十
䶰	丿󰁵毛󰁀
渣	氵木日一
巤	巛囗乂󰁐
壮	丬士󰀝
楫	木口耳󰀝
咀	口󰀐一󰀝
榒	木弓冫冫
妒	女丶尸ノ
楠	木十冂十
㱔	止匕夕󰁧
㱂	广󰁬氺人
屔	丘尸匕󰁀
䃛	石車辶󰀢
烛	火虫󰁶
汔	氵𠂉乙󰁀
郛	爫孑阝󰀢
胛	月甲󰀢
走	土󰁾󰁧
鵰	󰀼土口灬
浰	氵禾刂󰀢
絰	糹一厶土
戥	日丿主戈
枮	木󰀥口󰀝
瞮	目亠厶攵
螮	虫廿儿丨
隈	阝田一󰀖
累	田ㄠ小󰁧
㞾	山尸匕󰁀
垾	土曰干󰀢
䙷	目儿寸󰁧
噷	口立日人
贯	󰅂十贝󰁧
㙷	土日幺灬
拼	扌䒑廾󰀢
哮	口土丿子
㖛	古口匕󰀅
侔	亻厶丿󰀟
缤	纟宀󰅍八
澯	氵󰀥夕米
珁	王一󰁐丶
盖	丷王皿󰀘
㝾	乚工
倽	亻人干口
䀽	目丿󰀥廴
羿	羽廾󰀬
逽	艹口辶
蝾	虫艹冖木
袷	衤󰁧人口
攞	扌罒糹󰁷
棚	木月月󰀝
窦	宀八十大
迁	丿十辶󰀵
鸰	人丶󰁻一
薷	艹󰀙丆〢
疷	疒󰁚󰀁丶
斷	幺幺一斤
喷	口十艹贝
丰	三丨󰀵
㖷	口日一󰁾
鎁	釒耳阝󰀢
诊	讠人彡ノ
喛	口爫一又
斛	⺈用󰁦十
羔	丷王灬󰁧
薛	艹亻󰁃十
㖆	口ㄇ󰁺󰀝
崆	山宀八工
汊	氵又丶󰁶
㨾	扌丷王󰀩
啛	口一󰁬女
䕛	艹言大人
㿔	疒田田田
㾱	疒癶二儿
侱	亻口王󰀝
埰	土爫木󰁶
澱	氵尸󰁺又
羱	⺶厂白小
辱	厂二󰀖寸
韰	󰀥夕又一
娾	女厂土土
擢	扌羽亻󰁷
濞	氵丿目󰀯
憭	忄大丷小
仅	亻又󰁶
遥	爫󰅎山辶
漆	氵木人氺
倐	亻丨夂火
触	⺈用虫󰁶
报	扌卩又󰁶
镛	钅广󰁬丨
蕛	艹禾丷丿
畛	田人彡ノ
敛	人一󰀧夂
鲟	󰁢󰀞彐寸
尊	丷西一寸
祚	礻󰁶𠂉二
㨚	扌艹勹日
㼔	日皿⺁󰂃
伔	亻冖几󰁀
掁	扌󰀍󰀖󰁶
净	冫⺈󰁬亅
郭	󰁸孑阝󰀢
悼	忄󰀥早󰀢
手	手丿一亅
鳄	󰁢󰀞口ㄅ
矬	𠂉大人土
框	木匚王󰀝
灐	氵火火金
聐	耳士口󰀝
偐	亻立丿彡
墮	阝工土
桅	木⺈厂⺋
惘	忄冂䒑󰄃
挢	扌丿大󰀯
锷	钅口口ㄅ
裔	亠󰀔冂口
栳	木土丿匕
攷	一ㄅ攵󰁶
庰	广䒑廾󰀵
蔷	艹十䒑口
纰	纟󰁴匕󰁀
江	氵工󰀝
剥	󰁭氺刂󰀢
鼔	士口䒑又
㔷	匚一冂人
瘛	疒三丨心
輔	車甫󰁶
嘛	口广木木
演	氵宀一八
莉	艹禾刂󰀬
脭	月口王󰀝
佔	亻󰀥口󰀝
㗛	口⺮丿大
换	扌⺈ㄇ大
肺	月一冂丨
栝	木丿古󰀝
戽	丶尸󰁦十
蝠	虫一口田
靠	丿土口三
栋	木󰀂小󰁶
睥	目白丿十
饮	⺈󰁐⺈人
旱	日干󰀬
塾	󰁸孑九土
襦	衤󰁧󰀙〢
驂	󰀋灬厶彡
扽	扌一凵乚
鹰	广亻亻一
郐	人二厶阝
畷	田又又又
蹰	口止厂寸
啷	口丶彐阝
敷	一󰀐丨夂
㹰	犭󰁥⺌儿
买	乛󰁦大󰁧
柝	木斤丶󰁶
受	爫冖又󰁧
潔	氵三丨小
彔	彑氺󰁧
轔	車米夕㐄
罔	冂䒑亠󰄃
䪔	󰁆口㐄甫
力	力𠃌丿
抛	扌九力ノ
窔	宀八六乂
芛	艹󰁬丿󰁣
銛	釒丿古󰀝
関	門䒑大󰀦
先	丿土儿󰀅
眰	目一厶土
潱	氵士冖䒑
傷	亻𠂉日󰁤
䂷	石丿十匕
司	𠃌一口󰀌
猢	犭ノ古月
邷	一󰁐⺄阝
蜰	月巴虫󰁧
稂	禾丶彐󰀖
柠	木宀丁󰀢
䦮	門三人日
熊	厶月匕灬
銽	釒󰁚󰀁口
蝑	虫乛󰁾月
弽	弓廿󰄃木
臭	丿目犬󰁧
胥	乛󰁾月󰀘
堞	土廿󰄃木
鄢	一止一阝
妮	女尸匕󰁀
祀	礻󰁶巳󰁀
劁	亻󰁷灬刂
韶	立日刀口
㪔	木木󰀥又
仔	亻子󰀝
㻔	王丿士󰁺
暝	日冖曰六
愈	人一月心
晤	日五口󰀝
栶	木囗大󰁶
呱	口⺁厶󰂃
李	木子󰀘
磰	石羊䒑口
裰	衤󰁧又又
飰	人良亠卜
鍅	釒氵土厶
㣰	彳丿米心
䣰	西一匚󰁃
声	士󰁅󰁣
棰	木丿十一
夀	二乛口寸
思	田心󰁧
毆	匚口口又
朦	月艹冖󰀓
矑	目虍田皿
漒	氵弓口虫
屐	尸彳十又
嗱	口人一手
朐	月勹口󰀝
俣	亻口一大
䥾	钅冖一一
黔	󰀹土灬乛
虛	虍〢󰄃一
癛	疒亠囗禾
晛	日目儿󰁀
噛	口止米凵
挛	亠󰁗手󰀬
稔	禾人丶心
䨔	󰀙⺌一儿
匛	匚ク󰂃󰀦
碉	石󰀼土口
瞑	目冖曰六
㞰	山𠂉十󰀢
錛	釒大十廾
垰	土上一卜
俱	亻󰀣八󰁶
瞰	目乛耳夂
枰	木一丷十
逷	日勹󰁤辶
耷	大耳󰀘
扢	扌𠂉乙󰁀
佟	亻夂󰁦󰁶
顶	丁丆贝󰁶
噢	口丿ㄇ大
㟑	山十冖子
是	日一󰁾󰁧
妁	女勹丶󰁶
卮	⺁一⺋󰁫
桶	木󰁻月丨
春	三人日󰀘
囖	口⺮罒󰁷
枟	木二厶󰁶
㭽	木广󰁚丶
埕	土口王󰀝
唢	口⺌贝󰁶
㨔	扌戊一口
董	艹丿一土
斫	石斤󰀢
婔	女丨三三
䋛	糹米󰁶
穔	禾󰁺由八
橔	木󰁸孑攵
驔	󰀋灬覀早
㼱	丬匕冖丶
冀	丬匕田八
䞑	土󰁖工󰀝
漱	氵一口人
睰	目艹口
伱	亻人小󰁶
坰	土冂口󰀝
玮	王二𠃌丨
玼	王止匕󰁀
蝰	虫大土土
遷	覀大巳辶
硁	石ス工󰀝
炔	火ユ人󰁶
骮	󰀾月󰀁丶
噙	口人亠厶
塬	土厂白小
锕	钅阝丁口
只	口八󰁧
铕	钅月󰀝
梦	木木夕󰁧
蛄	虫古󰀝
陉	阝ス工󰀝
剿	巛日木刂
扙	扌󰂃󰁶
晑	曰丿冂口
㩔	扌尸󰁺又
鋼	釒冂䒑山
遰	廿儿冖辶
㴯	氵月匕日
灰	火󰁧
蠱	虫虫虫皿
偰	亻三丨大
恰	忄人一口
㠱	己󰀎八󰁧
䁰	目工丆貝
㶔	氵罒罒大
䶔	止󰀆也󰁀
嶔	山釒⺈人
枛	木⺁丨󰂃
撞	扌立日土
弟	丷弓丨丿
摧	扌山亻󰁷
哑	口一󰅊一
摞	扌田ㄠ小
蚕	一大虫󰁧
芥	艹人󰀯󰀬
韦	二𠃌丨󰀵
綔	大二ㄅ小
螛	虫宀三口
鞛	廿󰀜立口
桑	又又又木
癞	疒一口贝
东	󰀂小󰀦
金	金金金金
髽	󰂞彡人土
棁	木丷口儿
肀	󰁬丨󰀵
晕	日冖车󰀬
鹒	广󰁬人一
裱	衤󰁧主󰀔
炰	勹巳灬󰁧
搔	扌又丶虫
邰	厶口阝󰀢
䂰	石禾刂󰀢
㣱	彳貝󰁶
棱	木土八夂
壱	士冖匕󰀅
㝛	宀亻一人
鹊	󰁺日勹一
迷	米辶󰀦
恵	一由心󰁧
睛	目主月󰀝
淔	氵十󰀣󰀝
坛	土二厶󰁶
䝛	豸皮󰁶
撰	扌巳巳八
刑	一廾刂󰀢
靛	主月宀󰁾
跔	口止勹口
渒	氵白丿十
徼	彳白方夂
也	也𠃌丨乚
啫	口土丿日
惝	忄⺌冂口
增	土丷󰀺日
璼	王匚丨皿
豽	豸冂人󰁶
曰	日丨󰁈一
咔	口上卜󰁶
凑	冫三人大
保	亻口木󰁶
倭	亻禾女󰀝
褐	衤󰁧日󰄃
䳯	丿一日灬
湫	氵禾火󰁶
倚	亻大丁口
齿	止人凵󰀬
胰	月一弓人
姒	女󰁐丶人
崔	山亻󰁷󰀘
洔	氵土寸󰁶
䦱	門爫丿灬
妱	女刀口󰀝
懰	忄󰁚丶刂
燰	火爫冖夂
覱	車斤目儿
釰	釒刀丶󰁶
朁	󰀄󰁜󰀄日
㜁	女木日一
鏮	釒广󰁬氺
㕑	厂士口寸
鴔	丿之󰁟灬
蛔	虫囗口󰀝
純	糹一凵乚
蠛	虫艹罒丶
陱	阝勹米󰁶
䅥	禾日勹󰄃
尚	⺌冂口󰀘
软	车⺈人󰁶
哗	口亻ヒ十
嗔	口十󰀣八
搮	扌覀木󰁶
薑	艹一田一
亿	亻乙󰁀
逰	扌𠂉子辶
衱	衤󰁧乃󰂃
硱	石囗木󰁶
怰	忄亠幺󰁶
塱	丶󰁮月土
䡱	車匚口口
㡱	广ク󰂃󰀦
䵔	禾人氺日
㵔	氵大土日
浔	氵彐寸󰁶
埛	土冂八口
共	󰁺八󰁧
瞁	目目犬󰁶
螁	虫艮辶󰁶
鶯	火火冖灬
㞁	乚日匕
㶯	火󰁚丿卩
彂	业弓𠂉大
匐	勹一口田
蟛	虫士口彡
矛	󰁻乛亅丿
㗑	口三十
鵔	󰁟灬厶夂
剂	文󰀯刂󰀢
花	艹亻ヒ󰀅
梐	木󰁴匕土
椂	木󰁭氺󰁶
炝	火人⺋󰁀
飞	⺄󰁦󰀦
品	口口口󰀘
呤	口人丶󰁻
忑	一卜心󰁧
䵽	士口䒑厶
薮	艹米女夂
閮	門丿士廴
虁	艹䒑丿夂
㒛	亻羽亻󰁷
䒛	艹幺𠃌󰀅
咛	口宀丁󰀢
䤱	釒山斤󰀢
失	󰅎人󰀦
忠	口丨心󰁧
㤱	忄一口䒑
褱	亠罒氺󰀔
酰	西一丿儿
椱	木𠂉曰夂
礱	立月一石
忙	忄亠󰄃󰁀
凝	冫匕𠂉󰁾
㠽	冂丨夂󰁦
吁	口一󰀛󰀢
渥	氵尸一土
廂	广木目󰀌
并	䒑廾󰀬
微	彳山一夂
撛	扌米夕㐄
璛	王󰁬十󰀲
蒛	艹𠂉十人
钛	钅大丶󰁶
径	彳ス工󰀝
彳	彳丿丿丨
㘁	口皿土十
旦	日一󰀘
彬	木木彡ノ
滯	氵廿儿丨
眮	目冂一口
渂	氵曰文󰁶
隣	阝米夕㐄
瓐	王虍田皿
啦	口扌立󰀝
弱	弓冫弓冫
怚	忄󰀐一󰀝
塛	土覀木󰁶
姱	女大二ㄅ
㳔	氵又寸󰁶
熰	火匚口口
槱	木西一灬
駱	󰀋灬夂口
膰	月丿米田
纶	纟人匕󰁀
撦	扌大土日
稞	禾日木󰁶
慝	匚艹心
引	弓丨󰀢
通	󰁻用辶󰀵
賔	宀󰁅貝󰁧
糔	米又丶虫
捷	扌一󰁬󰁾
悛	忄厶八夂
嚷	口亠口󰀔
粯	米目儿󰁀
徊	彳囗口󰀝
呛	口人⺋󰁀
幢	冂丨立土
幅	冂丨一田
痛	疒󰁻用󰀵
侧	亻贝刂󰀢
坦	土日一󰀝
帐	冂丨丿󰂃
骱	󰀾月人󰀯
唛	口主夂󰁶
帅	リ冂丨󰀢
㔛	士口力󰁣
勰	力力力心
拰	扌亻丿士
狰	犭ノ⺈亅
苰	艹弓厶󰁧
侀	亻一廾刂
鸯	ㄇ大勹一
㪱	文⺈ㄇ大
䋰	目大幺小
灔	氵ㄇ󰁺巴
做	亻古夂󰁶
搦	扌弓冫冫
𤇾	火火冖󰀅
崧	山木八厶
祛	礻󰁶土厶
挐	女口手󰀬
鷯	大丷曰灬
蔛	艹⺈用十
锛	钅大十廾
攛	扌宀八󰁒
甛	甘丿古󰀝
缛	纟厂二寸
请	讠主月󰀝
啀	口厂土土
愚	日冂丨心
岔	八刀山󰀬
攝	扌耳耳耳
䮑	󰀋灬爫寸
珐	王土厶󰁶
㓛	工刀󰁥
筵	⺮丿止廴
哛	口匕八刀
䓛	艹尸凵山
儰	亻艹爫灬
䥱	釒宀臼灬
㥱	忄匚丨三
丐	一󰀥ㄅ󰁫
饱	⺈󰁐勹巳
脰	月一口䒑
焰	火⺈臼󰀝
楱	木三人大
绛	纟夂󰀂丨
知	𠂉大口󰀝
居	尸古󰀌
枿	木十廾󰀢
忮	忄十又󰁶
䯑	󰀾月⺌儿
到	一厶土刂
脉	月丶𠃌󰀩
瓛	王虍一犬
擛	扌艹廿木
铛	钅⺌彐󰀝
蓛	艹木冂攵
愁	禾火心󰁧
钦	钅⺈人󰁶
桧	木人二厶
尉	尸二小寸
拷	扌土丿ㄅ
寰	宀罒一󰀔
斀	罒勹虫又
寝	宀丬彐又
蝿	虫曰曰乚
寅	宀一由八
騱	󰀋灬爫大
害	宀三丨口
稱	禾爫冂土
艰	又彐󰀖󰁶
娱	女口一大
樱	木贝贝女
㨱	扌󰁝言󰀝
䉰	⺮󰀾月乂
沧	氵人⺋󰁀
鲧	󰁢󰀞丿小
儚	亻艹罒夕
䥛	釒三丨小
㥛	忄了口一
䰁	󰂞彡󰁭氺
饛	人良艹󰀓
脚	月土厶卩
焚	木木火󰁧
楛	木艹古󰀝
軭	車匚王󰀝
完	宀二儿󰀅
爐	火虍田皿
婑	女禾女󰀝
䩑	廿󰀜弓󰁀
搀	扌⺈口󰁦
儾	亻一口󰀔
孟	子皿󰀘
孝	土丿子󰀘
存	丨子󰀌
弓	弓󰁈一ㄅ
嬛	女罒一󰀔
㱅	士冖一人
髱	󰂞彡勹巳
㘉	口⺮󰁮卩
媳	女丿目心
抰	扌ㄇ大󰁶
嫱	女十䒑口
芰	艹十又󰁧
竱	立一曰寸
馛	禾日丶
㖇	口丆冂〢
䊰	米言土日
㫱	日土󰁖󰁧
妛	凵丨一女
榛	木三人禾
禛	礻󰁶十八
臚	月虍田皿
䯰	󰂞彡人󰀯
号	口一ㄅ󰀅
毰	毛立口󰀌
篰	⺮立口阝
菷	艹彐冖丨
鯰	󰁢灬人心
炖	火一凵乚
缺	󰅎山ユ人
抐	扌冂人󰁶
涠	氵囗二丨
摥	扌𠂉曰󰁤
娆	女弋丿儿
娅	女一󰅊一
偶	亻日冂丶
姥	女土丿匕
寀	宀爫木󰁧
篷	⺮夂三辶
酷	西一丿口
耶	耳阝󰀢
偕	亻󰁴匕白
鍀	釒曰一寸
砿	石广厶󰁶
栿	木亻犬󰁶
爆	火日󰁺氺
恙	丷王心󰁧
醚	西一米辶
畦	田土土󰀝
大	大大大大
槛	木〢𠂉皿
姛	女冂一口
觛	⺈用日一
秛	禾皮󰁶
澀	氵刀丶止
孁	󰀙口口女
䧛	阝亠丷方
㧛	〢𠂉丶手
踊	口止󰁻用
㟿	山艹犬廾
辮	辛幺小辛
塥	土一口丨
塑	䒑凵丿土
上	上丨一一
承	了三󰀩󰀦
堤	土日一󰁾
䦑	門ユ人󰀦
堡	亻口木土
缋	纟口丨贝
䅾	禾󰀄󰁜日
崛	山尸凵山
堋	土月月󰀝
堂	⺌冖口土
驱	󰀊󰀞匚乂
舰	丿󰁪ㄇ󰁜
穱	禾爫罒寸
橱	木厂一寸
婱	弓亠幺女
䈰	⺮扌⺌月
㩱	扌爫罒寸
鉚	釒󰁚丿卩
憀	忄羽人彡
稛	禾囗禾󰁶
艚	丿󰁪一日
剚	一口󰁬刂
樛	木羽人彡
㨛	扌門人󰁶
䨛	󰀙木斤󰀬
洛	氵夂口󰀝
心	心丶󰁒丶
肘	月寸󰁶
冬	夂󰁦󰁧
䧑	阝宀一󰁾
櫦	木󰁙乛夂
属	尸丿口丶
肷	月⺈人󰁶
胘	月亠幺󰁶
疒	疒丶一󰀞
煦	日勹口灬
泛	氵丿之󰁶
囧	囗八ㄇ󰁫
因	囗大󰀦
回	囗口󰀌
珲	王冖车󰀢
䤭	釒乂丨
陵	阝土八夂
唷	口亠厶月
褭	亠󰀋灬󰀔
弥	弓⺈小󰁶
㚛	大匕日󰀘
五	五一丨一
应	广󰀧一󰀌
溔	氵丷王灬
鈚	釒󰁴匕󰁀
蚛	虫口丨󰀢
麔	󰁙󰁴匕口
橛	木厂䒑人
婛	女󰁸小󰁶
笰	⺮弓󰀯󰀬
撷	扌士口贝
咷	口儿󰀪󰁶
䒷	艹丿古󰀘
偈	亻日勹󰄃
娙	女一巛工
鬰	木乂乂彡
謰	言車辶󰁶
蹋	口止日羽
稸	禾亠幺田
喝	口日勹󰄃
錾	车斤金󰀘
挾	扌大人人
闵	门文󰀦
穁	禾艹耳󰀝
熅	火囗人皿
唤	口⺈ㄇ大
唔	口五口󰀝
䕰	艹火丿田
啰	口罒夕󰁶
哧	口土󰁖󰁶
捉	扌口󰁾󰁶
控	扌宀八工
碇	石宀一󰁾
恆	忄一丨一
墇	土立早󰀢
媭	彡丆贝女
灾	宀火󰁧
㳰	氵亠厶廾
䋷	󰁻乛亅小
峰	山夂三丨
泰	三人氺󰁧
墿	土罒土十
咧	口一夕刂
円	冂丨一󰀌
憧	忄立日土
咝	口󰁲󰁲一
俦	亻三丿寸
渝	氵人一刂
吧	口巴󰁀
糰	米囗一寸
苷	艹艹二󰀘
鳰	丿丶󰁟灬
念	人丶乛心
遵	丷西一辶
昝	夂卜日󰀘
塇	土宀一一
橭	木古辛󰀢
䡇	車二儿󰁀
䡿	車󰀙口人
㸚	乂乂乂乂
咕	口古󰀝
进	二󰀯辶󰀵
㜛	女車⺈人
铵	钅宀女󰀝
刼	土厶刀丶
渔	氵󰁢一󰀝
縔	糹又又木
且	󰀐一󰀌
圛	囗罒土十
趋	土󰁾⺈彐
痊	疒人王󰀌
蜛	虫尸古󰀝
鸔	󰁟灬曰氺
吷	口ユ人󰁶
䮰	󰀋灬亠古
箰	⺮勹曰子
殰	一夕士貝
鐷	釒艹廿木
萷	艹⺌月刂
绅	纟日丨󰀢
镖	钅覀二小
輑	車󰁬丿口
懾	忄耳耳耳
凾	了口又凵
缑	纟亻ユ大
釾	釒󰀄亅丿
歧	止十又󰁶
踞	口止尸古
䁗	目山一䒑
榆	木人一刂
供	亻󰁺八󰁶
皈	白⺁又󰁶
檀	木亠囗一
戬	一业日戈
䯘	󰀾月宀儿
㛛	女丿󰀽丿
眐	目一止󰀝
幔	冂丨日又
乔	丿大󰀯󰀬
盛	厂𠃌󰅅皿
曛	日丿一灬
鹔	󰁬丨󰀯一
㑷	亻厶月匕
冥	冖曰六󰁧
鈣	釒一󰀥ㄅ
歰	刀丶刀止
瑷	王爫冖又
䑷	丿󰁪丶月
呷	口甲󰀢
瑶	王爫󰅎山
谮	讠󰀂󰁜日
葷	艹冖車󰀬
鑷	釒耳耳耳
侢	亻一冂土
浐	氵立丿󰁥
㴀	氵艹丿之
鋏	釒大人人
翰	十早人羽
掽	扌䒑业󰀝
鳭	刀󰁟灬󰁶
篙	⺮󰁸冂口
涥	氵󰁸了󰀢
鮷	󰁢灬丷丿
讷	讠冂人󰁶
箷	⺮方𠂉也
䯾	󰂞彡󰀼口
逦	一冂丶辶
诮	讠⺌月󰀝
怗	忄󰀥口󰀝
鞐	廿󰀜上卜
厭	厂日月犬
䀛	目勹󰁤󰁥
璙	王大丷小
俪	亻一冂丶
䞐	贝三人日
鋽	釒󰀥早󰀢
俑	亻󰁻月丨
㭛	木⺁󰀕󰁶
㷷	火巳巳八
䘶	衤󰁧了凵
嘶	口艹三斤
筛	⺮リ一丨
挚	扌九丶手
孛	十冖子󰀘
䭛	人良乛攵
喂	口田一󰀖
砧	石󰀥口󰀝
錚	釒⺈󰁬亅
茚	艹󰁚一卩
佳	亻土土󰀝
嫥	女一曰寸
你	亻⺈小󰁶
衷	亠口丨󰀔
鎶	釒丁口口
䩾	廿󰀜广灬
筷	⺮忄ユ人
莶	艹人一一
蓊	艹八厶羽
挬	扌十冖子
蟠	虫丿米田
邦	三丿阝󰀢
䜥	讠日一廴
猝	犭ノ亠十
䣀	⺈厂⺋阝
磀	石䒑凵辶
嗝	口一口丨
恶	一󰅊一心
盄	弓丨皿󰀘
作	亻𠂉丨二
囐	口虍一犬
㴮	氵尸⺌月
紮	木乚幺小
喘	口山丆〢
箛	⺮孑⺁󰂃
菚	艹戈戈󰁧
䮷	󰀋灬罒虫
㮷	木乚日
㮛	木日一󰁾
䏚	月小丿󰁥
叚	󰁃丨二又
揚	扌曰一󰁤
吊	口冂丨󰀬
颧	艹口口贝
潞	氵口止口
樜	木广廿灬
苶	艹人小󰁧
笷	⺮󰁚丿卩
数	米女夂󰁶
鬷	一口冂夂
䚐	𠂉大口儿
㒭	口儿口儿
鳮	又󰁟灬󰁶
糮	米匚丨皿
糤	米󰁺月攵
丛	人人一󰀘
锶	钅田心󰁶
珽	王丿士廴
宷	宀丿米󰁧
飧	夕人丶󰀖
辞	丿古辛󰀢
㴘	氵󰀰目󰀝
踬	口止⺁贝
弁	厶廾󰀬
䏽	月立口󰀝
䝀	一口䒑田
莚	艹丿󰀥廴
篛	⺮弓冫冫
㭷	木田力󰁥
䭷	󰀋灬毛󰁀
䯛	󰀾月宀⺋
㯛	木士冖一
掚	扌一冂丶
厚	厂日子󰀌
懵	忄艹罒目
合	人一口󰀘
爵	爫罒彐寸
㬞	日山日󰄃
竷	立早夂夂
茶	艹人木󰁧
髷	󰂞彡ㄇ󰁺
喯	口大十廾
孰	󰁸孑九丶
昏	󰁚弋日󰀘
鐭	釒丿ㄇ大
俞	人一月刂
䐭	月廿儿丨
䔐	艹氵戈戈
狒	犭ノ弓󰀯
鷧	士冖一灬
踟	口止𠂉口
膈	月一口丨
鸅	罒土䒑灬
吴	口一大󰁧
髟	󰂞彡󰁥
鎗	釒人丶口
辁	车人王󰀝
蕽	艹ㄇ󰁺󰀖
鰛	󰁢灬日皿
㬷	月囗木󰁶
欷	乂冂人
葚	艹艹三󰄃
尛	小小小󰁧
氛	󰅎⺄八刀
㰛	木艹白木
䑚	丿古月󰀝
敭	日一勹攵
苟	艹勹口󰀘
曝	日日󰁺氺
荫	艹阝月󰀘
薽	艹覀土丶
瞬	目爫冖丨
餐	󰀥夕又󰀖
嶷	山匕𠂉󰁾
麷	木人人䒑
躷	丿󰀽三女
癶	癶乛丶󰂃
晶	日日日󰀘
嵛	山人一刂
味	口二󰅇󰁶
罐	󰅎山艹󰁷
连	车辶󰀵
锚	钅艹田󰀝
郜	丿土口阝
㳷	氵勹󰁤日
䔶	艹扌日󰁾
䚁	丿冂口儿
倮	亻日木󰁶
䅆	禾冫⺈人
训	讠川󰀢
蘖	艹亻󰁃木
鱛	󰁢灬丷日
豛	一󰀓几又
籛	⺮釒戈戈
汛	氵⺄十󰀢
吚	口󰁬丿󰁥
䐚	月󰁮卩󰀢
㐚	五口乙󰀅
缎	纟亻三又
悚	忄一口󰅇
刺	一冂󰅇刂
氢	󰅎⺄ス工
波	氵󰅌又󰁶
鸪	古勹丶一
㶾	覀一火󰁧
时	日寸󰁶
蚶	虫艹二󰀝
隶	󰁬氺󰀦
湷	氵三人日
繷	糹ㄇ󰁺󰀖
御	彳󰅎止卩
立	立立立立
芊	艹丿十󰀬
䁝	火火冖目
聛	耳白丿十
㢛	广人一人
䢛	冂八口辶
僚	亻大丷小
噶	口艹日󰄃
䙶	西冖󰀔󰁶
㺷	王木丶󰁶
郚	五口阝󰀢
胜	月丿主󰀝
嘧	口宀心山
毳	丿二乚乚
薄	艹氵一寸
颛	山丆冂贝
洫	氵丿皿󰀝
碛	石主贝󰁶
閦	門人人人
珂	王丁口󰀝
檄	木白方夂
巜	巜󰁑󰁑
氦	󰅎⺄亠人
䎶	耳日丨󰀢
怜	忄人丶󰁻
軮	車ㄇ大󰁶
潜	氵二人日
縷	糹󰀻女󰀝
渷	氵六口儿
鸷	扌九丶一
藶	艹厂禾止
朱	󰅎󰅇󰀦
錗	釒禾女󰀝
旽	日一凵乚
恨	忄彐󰀖󰁶
㣛	彳人一口
闽	门虫󰀦
傚	亻六乂攵
䣛	木人氺阝
磛	車斤石󰀘
棛	木亠厶月
飛	⺄〈丿丨
㹷	乂冂犬
浦	氵一月丶
陶	阝勹󰅎山
舳	丿󰁪由󰀝
张	弓丿七󰂃
蜞	虫艹三八
氤	󰅎⺄囗大
㘽	十戈土󰀌
嵾	山厶厶彡
昽	日ヒ丶
鵾	日󰁴󰁴灬
䧯	阝⺈口丶
姝	女󰅎󰅇󰁶
㖰	口匕冂口
赮	土󰁖󰁃又
䮕	󰀋灬又又
熗	火人丶口
昶	丶𠃌󰀩日
緷	糹冖車󰀢
跷	口止弋儿
阶	阝人󰀯󰀢
农	冖󰀔󰀦
毛	丿二乚󰁫
嫠	二󰅇夂女
㼘	山一󰁐丶
䤛	釒󰁐丨󰀢
党	⺌冖口儿
舻	丿󰁪󰀥尸
㤛	忄亻丿土
㗶	口癶弓又
酚	西一八刀
慚	忄車斤󰀢
煚	日匚󰁃火
黼	󰅊一丷丶
旄	方𠂉丿乚
驐	󰀋灬󰁸攵
輽	車厶大田
䅗	禾禾女󰀝
赙	贝一月寸
艨	丿󰁪艹󰀓
惮	忄丷曰十
鵛	一巛工灬
蔚	艹尸二寸
絛	亻丨夂小
攚	扌火火口
彝	󰅂一米廾
艋	丿󰁪子皿
秋	禾火󰁶
殛	一夕了一
宛	宀夕⺋󰀅
氆	丿二乚日
枼	廿󰄃木󰁧
鶷	宀三丨灬
唚	口彐冖又
䵛	禾人氺土
涷	氵木曰󰀝
啶	口宀一󰁾
睐	目一米󰁶
簿	⺮氵一寸
鞬	廿󰀜󰁬廴
铼	钅一米󰁶
枬	木󰀼亠󰀝
湛	氵艹三󰄃
嶀	山󰀙二ㄅ
洚	氵夂󰀂丨
氰	󰅎⺄主月
氅	⺌冂口乚
睼	目日一󰁾
帙	冂丨󰅎人
萧	艹󰁬󰅏󰀯
盳	目亠󰄃󰁀
杬	木二儿󰁀
侭	亻尸󰂃󰁦
鶛	󰁴匕白灬
揇	扌十冂十
椐	木尸古󰀝
俽	亻斤⺈人
嶛	山大丷小
涛	氵三丿寸
綛	糹刀丶心
趛	土󰁾金󰀌
蠼	虫目目又
馋	⺈󰁐⺈󰁦
閶	門日曰󰀌
䶛	一夕刂󰀆
絷	扌九丶小
起	土󰁾己󰁫
嵷	山彳人󰁾
斶	斤罒勹虫
䕶	艹言亻又
㶷	火勹日󰀝
巷	󰁺八巳󰀅
棋	木艹三八
栬	木⺈巴󰁀
翭	羽亻ユ大
蘳	艹󰁺由土
啵	口氵󰅌又
绻	纟䒑大⺋
膊	月一󰀐寸
㟼	山󰁡攵
绺	纟夂卜口
埼	土大丁口
诛	讠󰅎󰅇󰁶
测	氵贝刂󰀢
㨬	扌土口󰀔
晳	木斤日󰀘
鷛	广󰁬月灬
癳	疒田田小
濑	氵一口贝
斚	厶厶冖十
喚	口⺈ㄇ大
跛	口止󰅌又
疚	疒ク󰂃󰀦
䝦	豸丿皿乑
银	钅彐󰀖󰁶
䖚	虍几󰁞灬
㖚	亻寸口匕
洷	氵一厶土
崷	山丷西一
贷	亻󰀁丶贝
瓶	䒑廾一丶
㵷	辛氵辛󰀢
䵷	土土黽󰀝
斓	文门一󰅇
䔇	艹山一䒑
既	彐厶󰀂󰁜
鹄	丿土口一
薳	艹土口辶
炊	火⺈人󰁶
梬	木由一ㄅ
碬	石󰁃丨又
娌	女日土󰀝
甚	艹三八󰄃
粀	米󰂃󰁶
记	讠己󰁀
蔇	艹󰁮󰀄󰁜
䖳	虫宀丿七
倦	亻䒑大⺋
㖳	氵女口匕
鸛	艹口口灬
踔	口止󰀥早
縛	糹甫寸󰁶
虚	󰅋七󰅊一
噚	口彐工寸
晚	日⺈口󰁜
鳷	十又󰁟灬
䙚	󰁟灬亠󰀔
牖	丿丨一丶
旳	日勹丶󰁶
唶	口󰁺日󰀝
收	󰁐丨夂󰁶
糷	米艹門󰀹
賷	十口口貝
酤	西一古󰀝
泀	氵𠃌一口
䴷	木人人儿
㴷	氵耳冖󰁜
糀	米艹亻ヒ
䗳	虫癶一䒑
瘳	疒羽人彡
㴰	氵厶月匕
鸣	口勹丶一
廠	广⺌冂攵
狷	犭ノ口月
莆	艹一月丶
䇧	⺮一囗人
形	一廾彡ノ
攳	十又彐寸
礬	木乂乂石
鎇	釒󰁅目󰀝
锳	钅艹ㄇ大
鉨	釒⺈小󰁶
鹛	󰁅目勹一
蹛	口止廿丨
瘚	疒䒑凵人
昚	大丷日󰀘
幛	冂丨立早
䘚	亠󰀔十󰀬
㘚	口門乛攵
腼	月丆冂三
鳞	󰁢󰀞米丨
地	土也󰁀
䔳	艹󰁝犬灬
夬	ユ人󰀦
黠	󰀹土灬口
碷	石⺁十目
梷	󰀥口又木
弰	弓⺌月󰀝
䢷	󰀼亠阝󰀢
逊	孑小辶󰀦
㩀	扌虍勹󰂃
遶	土土土辶
輰	車曰一󰁤
墅	日土󰁻土
糢	米艹曰大
橀	木亠厶皿
孖	孑子󰀝
坫	土󰀥口󰀝
牙	󰀂亅丿󰀏
鲞	䒑大󰁢一
鳖	丷冂󰅏一
屋	尸一厶土
鈗	釒厶儿󰁀
剜	宀夕⺋刂
䈇	⺮󰀥早󰀬
藲	艹木匚口
惊	忄󰁸小󰁶
榬	木土口󰀔
掣	󰅎冂丨手
亰	亠曰小󰁧
繇	爫󰅎山小
馬	󰀋灬󰀦
黉	󰀧冖󰁺八
㼰	白丿十丶
蒳	艹糹冂人
懗	忄土󰁖󰁖
燗	火門月󰀝
桷	木⺈月丨
炶	火󰀥口󰀝
䡷	車艹土皿
塷	土󰀥囗󰁘
㥼	忄一止灬
敝	丷冂󰅏夂
肶	月󰁴匕󰁀
邶	丬󰁴阝󰀢
䋚	糹羽󰀝
媛	女爫一又
拚	扌厶廾󰀢
窛	宀八二女
誛	言彐冖又
鋚	亻丨攵金
楬	木曰勹󰄃
敕	一口󰅇夂
節	⺮󰁮卩󰀬
佚	亻󰅎人󰁶
屠	尸土丿日
筝	⺮⺈󰁬亅
池	氵也󰁀
蟋	虫丿米心
伐	亻戈󰁶
摔	扌亠ㄠ十
箫	⺮󰁬󰅏󰀯
追	亻󰁃󰁃辶
搳	扌宀三口
袅	勹丶ㄅ󰀔
滕	月䒑大氺
㡷	广木一󰀌
棘	一冂󰅇󰅇
遖	十冂䒑辶
堷	土立日󰀝
侰	亻󰁬丿口
砷	石日丨󰀢
样	木䒑󰀟󰀢
龰	󰁾丨一󰂃
辰	厂二󰀖󰀦
㫛	日口儿󰁀
聖	耳口王󰀘
嫛	匚𠂉大女
䫛	亻ユ𠂉貝
竛	立人丶󰁻
櫛	木⺮󰁮卩
髛	󰁸冂口九
芚	艹一凵乚
凋	冫󰀼土口
冚	冖山󰀬
旖	方𠂉大口
谝	讠丶尸艹
䂖	丆丶口󰀘
彐	彐󰁈一一
氘	󰅎⺄󰀯󰀬
坞	土勹ㄅ一
尝	⺌冖二厶
聊	耳󰁚丿卩
厮	厂艹三斤
瀅	氵火火丶
怅	忄丿七󰂃
塆	土亠󰁗弓
帲	冂丨丿干
耄	土丿匕乚
㾰	疒古月󰀌
诰	讠丿土口
䀶	目丶艮󰁶
忰	忄九十󰀢
柷	木口儿󰁀
瀶	氵匚丨口
述	木丶辶󰀦
逶	禾女辶󰀌
锓	钅彐冖又
䦟	門人人土
欛	木󰀙廿月
笛	⺮由󰀘
䍚	罒丶艮󰁧
博	十一月寸
茜	艹西󰀘
跟	口止彐󰀖
荚	艹一丷大
鬛	󰂞彡囗󰁒
㜚	女宀亻日
甜	丿古艹二
鸟	勹丶ㄅ一
睳	目大土土
罛	罒⺁厶󰂃
潛	氵󰀄󰁜日
彛	󰁭米八廾
佛	亻弓󰀯󰀢
嶧	山罒土十
頰	大人人貝
蠰	虫亠口󰀔
轛	車业丷寸
栰	木亻戈󰁶
堰	土匚日女
䠰	口止艹󰁷
㠰	力口己󰀅
傰	亻山月月
辄	车耳乚󰁀
廀	广宀火又
㩬	扌虍业戈
嫌	女䒑󰁬󰁗
揳	扌三丨大
旗	方𠂉艹八
嵤	火火冖山
䇰	⺮了󰀩一
璜	王󰁺由八
嵙	山禾󰁦十
隆	阝夂一主
氟	󰅎⺄弓󰀯
柛	木曰丨󰀢
㦇	忄󰁙󰁴匕
卬	󰁚卩󰀢
㾛	疒彐冖又
䀙	目七刀󰁥
候	亻丨ユ大
柚	木由󰀝
懷	忄亠罒󰀔
称	禾⺈小󰁶
觰	⺈用土日
駰	󰀋灬囗大
覇	覀廿󰀜月
症	疒一止󰀌
来	一米󰀦
暧	日爫冖又
矚	目尸氺虫
耙	三󰅇巴󰁀
龛	人一口丶
蒲	艹氵一丶
舞	󰅎󰀷一丨
菠	艹氵󰅌又
墟	土󰅋七一
歉	䒑󰁬󰁗人
瓜	⺁厶󰂃󰀦
铜	钅冂一口
拆	扌斤丶󰁶
峘	山一曰一
玬	王󰀼亠󰀝
莬	艹⺈口󰁜
㥇	忄戈戈󰁶
赚	贝䒑󰁬󰁗
峴	山目儿󰁀
匘	匕巛丿乂
束	一口󰅇󰀦
晗	日人丶口
俛	亻⺈口󰁜
㿛	疒一冂匕
枚	木夂󰁶
垚	土土土󰀘
诧	讠宀丿七
瀠	氵火火小
埠	土亻󰁃十
琪	王艹三八
袰	母亠󰀔󰁧
碰	石䒑󰅊一
泔	氵艹二󰀝
颰	几丿虫丶
聙	耳月󰀝
翛	亻丨夂羽
械	木戈廾󰀢
鞚	廿󰀜宀工
降	阝夂󰀂丨
澜	氵门一󰅇
駴	󰀋灬戈廾
殊	一夕󰅎󰅇
呜	口勹ㄅ一
瑜	王人一刂
痗	疒𠂉母󰀦
慰	尸二小心
尧	弋丿一儿
缰	纟一田一
玧	王厶儿󰁀
俐	亻禾刂󰀢
倖	亻土䒑十
埇	土󰁻用󰀢
兵	󰅍一八󰁧
卧	匚丨󰁃卜
塚	土冖一丶
桚	木巛夕󰁶
㡚	冂丨󰀀土
䡚	車白儿󰁀
赔	贝立口󰀝
荧	艹冖火󰁧
丝	󰁲󰁲一󰀘
濐	氵曰土日
顰	止󰀤丆十
嗜	口土丿日
硰	氵小丿石
衰	亠口一󰀔
塰	氵𠂉母土
桰	木󰁚󰀁口
硚	石丿大󰀯
衚	彳古月丁
嚇	口土󰁖󰁖
鑬	釒匚丨儿
嚗	口曰󰁺氺
恚	土土心󰁧
䴭	木人人丿
椡	木一厶刂
娠	女厂二󰀖
雉	𠂉大亻󰁷
輊	車一厶土
缊	纟曰皿󰀝
曉	日土土儿
弊	丷冂󰅏廾
伊	亻󰁬丿ノ
㼊	一凵󰁐󰂃
畜	亠ㄠ田󰀘
镜	钅立日儿
栚	木䒑大󰁶
堚	土冖車󰀢
䠚	口止宀󰂃
㠚	山业丷寸
銷	釒⺌月󰀝
芷	艹止󰀘
礰	石厂禾止
椰	木耳阝󰀢
獾	犭ノ艹󰁷
䱗	󰀥夕又灬
祠	礻󰁶𠃌口
汭	氵冂人󰁶
嬄	女士冖䒑
頚	又土丆貝
蠚	艹口虫
砚	石ㄇ󰁜󰁀
偿	亻⺌冖厶
哋	口土也󰁀
缱	纟口丨辶
苛	艹丁口󰀘
招	扌刀口󰀝
缝	纟夂三辶
齊	󰀴󰀳󰀘
曜	日羽亻󰁷
皉	白止匕󰁀
轊	車三丨彐
彊	弓一田一
暉	日冖車󰀢
㚉	乃夕夕󰁧
䚉	三丨刀儿
丷	丷丶丿
菬	艹氵刀口
僷	亻艹廿木
粛	󰁬米󰀯󰀵
蓚	艹亻丨彡
铚	钅一厶土
媟	女廿󰄃木
阜	亻󰁃󰁃十
㫰	日丶艮󰁶
䫰	丆貝米㐄
玣	王亠卜󰁶
秸	禾士口󰀝
䉆	⺮󰁟灬󰁧
娺	女又又又
窄	宀八𠂉二
㓚	工刂󰀢
䲛	󰁢灬艹目
岛	勹丶ㄅ山
僼	亻ㄇ󰁺䒑
阚	门乛耳夂
琬	王宀夕⺋
壇	土亠囗一
磇	石丿囗匕
靉	󰀙二厶夂
鄆	冖車阝󰀢
果	日木󰀦
溊	氵󰁃丨又
坉	土一凵乚
蝉	虫丷曰十
睉	目人人土
魄	白白󰁜厶
菣	艹匚丨又
亊	一丷󰁬亅
㺊	犭󰁥丷心
㦰	人人戈󰀦
撚	扌󰁝犬灬
刷	尸冂丨刂
䦰	門⺈日乚
爷	八乂ㄗ󰀬
户	丶尸󰀏
馰	󰀋灬勹丶
舷	丿󰁪亠ㄠ
黐	禾人氺厶
姡	女丿古󰀝
倀	亻󰀍󰀖󰁶
颠	十󰀣八贝
㒚	亻爫工心
渀	氵大十廾
咚	口夂󰁦󰁶
䒚	艹小丿󰁣
霜	󰀙木目󰀘
蜜	宀心丿虫
绝	纟⺈巴󰁀
返	⺁又辶󰀦
霉	󰀙𠂉母󰁧
昫	日勹口󰀝
玖	王ク󰂃󰁶
柰	木二小󰁧
圉	囗土䒑十
有	月󰀘
眉	󰁅目󰀌
車	車一丨丨
奧	丿ㄇ丿大
⻊	口止󰀘
㜉	女巛口巴
今	人丶乛󰀅
蕚	艹口口ㄅ
鴛	夕⺋󰁟灬
敚	丷口儿攵
畚	厶大田󰀘
艷	山三丨巴
饰	⺈󰁐𠂉丨
扷	扌丿大󰁶
祰	礻󰁶丿口
薬	艹白󰀪木
潋	氵人一夂
靇	󰀙立月三
王	王王王王
䕚	艹匚口貝
啚	口十囗口
压	厂土丶󰀦
㴛	氵一厶攵
晷	日夂卜口
罡	罒一止󰀘
鍣	釒艹刀口
䮗	󰀋灬山干
气	󰅎⺄󰀅
谔	讠口口ㄅ
䁙	目日宀女
耿	耳火󰁶
帊	冂丨巴󰁀
䗉	虫日日󰀝
㸊	火木口貝
㘇	口火火木
鸊	尸口辛灬
藉	艹三󰅇日
痉	疒ス工󰀌
渊	氵丿米丨
膷	月󰁲丿阝
稰	禾乛󰁾月
樰	木󰀙彐󰀝
冷	冫人丶󰁻
䨰	󰀙氵廿󰀜
㨰	扌六厶󰀔
嘇	口厶厶彡
违	二𠃌丨辶
烧	火弋丿儿
鶐	木丶辶灬
蘗	艹尸口木
僧	亻丷󰀺日
䦍	門𠂉乙󰁫
幧	冂丨口木
蝡	虫丆冂大
濡	氵󰀙丆〢
鞠	廿󰀜勹米
羹	丷王灬大
芋	艹一󰀛󰀬
鲔	󰁢󰀞月
坠	阝人土󰀘
㿀	疒王丶王
䗇	虫勹米󰁶
悒	忄口巴󰁀
闗	門幺幺灬
仕	亻士󰀝
澗	氵門日󰀝
㐶	亻巳󰁀
䯷	󰂞彡戈
寷	宀山三䒑
毷	󰀰目毛󰁀
琶	王王巴󰀅
祜	礻󰁶古󰀝
乡	󰁲丿󰀏
幡	冂丨丿田
鲰	󰁢󰀞耳又
猷	丷西一犬
洄	氵囗口󰀝
䳝	立口󰁟灬
䢧	羽人彡辶
陬	阝耳又󰁶
䰆	󰂞彡󰁻木
琛	王冖八木
鬜	󰂞彡門月
规	二人ㄇ󰁜
䒖	艹⺄十󰀬
绡	纟⺌月󰀝
撖	扌乛耳夂
㜙	女󰁙󰁴匕
醋	西一󰁺日
㙬	木人人土
湭	氵丷西一
趄	土󰁾󰀐一
憋	丷冂󰅏心
鸡	又勹丶一
噵	䒑丿目口
嘝	口⺈用十
幕	艹日大丨
厩	厂彐厶󰁜
久	ク󰂃󰀦
鹅	丿扌󰁒一
㑖	亻亻口丨
赡	贝⺈厂言
騰	月丷夫灬
檰	木糹白丨
媰	女勹凵丿
脷	月禾刂󰀢
焷	火白丿十
宪	宀丿土儿
雠	亻󰁷讠󰁷
䄷	禾石󰀝
㪰	文米󰁧
旬	勹日󰀌
沱	氵宀匕󰁀
亡	亠󰄃󰁫
恋	亠󰁗心󰁧
缅	纟丆冂三
髗	󰀾月虍田
元	二儿󰀅
傄	亻大丷目
种	禾口丨󰀢
冣	冖耳又󰁧
憣	忄丿米田
竗	立小丿󰁥
唟	土厶口匕
儋	亻⺈厂言
嫔	女宀󰅍八
巡	巛辶󰁫
淡	氵火火󰁶
卉	十廾󰀬
曇	曰󰀙二厶
籖	⺮十戈󰀞
髰	󰂞彡廿󰄃
印	󰁚一卩󰀢
咥	口一厶土
附	阝亻寸󰁶
穰	禾亠口󰀔
詰	言士口󰀝
具	󰀣八󰁧
橰	木丿目十
㩰	扌艹口木
䩰	廿󰀜口耳
鬗	󰂞彡廿丶
㱆	虍一口人
㑰	亻彑󰀓󰁶
杙	木󰀁丶󰁶
箱	⺮木目󰀘
台	厶口󰀘
垽	氵斤土󰀘
无	二󰁜󰁫
嵇	禾乚山
翾	罒一口羽
䡶	車尸口辛
䔞	艹亠幺十
圄	囗五口󰀌
诜	讠丿土儿
料	米󰁦十󰀢
泡	氵勹巳󰁀
狱	犭󰁥讠犬
䅠	禾日一󰁾
㭥	木⺈贝󰁶
俔	亻目儿󰁀
黳	匚𠂉大灬
軳	車勹巳󰁀
罬	罒又又又
鄷	ㄇ󰁺一阝
军	冖车󰀬
宜	宀󰀐一󰀘
箜	⺮宀八工
䧕	阝戈口󰀞
鲷	󰁢󰀞󰀼口
葶	艹󰁸冖丁
挠	扌弋丿儿
䅢	禾由月󰀝
夣	亠厶罒夕
慖	忄囗戈󰀞
䦗	門丿皿󰀌
郢	口王阝󰀢
吆	口ㄠ󰁶
萆	艹白丿十
雲	󰀙二厶󰁧
蛲	虫弋丿儿
仳	亻󰁴匕󰁀
㐖	士口乚󰁀
䐖	月尸米󰁶
哔	口󰁴匕十
妲	女日一󰀝
瓠	大二ㄅ󰂃
炢	火木丶󰁶
悢	忄丶艮󰁶
鳜	󰁢󰀞厂人
焱	火火火󰁧
㫷	󰀎八日󰀘
䌶	纟󰀛丿󰁥
嫷	女阝月
櫷	木丿󰁵󰀝
濬	氵󰀥冖目
㺾	王冂口󰀝
㾬	疒󰁴匕白
䏖	月弓丨󰀢
菖	艹日日󰀘
槲	木⺈月十
豷	一󰀓土䒑
钶	钅丁口󰀝
些	止匕二󰀘
庛	广止匕󰁫
溛	氵宀八󰂃
纛	主母󰀣小
躛	彳󰁆口󰁾
麛	󰁙󰁴匕耳
婇	女爫木󰁶
迅	⺄十辶󰀵
翅	十又羽󰀌
占	󰀥口󰀘
獠	犭ノ大小
俬	亻禾厶󰁶
赕	贝火火󰁶
抖	扌󰁦十󰀢
䊖	米十冂十
塣	氵口王土
䀢	目𠂉大󰁶
驗	󰀋灬人人
邼	匚王阝󰀢
硽	石大曰乚
㲷	气口口十
鷳	門月󰁟灬
緳	广三丨小
喔	口尸一土
粷	米勹米󰁶
沷	氵又丶
呶	口女又󰁶
䲷	󰁟灬木󰁧
鰷	󰁢灬亻朩
谷	八人口󰀘
㻛	王日勹󰁤
禄	礻󰁶󰁭氺
廛	广日土土
仛	亻丿七󰁀
皚	白山一䒑
滛	氵爫𠂉凵
黛	亻󰀁丶灬
軛	車厂⺋󰁀
㮰	木丿囗匕
歑	虍丿丷人
檗	尸口立木
媗	女宀一一
歩	󰁾小丿󰁣
鉖	釒夂󰁦󰁶
灢	氵一口󰀔
甆	䒑幺幺丶
克	古儿󰀅
踅	扌斤口󰁾
酋	丷西一󰀘
锝	钅日一寸
逛	犭ノ王辶
喲	口糹勹丶
糍	米䒑ㄠㄠ
㱷	一夕亻木
靣	丆囗口󰀘
洇	氵囗大󰁶
汷	氵夂󰁶
籷	米丿七󰁀
䒶	艹日󰁒丿
咶	口丿古󰀝
萶	艹三人日
鐶	釒罒一󰀔
模	木艹日大
蔲	艹宀二攵
杚	木𠂉乙󰁀
睚	目厂土土
䝚	豸尸匕󰁀
坚	〢又土󰀘
㴇	水水水󰁶
瀼	氵亠口󰀔
輛	車一冂丶
靚	月目儿
耼	耳冂二󰀝
涕	氵丷弓丿
襄	亠口口󰀔
椗	木宀一󰁾
煼	火勹凵丿
妽	女曰丨󰀢
瞖	匚𠂉大目
筇	⺮工阝󰀬
㜣	女󰁝犬灬
洳	氵女口󰀝
贳	廿󰄃贝󰁧
鴳	宀女󰁟灬
愠	忄日皿󰀝
䉙	⺮󰀙二厶
㰷	一夕󰁴人
漕	氵一ㄇ日
尷	乚匚皿
䏶	月󰁴匕土
珶	王丷弓丿
揶	扌耳阝󰀢
渶	氵艹ㄇ大
縶	土䒑十小
踶	口止日󰁾
鸶	󰁲󰁲一一
垩	一󰅊一土
厶	厶ㄥ丶
㷔	火爫丨日
剠	󰁸小刂󰀢
熠	火羽白󰀝
俰	亻禾口󰀝
冠	冖二儿寸
柱	木丶王󰀝
㟉	山宀丿󰀟
㙵	土󰁸冂土
䙵	覀土土󰀘
帶	廿儿冖丨
枉	木王󰀝
瞉	士冖一又
䞉	貝丷夫貝
垉	土勹巳󰁀
亜	一口〢一
溜	氵󰁚丶田
螉	虫八厶羽
鞉	廿󰀜儿󰀪
灏	氵日亠贝
何	亻丁口󰀝
魅	白󰁜厶󰅇
厄	厂⺋󰁫
萊	艹木人人
䏷	月日干󰀢
胼	月䒑廾󰀢
蚰	虫由󰀝
緶	糹亻一乂
淶	氵木人人
隵	阝虍一戈
蚵	虫丁口󰀝
䨋	󰀙丿七󰀅
悠	亻丨夂心
仹	亻三丨󰀢
宅	宀丿七󰀅
蠡	彑󰀓虫虫
徜	彳⺌冂口
咲	口䒑大󰁶
栅	木󰀼󰀼一
㷶	亻󰁺丿灬
㞉	乚⺶工
巶	刀口巳󰁀
䚵	言󰁦十󰀢
塉	土󰀪人月
䀈	󰁮󰀄󰁜皿
硉	石󰁬󰀟󰀢
桉	木宀女󰀝
逈	丿冂口辶
辊	车日󰁴匕
樇	木亻丨月
䄼	禾一囗人
炴	火ㄇ大󰁶
㓶	三丨刀刂
哄	口󰁺八󰁶
坡	土󰅌又󰁶
䂦	石人彡󰁥
惠	一日丨心
夕	夕丿乛丶
䢢	人丶彐辶
藵	艹亻口󰀔
麶	木人人厶
溶	氵宀八口
痵	疒禾子󰀌
䴥	󰁙󰁴匕口
瀄	氵⺮󰁮卩
擲	扌丷西阝
燖	火彐工寸
柅	木尸匕󰁀
诅	讠󰀐一󰀝
䴟	󰁙󰁴匕丶
㪽	一日斤󰀬
䗵	虫一田一
庶	广廿灬󰀦
㡉	冂丨弓幺
㺶	王󰁦十󰀢
俊	亻厶八夂
堉	土亠厶月
栉	木艹ㄗ󰀢
翊	立羽󰀝
蠉	虫罒一󰀔
遈	日一󰁾辶
毕	󰁴匕十󰀬
簳	⺮十早干
谳	讠十冂犬
吔	口也󰁀
摄	扌耳又又
䓴	艹丆冂大
㟊	山爫子󰀝
饩	⺈󰁐󰅎⺄
脜	月丆目󰀝
䏝	月二󰁓丶
阵	阝车󰀢
蹶	口止厂人
瘵	疒󰁯二小
湶	氵白水󰁶
潢	氵󰁺由八
憔	忄亻󰁷灬
锴	钅󰁴匕白
饕	口一ㄅ󰀖
鉼	釒䒑廾󰀢
山	山山山山
熔	火宀八口
鬊	󰂞彡三日
苉	艹匚儿󰀅
笊	⺮⺁丨󰂃
㘵	土冂丨
㿊	疒󰀄儿日
剼	厶厶厶刂
㙣	土弓󰀍󰀖
䯚	󰀾月幺月
燔	火丿米田
绢	纟口月󰀝
鳅	󰁢󰀞禾火
璥	王艹勹攵
壕	土󰁸冖󰀓
脔	亠󰁗冂人
磕	石土厶皿
镄	钅弓󰀯贝
騽	󰀋灬羽白
滗	氵⺮毛󰁀
薣	艹士口又
兔	⺈口󰁜丶
馕	⺈󰁐一󰀔
㬶	月丿土口
䬶	人良艮󰁶
卵	󰁚丶丿丶
欶	木口⺈人
盅	口丨皿󰀘
拍	扌白󰀝
㜜	女󰁡攵
帖	冂丨󰀥口
螳	虫⺌冖土
爼	乂乂󰀐一
銉	釒󰁬󰀟󰀢
鬇	󰂞彡⺈亅
笶	⺮𠂉大󰁧
譊	言土土儿
鍵	釒󰁬󰀟廴
抉	扌ユ人󰁶
䬊	几丿虫人
㬊	日爫一又
灶	火土󰀝
瞳	目立日土
枳	木口八󰁶
䢵	二厶阝󰀢
箓	⺮󰁭氺󰁧
摴	扌󰀙二ㄅ
䩡	廿󰀜大人
㴊	氵䒑凵刂
苔	艹厶口󰀘
䡵	車䒑󰀓辶
巢	巛日木󰁧
磑	石山一䒑
䏲	月丷弓丿
锡	钅日勹󰁤
䫶	木乂乂貝
㫶	日彐冖丨
櫶	木宀三心
厵	厂白小小
柳	木󰁚丿卩
簦	⺮癶一䒑
猱	犭ノ󰁻木
嗡	口八厶羽
㴣	氵氵一人
鍉	釒日一󰁾
啢	口一冂丶
嚅	口󰀙丆〢
檊	木十早干
競	立口儿儿
草	艹早󰀬
髶	󰂞彡耳󰀘
㭊	木丿丨󰁈
䊉	米宀木󰁶
挲	氵小丿手
㶗	𠂉母幺水
㰝	󰁂⺈人󰁶
丹	󰀼亠󰀌
鬲	一口冂丨
欲	八人口人
䝥	豸丿目十
斡	十早人十
赢	亠󰄃口丶
䐴	󰁮󰀄󰁜月
撢	扌覀早󰀢
䒢	艹󰁚卩󰀬
楆	木覀女󰀝
鵦	󰁟灬󰁭氺
家	宀一󰀓󰁧
拵	扌丨子
㮶	木䒑凵月
䋵	糹日勹󰄃
濗	氵艹曰丨
翗	夕夕羽󰀝
迗	一大辶󰀦
碳	石山火
錉	釒󰁚󰀁日
㮞	木冫⺈口
豆	一口䒑󰀘
䑟	爫冖夕王
嫊	女幺小
按	扌宀女󰀝
箶	⺮古月󰀘
讶	讠󰀂亅丿
谕	讠人一刂
鳢	󰁢󰀞ㄇ䒑
䪊	廿󰀜立三
㪊	󰁬丿口又
傲	亻主󰁡夂
缆	纟〢𠂉󰁜
蠆	艹曰冂虫
篘	⺮勹凵丿
㵘	水水水水
谢	讠丿󰀽寸
兲	王八󰁧
㱘	厂日月止
蔤	艹宀心山
费	弓󰀯贝󰁧
苳	艹夂󰁦󰁧
悕	忄乂丨
挵	扌王廾󰀢
孶	亠幺亠子
䭶	󰀋灬一󰀯
㭶	木艹方󰁥
汣	氵ク󰂃󰁶
妳	女⺈小󰁶
榻	木日羽󰀝
赖	一口󰅇贝
釉	丿米由󰀝
訊	言⺄十󰀢
稊	禾丷弓丿
樊	木乂乂大
螬	虫一ㄇ日
錵	釒艹亻ヒ
茵	艹囗大󰁧
筶	⺮丿土口
色	⺈巴󰀅
幇	土土寸丨
㫊	方𠂉丁口
䫊	丆卜口貝
溗	氵禾丬匕
莢	艹大人人
㑢	亻土厶卩
了	了乛亅
旅	方𠂉󰀕󰁶
孢	孑勹巳󰁀
崖	山厂土土
虆	艹田田小
给	纟人一口
鈳	釒丁口󰀝
岬	山甲󰀢
熳	火曰罒又
淙	氵宀二小
操	扌口口木
菢	艹扌勹巳
稚	禾亻󰁷󰀝
慅	忄又丶虫
锪	钅勹󰁤心
峙	山土寸󰁶
备	夂田󰀘
雕	󰀼土口󰁷
擖	扌艹日󰄃
抡	扌人匕󰁀
垲	土山己󰁀
匢	匚勹󰁤󰀏
筣	⺮禾刂󰀬
䮣	󰀋灬又木
朕	月䒑大󰁶
飆	犬犬犬虫
膅	月广󰁬口
酡	西一宀匕
蜕	虫丷口儿
瞪	目癶一䒑
掏	扌勹󰅎山
儡	亻田田田
㠶	冂丨丿几
俷	亻月巴󰁀
堶	土工月
濷	水氵廿丶
㖉	口人止󰀝
蠶	󰀄󰁜󰀄虫
閉	門󰀛丿󰀏
湊	氵三人大
繊	糹十戈业
洼	氵土土󰀝
髖	󰀾月宀丶
化	亻ヒ󰁀
瘢	疒丿󰁪又
轇	車羽人彡
䅳	禾勹凵丿
糬	米罒土日
溽	氵厂二寸
櫣	木艹車辶
蔫	艹一止灬
鹤	冖亻󰁷一
蠕	虫󰀙丆〢
羇	罒廿󰀜口
噱	口󰅋七󰀓
梢	木⺌月󰀝
靆	󰀙二厶辶
䍕	罒󰁚󰀁丶
躲	丿󰀽三木
刘	文刂󰀢
厅	厂丁󰀵
他	亻也󰁀
编	纟丶尸艹
㟶	山厂白小
阖	门土厶皿
債	亻貝󰁶
䂵	石工贝󰁶
炵	火夂󰁦󰁶
悵	忄󰀍󰀖󰁶
邵	刀口阝󰀢
蟶	虫耳口王
鶊	广󰁬人灬
越	土󰁾一丶
仲	亻口丨󰀢
倡	亻日日󰀝
嘱	口尸丿丶
涼	氵󰁸小󰁶
㱖	止亠人十
睢	目亻󰁷󰀝
闖	門󰀋灬󰀦
蜢	虫子皿󰀝
珙	王󰁺八󰁶
浼	氵⺈口󰁜
擅	扌亠囗一
邡	方阝󰀢
嗆	口人丶口
干	干一一丨
焙	火立口󰀝
瀳	氵艹󰁙灬
鸬	󰀥尸勹一
鉢	釒木一󰀝
倳	亻一口亅
宫	宀口口󰀘
愕	忄口口ㄅ
㢶	弓丆日󰀝
螺	虫田ㄠ小
液	氵亠亻丶
梶	木尸毛󰁀
碶	石三丨大
䘉	一大虫虫
嘉	士口䒑〇
淊	氵⺈臼󰀝
緊	匚丨󰁃小
蘉	艹罒冖又
阉	门大日乚
沇	氵厶儿󰁀
锱	钅巛田󰀝
㼾	󰁙󰁴󰁴丶
奚	爫ㄠ大󰁧
偌	亻艹口
识	讠口八󰁶
䉢	⺮土人口
喱	口厂日土
沫	氵一木󰁶
铪	钅人一口
猪	犭ノ土日
鲲	󰁢󰀞日匕
沲	氵𠂉也󰁀
泫	氵亠ㄠ󰁶
㜆	女米辶󰁶
槣	木宀大口
廇	广󰁚丶田
邈	豸白儿辶
裉	衤󰁧彐󰀖
磉	石又又木
棉	木白冂丨
傈	亻覀木󰁶
䣉	氵小丿巴
㣉	工彡󰁥
瀵	氵米田八
怵	忄木丶󰁶
塶	土󰁙󰁴匕
䀵	目厶𠂉大
虽	口虫󰁧
再	一冂土󰀌
逵	土八土辶
耵	耳丁󰀢
鴶	士口󰁟灬
懢	忄匚丨皿
䦣	門立口󰀌
蛆	虫󰀐一󰀝
崶	山土土寸
洶	氵勹乂凵
紶	糹土厶󰁶
蕵	艹夕人艮
宏	宀厶󰁧
陪	阝立口󰀝
㴶	氵冖亻󰁷
䕵	艹士口灬
搱	扌尸辛󰀢
㳲	氵氵大丶
拙	扌凵山󰀢
镅	钅󰁅目󰀝
郈	⺁一口阝
雪	󰀙彐󰀘
烈	一夕刂灬
胈	月又丶
僈	亻曰罒又
梉	木爿士󰀝
㢉	广禾丿七
䃈	石󰁴匕白
身	丿󰀽三丿
殚	一夕丷十
仫	亻丿厶󰁶
缫	纟巛日木
季	禾子󰀘
䈕	⺮日一󰁾
厢	厂木目󰀌
绵	纟白冂丨
媖	女艹ㄇ大
鳶	󰀁丶󰁟灬
过	寸辶󰀦
鴲	匕日󰁟灬
斵	󰁚丶刀斤
喵	口艹田󰀝
薵	艹士乛寸
疵	疒止匕󰁫
璕	王彐工寸
匆	勹󰁤丶󰀦
䳶	󰁟灬爫大
㳶	氵爫孑乚
怍	忄𠂉丨二
呲	口止匕󰁀
吲	口弓丨󰀢
翣	羽立女󰀘
襉	衤󰁧門月
祉	礻󰁶止󰀝
簖	⺮米󰄃斤
鄈	癶一大阝
䥉	釒宀⺈丶
㥉	忄立口󰀝
楉	木艹口
奉	三人󰀟󰀬
檫	木宀󰁯小
蔅	艹門女󰀘
澣	氵十早干
噎	口士冖䒑
得	彳日一寸
兼	䒑󰁬󰁗󰁧
䦖	門士口󰀌
罣	罒土土󰀘
绖	纟一厶土
褙	衤󰁧丬月
鶶	广󰁬丨灬
恢	忄火󰁶
瓵	厶口一丶
蓵	艹扌一󰁾
哵	口口力刂
涶	氵丿士󰁺
㶶	火冖󰀔󰁶
䓵	艹口口口
滲	氵厶厶彡
靕	一止月
墙	土十䒑口
掅	扌月󰀝
㢢	⺌冂口廾
颢	曰󰁸小贝
礉	石白方攵
腈	月主月󰀝
酈	一冂丶阝
溣	氵亻人艹
㤉	忄󰀄亅丿
䤉	西一心皿
変	亠󰁖夂󰁧
慈	䒑ㄠㄠ心
赤	土󰁖󰁧
歙	人一口人
蛇	虫宀匕󰁀
弳	弓一巛工
漳	氵立早󰀢
湣	氵󰁂󰀁日
銅	釒冂一口
鸭	甲勹丶一
虫	虫丨󰁈丶
䧖	阝戈戈󰁶
凅	冫囗古󰀝
锵	钅丬夕寸
赶	土󰁾干󰀵
电	日乚󰁫
攵	攵丿一󰂃
嵶	山弓冫冫
䔵	艹門木󰁧
㵶	氵十戈󰁷
鉕	釒匚口󰀝
抅	扌勹厶󰁶
谙	讠立日󰀝
錅	禾勹丿金
蕻	艹󰂞󰁺八
捣	扌勹丶山
矉	目宀一貝
柉	木丿之󰁶
埉	土大人人
䟉	土󰁾罒虫
罖	罒人丶󰁧
谴	讠口丨辶
韉	廿󰀜艹灬
蟉	虫羽人彡
㞲	山口丨󰀢
变	亠󰁗又󰁧
苅	艹乂刂󰀬
銡	釒士口󰀝
语	讠五口󰀝
䩢	廿󰀜扌斤
樢	木󰁟灬󰁶
郫	白丿十阝
舴	丿󰁪𠂉二
榅	木曰皿󰀝
豊	ㄇ󰁺一䒑
鎉	釒曰羽󰀝
爡	火艹曰虫
痘	疒一口䒑
腆	月ㄇ󰁺八
去	土厶󰁧
竳	立癶一䒑
借	亻󰁺日󰀝
姬	女匚丨丨
夤	夕宀一八
剡	火火刂󰀢
䪢	丿ㄅ丨一
悻	忄土䒑十
䕕	艹氵日又
卫	ㄗ一󰀌
鞷	一口冂󰀜
螷	广白丿虫
瞷	目門日󰀝
枷	木力口󰀝
垷	土目儿󰁀
䞷	土󰁾尸山
㞷	凵丨王󰀘
㰊	木土八火
登	癶一口䒑
片	丿丨一󰁈
叡	󰀥冖一又
珉	王󰁃󰁐弋
揉	扌󰁻乛木
叉	又丶󰀦
䏉	耳日幺灬
鑉	釒艹土皿
葉	艹廿󰄃木
笢	⺮󰁂󰀁󰀅
濖	氵罒土日
熟	󰁸孑九灬
忽	勹󰁤心󰁧
騳	󰀋灬󰀋灬
恄	忄士口󰀝
樳	木彐工寸
翆	羽九十󰀬
徭	彳爫󰅎山
㨳	扌宀大口
䉲	⺮弓一乂
蛳	虫リ一丨
藤	艹月䒑氺
秳	禾丿古󰀝
靷	廿󰀜弓丨
鑝	釒艹夂辶
睷	目󰁬󰀟廴
蝷	虫广䒑丿
坷	土丁口󰀝
杷	木巴󰁀
㝷	彐工九寸
䝷	𠂉大口貝
遴	米夕󰀂辶
㱊	丆󰀐冖人
耥	三󰅇⺌口
涞	氵一米󰁶
掉	扌󰀥早󰀢
玉	王丶󰀦
䎉	羽戈人󰁶
届	尸由󰀌
萉	艹月巴󰀅
鯊	氵小丿灬
嗉	口主ㄠ小
䡕	車了󰀩一
舜	爫冖夕丨
郄	乂厶阝
烄	火六乂󰁶
耧	三󰅇米女
売	士冖儿󰀅
搛	扌䒑󰁬󰁗
诔	讠三󰅇󰁶
檡	木罒土十
䤝	釒󰁚卩󰀢
萄	艹勹󰅎山
慊	忄䒑󰁬󰁗
蓪	艹󰁻用辶
蜷	虫䒑大⺋
眷	䒑大目󰀘
瓞	⺁厶󰂃人
霷	󰀙日曰󰁤
䜷	一口䒑又
㜷	弓一八女
朷	木刀󰁥
圷	土一卜󰁶
嵖	山木曰一
䄲	禾冂人󰁶
㑉	亻几一夕
愲	忄󰀾月󰀝
宊	宀犬󰁧
䮊	󰀋灬一人
瑉	王󰁂󰀁日
摉	扌宀八夕
㓤	士口刂󰀢
㕈	厂亠󰀔󰀦
㖤	口了󰀪凵
㓦	丆日刂󰀢
儵	亻丨夂灬
愵	忄弓冫冫
垅	土ヒ丶
㫥	日夕口󰀝
瓡	土䒑十󰂃
慲	忄廿冂丶
阊	门日日󰀌
藜	艹禾勹氺
䃵	石亠󰀋󰀔
鉤	釒勹口󰀝
惵	忄廿󰄃木
㴉	氵厶厶二
盷	目勹冫󰀝
蛷	虫一氺丶
雷	󰀙田󰀘
㙞	土丿目木
㛷	禾乚女
䛷	言宀夕⺋
囷	囗禾󰀦
曷	日勹人󰄃
㶘	氵⺮覀早
睅	目曰干󰀢
蝅	一大一虫
㯊	木一止灬
䐉	月巛田󰀝
吉	士口󰀘
毊	士󰁅几口
琉	王亠厶󰀸
盈	乃又皿󰀘
躉	艹曰冂󰁾
庉	广一凵乚
溉	氵彐厶󰁜
㛈	女土丿ㄅ
争	⺈󰁬亅󰀬
㪶	丆日󰁦十
萞	艹ㄇ人󰁴
屆	尸士凵󰀵
䅵	禾丷王灬
䔟	艹禾夕夕
㛟	女⺈ㄇ大
㠥	山田田土
㽦	火火冖田
稟	亠囗口禾
椥	木𠂉大口
㭕	木土厶󰁶
玱	王人⺋󰁀
㶉	氵爫幺一
粆	米小丿󰁥
㛥	女水日󰀝
㙧	土一〢田
怲	忄一冂人
胺	月宀女󰀝
媷	女厂二寸
䉶	⺮亻󰁷又
㪷	一口䒑十
㖡	口亠亻丶
骷	󰀾月古󰀝
齉	丿目田󰀔
窷	宀八耳卩
扶	扌二人󰁶
蚈	虫一廾󰀢
绉	纟⺈彐󰀝
滉	氵曰⺌儿
嚈	口厂日犬
䚈	覀土目儿
㚈	夕十󰀢
笲	⺮厶廾󰀬
㶠	氵󰀋灬十
㛧	女山石󰀝
菴	艹大曰乚
鐞	釒彐工寸
翧	宀一曰羽
贶	贝口儿󰁀
䚅	木人人儿
䏞	月一木󰁶
暅	日忄一一
恲	忄䒑廾󰀢
䴢	󰁙󰁴匕木
洢	氵亻󰁬丿
蒴	艹䒑凵月
㠦	山山三䒑
蘦	艹󰀙口口
鵧	䒑廾󰁟灬
㮠	木艹冖木
䊶	糹也󰁀
婷	女󰁸冖丁
䡝	車宀夕⺋
㩷	扌宀󰀀灬
芶	艹勹厶󰁧
驷	󰀊󰀞四󰀝
麉	干干󰁙匕
状	丬犬󰁶
弉	爿士廾󰀬
杈	木又丶󰁶
睈	目口王󰀝
載	十戈車󰀵
蟳	虫󰁬工寸
䡥	車宀八口
㼉	⺁厶󰂃󰁜
伉	亻亠几󰁀
㚕	大弓󰀯󰀬
臈	月艹曰󰄃
呴	口勹口󰀝
砉	三丨石󰀘
䯉	󰀾月⺈人
㑵	亻疒𠂉大
潆	氵艹冖小
䤧	釒囗口󰀝
穐	禾⺈曰乚
鶢	爫一灬
䤷	釒匚日女
涢	氵口贝󰁶
渖	氵宀曰丨
滧	氵六乂攵
䦊	󰂞上小󰁶
䦞	門氵王󰀌
㨷	扌廿口
㴟	氵厂日子
凶	乂凵󰀵
䇶	⺮⺈用󰀬
燶	火ㄇ󰁺󰀖
樷	木木耳又
騷	󰀋灬又虫
臶	一厶土子
潉	氵山曰󰁴
圈	囗䒑大⺋
轉	車一曰寸
眈	目冖󰁜󰁀
蝳	虫母󰁶
曶	勹󰁤日󰀘
佉	亻土厶󰁶
㜈	󰁻乛亅女
㚠	大丷王灬
靊	󰀙山三䒑
㛠	女门日󰀝
蜶	虫亠人十
䩝	廿󰀜⺁󰂃
㩛	扌囗一寸
䩥	廿󰀜丿廴
㗠	女厶口匕
羛	丷王弓󰀯
鶅	巛田󰁟灬
䪠	丿ㄅ丨一
㼟	白一󰁐丶
萈	艹目儿丶
㐈	丿󰂃乙󰀅
㦲	十戈󰁡󰁫
䂥	石󰁂󰀁󰁀
䁵	目罒一󰀔
㧷	扌一大口
䈶	⺮宀八口
制	󰅎冂丨刂
靈	󰀙口口人
秷	禾一厶土
舶	丿󰁪白󰀝
鈶	釒厶口󰀝
䁥	目匚艹口
㿧	白士乛寸
䢯	火火夕辶
㰶	夂卜口人
䑵	丿󰁪󰀰月
尶	一儿匚皿
氶	了󰀩󰀦
瑵	王又丶虫
谶	讠人人󰀞
醉	西一亠十
橊	木一〢田
穊	禾󰁮󰀄󰁜
蔄	艹門口󰀘
嘡	口⺌冖土
昡	日亠幺󰁶
刿	山夕刂󰀢
䈝	⺮乛󰁾月
䮝	󰀋灬冖車
䮞	󰀋灬三日
㗵	口火火人
娊	女目儿󰁀
䇉	立石󰀝
㨊	扌工月
酶	西一𠂉母
覷	虍业目儿
煶	火曰一󰁾
慶	󰁙乛心夂
其	艹三八󰁧
䦷	门人人土
㦷	厶用戈󰁶
㨞	扌幺小
弞	弓⺈人󰁶
㚵	女夂󰁦󰁶
䯊	󰀾月丁口
㯶	木󰁘凵夂
涱	氵󰀍󰀖󰁶
咵	口大二ㄅ
䒵	艹女子󰀘
篶	⺮一止灬
撵	扌二人车
禊	礻󰁶三大
蒵	艹爫幺大
鉉	釒亠幺󰁶
覊	覀廿󰀜灬
闰	门王󰀌
䏈	耳糹幺小
扵	扌人󰁦󰁶
碝	石丆冂大
䉵	⺮目大艮
攟	扌󰁙󰁴禾
㰧	厶口⺈人
擜	扌十冂犬
䆉	禾罒厶匕
冉	冂土󰀌
饷	⺈󰁐丿口
㩊	扌爫罒寸
熶	火曰耳又
膶	月門王󰀝
奷	女丿十󰀢
楷	木󰁴匕白
㥷	广大人心
䥷	釒⺮目刂
䔀	艹亻禾女
㵧	氵艹日󰄃
㲕	爫寸毛󰁀
㲶	气󰀥囗󰁘
呔	口大丶󰁶
哴	口丶艮󰁶
揵	扌󰁬󰀟廴
粶	米󰁭氺󰁶
䲶	二儿󰁟灬
叵	匚口󰀌
槊	䒑凵丿木
秊	禾丿十󰀬
觊	山󰁁ㄇ󰁜
鈉	釒冂人󰁶
瑔	王白水󰁶
貕	豸爫幺大
䐶	月󰀄󰁜日
槍	木人丶口
䲫	一儿󰁟灬
碭	石日一󰁤
䳉	夂󰁦󰁟灬
㴞	氵爫丨日
㦊	忄艹一󰀟
郶	立口口巴
剉	人人土刂
䉉	⺮⺈用󰂃
惶	忄白王󰀝
夷	一弓人󰀦
胶	月亠八乂
礷	石艹匚皿
䳟	日月󰁟灬
䒝	艹乂乂󰁧
䃶	石亠罒󰀔
㤷	忄人丶口
㱶	一夕士彡
怏	忄ㄇ大󰁶
瀏	氵󰁚丶刂
䴉	罒一口灬
琵	王王󰁴匕
铉	钅亠ㄠ󰁶
吵	口小丿ノ
紊	文ㄠ小󰁧
㖴	口艹勹󰁤
㙊	土󰀍󰀖󰁶
鐵	釒十戈王
豶	一󰀓十貝
翢	󰀼土口羽
䴡	一业丿匕
琄	王口月󰀝
驛	󰀋灬罒十
嬙	女土人口
嬘	女䒑󰀓辶
䁋	目廿󰄃木
晰	日木斤󰀢
飷	人良󰀐一
㧊	扌一冂丨
䈉	⺮立女󰀘
刉	𠂉乙刂󰀢
壷	士冖口一
棷	木耳又󰁶
磷	石米夕丨
脶	月口冂人
㾢	疒木人人
㽰	月月乛󰁾
㣷	彳宀心丁
䄶	禾弓󰀯󰀢
㘈	口匕𠂉󰁾
㶞	氵日亠󰀔
䐊	月日󰁴匕
㱕	止彐冖丨
鵊	大人人灬
䃦	󰁸孑攵石
璉	王車辶󰁶
蒉	艹口丨贝
汕	氵山󰀢
籕	⺮木󰁚田
蒔	艹日土寸
䑊	月口丨辶
晈	日六乂󰁶
丶	丶丶〇〇
刦	土厶刂󰀢
㗚	口覀木󰁶
乛	乛乛〇〇
撄	扌贝贝女
䗶	虫艹日󰄃
㡝	冂丨夂辶
亄	士冖一乚
輙	車耳又󰁶
亝	厶厶厶二
䁴	目亠囗一
洊	氵丨子
哉	十戈口󰀌
䓉	艹󰀄亅阝
㓉	冫丿古󰀝
嚦	口厂禾止
㾜	疒大人人
䚧	⺈用羽彡
瀀	氵丆󰀐夂
灠	氵匚丨儿
䀀	氵⺋皿󰀘
亶	亠囗口一
聠	耳䒑廾󰀢
貊	豸丆日󰀝
粊	󰁴匕米󰁧
辕	车土口󰀔
镉	钅一口丨
䇜	⺮⺈人󰁧
仙	亻山󰀢
䇊	立广厶󰁶
仞	亻刀丶󰁶
䗧	虫广󰁬氺
仡	亻𠂉乙󰁀
䂠	石𠂉大󰁶
圔	囗土厶皿
彲	一ㄇ丶彡
潲	氵禾⺌月
伛	亻匚乂󰁶
伜	亻九十󰀢
估	亻古󰀝
䀊	氵羽人皿
䒧	艹土厶󰁧
覡	工人人儿
咉	口ㄇ大󰁶
浊	氵虫󰁶
㵊	氵日耳又
䒉	丿󰁪𠂉㐄
䉚	⺮罒冖丶
㠋	山口口ㄅ
滠	氵耳又又
䒟	艹󰀼亠󰀘
傏	亻广󰁬口
䔠	艹木⺌月
㡡	冂丨厂寸
䁊	目又丶目
糊	米古月󰀝
蔉	艹六口󰀔
锉	钅人人土
㫚	勹󰁤日󰀘
䇚	⺮亻卜󰁧
罜	罒丶王󰀘
阰	阝󰁴匕󰁀
圱	丿土󰀝
䗴	虫⺮丿廴
蜱	虫白丿十
侟	亻丨子
䪅	廿󰀜罒虫
邋	巛囗乂辶
䓜	艹氵󰁚丶
霯	󰀙癶一䒑
焏	了口又灬
䀚	目󰁚卩󰀬
埱	土上小又
缲	纟口口木
俜	亻由一ㄅ
䕉	艹罒土十
㲊	󰀥冖一又
沊	冖󰁜水󰀦
啉	口木木󰁶
秕	禾󰁴匕󰁀
滜	氵白大十
胏	月丿ㄅ丿
倁	亻𠂉大口
䧅	阝一弓人
軜	車冂人󰁶
鰊	󰁢灬木󰀹
菉	艹󰁭氺󰁧
䔜	艹耳冂土
㬠	日⺈彐灬
㼲	丆冂〢丶
䳫	癶一大灬
荠	艹文󰀯󰀬
敉	米夂󰁶
鴻	氵工󰁟灬
㛚	女󰁻用󰀢
㼝	夕⺋一丶
鐦	釒門一廾
鋄	釒一火又
懁	忄罒一󰀔
㪟	󰁸日攵󰁶
姧	女女干󰀢
䗛	虫亻丨月
擉	扌罒勹虫
儠	亻巛囗󰁒
仟	亻丿十󰀢
㟰	山冖日六
㜊	女尸󰁺󰀖
㔉	尸丿口刂
䔉	艹禾禾󰁧
唉	口厶𠂉大
攉	扌󰀙亻󰁷
搵	扌囗人皿
仝	人工󰀘
眪	目一冂人
烶	火丿士廴
颟	艹一冂贝
䤰	土⺈人金
優	亻丆󰀐夂
涜	氵士冖儿
㺵	王⺈人󰁶
㟈	山一氺丶
庵	广大日乚
亵	亠扌九󰀔
澉	氵乛耳夂
矈	目白宀方
侉	亻大二ㄅ
徉	彳䒑󰀟󰀢
粋	米九十󰀢
珵	王口王󰀝
蟈	虫囗戈󰀞
龉	止人凵口
㷜	火亠󰁖大
㭫	木人人土
䢜	彐冖冂辶
汝	氵女󰀝
汘	氵丿十󰀢
執	土䒑十丶
䏛	月勹冫󰀝
緜	白冂丨小
纵	纟人人󰁶
溵	氵⺁彐又
陴	阝白丿十
虴	虫丿七󰁀
淜	氵月月󰀝
㾡	疒土厶卩
㗔	口虍文󰁶
坖	二儿土󰀘
殹	匚𠂉大又
粕	米白󰀝
铟	钅囗大󰁶
闔	門土厶皿
㞈	乚丶艹
㚴	女冂丨
䚴	言月󰀝
幵	一干󰀢
翉	木一羽󰀝
枈	󰁴匕木󰁧
儏	亻󰀥夕米
俉	亻五口󰀝
覄	覀亻犬󰁧
櫠	木广癶又
鞈	廿󰀜人口
螈	虫厂白小
櫙	木艹匚口
浕	氵尸󰂃󰁦
䨜	󰀙月月󰀘
穡	禾土人口
蝈	虫囗王丶
橎	木丿米田
昜	曰一勹󰁤
䳦	宀一日灬
湵	氵丷王󰂃
皴	厶八夂又
蚴	虫ㄠ力ノ
隴	阝立月三
暈	曰冖車󰀬
艶	ㄇ󰁺一巴
鉶	釒一廾刂
䔝	艹止匕小
刜	弓󰀯刂󰀢
㯜	木艹亠十
䅛	禾日日󰀝
鬡	󰂞彡宀丁
帵	冂丨宀⺋
丵	业䒑十󰀬
㗴	口門月󰀝
㡈	冂丨⺈󰁜
䁏	目覀女󰀝
塈	󰁮󰀄󰁜土
恏	女子心󰁧
硈	石士口󰀝
衈	丿皿耳󰀝
遏	日勹人辶
岜	山巴󰀅
㯡	木人氺巳
䒠	艹三丨󰀬
囈	口艹土厶
槫	木一曰寸
䤳	釒亠亻丶
䉋	⺮女󰁅目
䩲	廿󰀜广又
㠠	山虍田皿
儱	亻立月三
鸵	勹丶ㄅ匕
藴	艹糹曰皿
痴	疒𠂉大口
渵	氵艹田󰀝
濕	氵日幺灬
駲	󰀋灬丶丨
䰘	丨王王彡
䚟	⺈用日寸
寡	宀丆󰀐刀
篡	⺮目大厶
岡	冂䒑山󰀵
簜	⺮氵曰󰁤
䘴	衤󰁧木厶
巵	⺁一巴󰁫
㠈	山門王󰀝
㘴	口人土󰀌
堈	土冂䒑山
䂏	𠂉大刀口
砈	石厂⺋󰁀
悏	忄大人人
須	彡丆貝󰁶
蠈	貝戈虫
崕	山厂土土
䁛	目白󰁜厶
覲	廿口儿
榲	木囗人皿
俶	亻上小又
伅	亻一凵乚
铔	钅一业󰀝
㭡	木丿囗乂
傒	亻爫幺大
椵	木󰁃丨又
蘴	艹山三䒑
阴	阝月󰀝
昴	日󰁚丿卩
瘴	疒立早󰀵
㿆	疒禾亠󰀔
䨝	󰀙月󰀘
䴯	木人人󰁤
椛	木艹亻ヒ
㫜	日日一󰀝
梔	木⺁一巴
唵	口大曰乚
䧜	阝广󰁬口
匠	匚斤󰀵
憻	忄亠囗一
葠	艹亻彐又
哢	口王廾󰀢
䍴	⺶禾女󰀝
㮵	木方𠂉亠
段	亻三几又
却	土厶卩󰀢
桋	木一弓人
镘	钅日罒又
㝚	宀丿󰀥廴
璠	王丿米田
㠷	冂丨乃󰂃
瀋	氵宀丿田
鋈	氵丿大金
鈱	釒󰁂󰀁󰁀
狈	犭ノ贝󰁶
箵	⺮小丿目
媉	女尸一土
檉	木耳口王
㪉	人一口攵
䪉	廿󰀜巛󰁒
㒠	亻󰀥夕一
㟘	山󰀼土口
厰	厂⺌冂攵
鉱	釒广厶󰁶
菰	艹孑⺁󰂃
檲	木囗一寸
叄	厶厶厶三
㖊	口彐寸󰁶
晉	一厶厶日
噉	口乛耳攵
搠	扌䒑凵月
㝤	宀󰀀冂土
㞄	乚大乚
歔	虍业⺈人
㭵	木勹田󰀝
䭵	󰀋灬几丶
厴	厂曰月甲
掴	扌囗王丶
㟚	木十又山
㖶	口覀土󰀝
呞	口𠃌一口
燉	火󰁸孑攵
暙	日三人日
呥	口冂土󰀝
蕠	艹女口小
銈	釒土土󰀝
玴	王廿󰄃󰁀
莴	艹口冂人
櫉	木厂士寸
嫉	女疒𠂉大
䊈	米𠂉母󰁶
㫉	方⺈厂⺋
鸗	立月一灬
䒡	艹弓丨󰀬
唈	口口巴󰁀
唊	口大人人
唜	一木口匕
唝	口工贝󰁶
唞	口扌󰁦十
阄	门⺈日乚
昄	日⺁又󰁶
劉	󰁚丶刀刂
㚚	大夕口󰀘
啈	口土䒑十
䓥	丿󰂃艹早
啜	口又又又
拴	扌人王󰀝
嬵	女糹白丨
䋴	糹󰁻乛木
㬵	月六乂󰁶
㨖	扌一厶攵
嘵	口土土儿
䏥	月冂土󰀝
㢅	广王廾󰀵
鍈	釒艹ㄇ大
昵	日尸匕󰁀
喞	口白匕卩
喥	口广廿又
午	𠂉十󰀬
鋴	釒古儿󰁀
苴	艹󰀐一󰀘
笵	⺮氵⺋󰀅
癟	疒丿目艹
㻄	王丿一󰁾
㬉	日丆冂大
䬉	几丿虫󰁖
嗞	口䒑幺幺
丠	丬匕一󰀘
嗥	口白大十
嗦	口十冖小
鵡	一󰀁止灬
䮠	󰀋灬一田
浡	氵十冖子
㵡	氵󰀙勹巳
瀈	氵羽冖車
歱	止丿一土
倈	亻木人人
嚵	口⺈口丶
匴	匚⺮目廾
挴	扌𠂉母󰁶
㫵	日丨三三
䌴	糹󰄹月丶
䥅	十王王金
噄	口三丨小
噋	口󰁸孑攵
帡	冂丨䒑廾
嚊	口丿目󰀯
魉	白󰁜厶人
嚟	口禾勹氺
嚠	口󰁚丶刂
挈	三丨刀手
匈	勹乂凵󰀵
茈	艹止匕󰀅
茴	艹囗口󰀘
䦫	門艹ㄇ大
㼛	一廾一丶
䌈	糹日羽󰀝
㭉	艹木󰁧
䕋	艹土广口
㻰	王三丨彐
䢹	匚󰁃阝󰀢
摶	扌一曰寸
忶	忄二厶󰁶
嗈	口巛口巴
翶	白󰀪十羽
濶	氵門丿古
藈	艹目癶大
鶉	󰁸孑󰁟灬
涉	氵止󰀤ノ
痈	疒用󰀵
圦	土丿󰂃󰁶
弗	弓󰀯󰀵
囚	囗人󰀦
坥	土󰀐一󰀝
䴄	爫冖夕灬
㐛	亻口乙
㿣	白日勹󰄃
垝	土⺈厂⺋
垦	艮土󰀘
埊	山水土󰀘
鴄	匚儿󰁟灬
郷	󰁲丿󰁮阝
埥	土月󰀝
楔	木三丨大
䵄	木人人䒑
饜	厂曰月艮
驍	󰀋灬土儿
硙	石山己󰁀
儷	亻一ㄇ匕
愷	忄山一䒑
堦	土󰁴匕白
鵄	一厶土灬
㿶	亠丷冖皮
杠	木工󰀝
喈	口󰁴匕白
塵	󰁙󰁴匕土
桵	木爫女󰀝
硵	石󰀥囗乂
肴	乂月󰀘
页	丆贝󰁧
緉	糹一冂丶
淉	氵曰木󰁶
闉	門覀土󰀌
垠	土艮󰁶
㻊	王⺈口󰁜
墝	土土土儿
蠜	木乂乂虫
墦	土丿米田
昲	日弓󰀯󰀢
欞	木󰀙口人
杉	木彡ノ
㷇	夕夕火
壀	土尸口辛
釼	釒刀󰂃󰁶
嚉	口业丷寸
壝	土口丨辶
歭	止土寸󰁶
壵	士士士󰀘
梜	木大人人
蜠	虫囗禾󰁶
潡	氵󰁸孑攵
豔	山三丨皿
娧	女丷口儿
彋	弓罒一󰀔
夞	夕卜口匕
㡵	广人丶󰁻
砵	石木一󰀝
㸉	辛火火火
三	三一一一
帉	冂丨八刀
渉	氵止小丿
癈	疒癶弓又
踉	口止丶󰀖
鸉	木曰一灬
鉣	釒土厶󰁶
轋	車車辶󰁶
砠	石󰀐一󰀝
澝	氵宀心用
䖷	虫乂丨
忔	忄𠂉乙󰁀
鍚	釒日一󰁤
朜	月󰁸子󰀝
㕢	󰀥冖一又
妥	爫女󰀘
劚	尸氺罒刂
璲	王䒑󰀓辶
鬄	󰂞彡日󰁤
溰	氵山一䒑
阛	门罒一󰀔
姦	女女女󰀘
姫	女匚丨丨
姰	女勹日󰀝
䇖	⺮勹丿󰁣
聶	耳耳耳󰀘
㠵	亠󰄃冂丨
轱	车古󰀝
溝	氵󰀀冂土
巛	巛󰁑󰁑󰁑
柵	木冂艹󰀢
矵	石刂󰀢
幉	冂丨廿木
倴	亻大十廾
瘈	疒三丨大
湉	氵忄丿古
鹉	一󰀁止一
蹉	口止䒑工
瓏	王立月三
疶	疒廿󰄃󰁫
婝	女宀一󰁾
婦	女彐冖丨
苧	艹宀丁󰀬
鋧	釒目儿󰁀
媘	女󰁴匕白
軔	車刀丶󰁶
绔	纟大二ㄅ
㻳	王艹禾刂
娔	女古儿󰁀
茛	艹艮󰁧
騔	󰀋灬日󰄃
鞰	廿󰀜曰皿
乷	氵小丿乙
䂚	石乂乂󰁶
㦠	忄业丷寸
漝	氵羽白󰀝
遛	󰁚丶刀辶
㛇	女广土󰀝
蛜	虫亻󰁬丿
㟵	山罒一止
瀧	氵立月三
袲	亠夕夕󰀔
嫝	女广󰁬氺
嫞	女广󰁬丨
䶵	人一口几
㶵	亻丿士灬
馥	禾日𠂉夂
靰	廿󰀜一儿
暜	立立曰󰀘
㚜	大戈口󰀞
飈	几丿虫火
亀	⺈曰曰乚
磈	石白󰁜厶
裈	衤󰁧冖车
壈	土亠囗禾
棈	木月󰀝
㣈	彑󰁤冂丨
䣈	口巴口巴
拶	扌巛夕󰁶
鎧	釒山一䒑
嬦	女士乛寸
錶	釒󰀔󰁶
䨠	󰀙日勹󰄃
鷄	爫幺大灬
瞘	目匚口口
䮛	󰀋灬阝寸
懧	忄宀心丁
鶵	勹凵丿灬
诠	讠人王󰀝
卶	夕夕卩󰀢
整	一口󰅇止
嶵	山罒丨三
蕴	艹纟日皿
畴	田三丿寸
孥	女又子󰀘
眥	止匕目󰀘
㵵	氵耳又乑
䵵	⺮目大灬
彟	彐寸艹又
実	宀三人󰁧
䴔	六乂󰁠一
馱	󰀋灬大󰁶
宰	宀辛󰀬
颈	ス工丆贝
袈	力口亠󰀔
碈	石󰁚󰀁日
梈	木󰁸了󰀢
倏	亻丨夂犬
䀏	勹目󰀌
㢈	广亻󰁷󰀌
霛	󰀙弓弓弓
㐷	亻󰀊一󰀝
桱	木一巛工
鋷	釒耳又󰁶
図	囗󰁦乂󰀦
閜	門丁口󰀌
疜	疒一卜󰀦
钷	钅匚口󰀝
鵵	⺈口󰁜灬
皛	白白白󰀘
㩠	扌󰁙󰁴灬
䕗	艹丿目󰀯
嵵	山日土寸
浵	氵󰀼亠彡
疴	疒丁口󰀌
薴	艹宀心丁
䴵	木人人廾
㓴	丆冂〢刂
尟	日一󰁾丿
扚	扌勹丶󰁶
粝	米厂一󰁡
捨	扌人干口
膚	虍田月󰀌
屟	尸廿󰄃木
祈	礻󰁶斤󰀢
襈	衤󰁧巳八
饈	人良⺶一
秱	禾冂一口
㥈	冂丨󰀥心
䥈	釒艹犬廾
奈	大二小󰁧
楈	木乛󰁾月
姕	止匕女󰀘
鉰	釒𠃌一口
硛	石亠󰁖󰁶
嵠	山爫幺大
愰	忄曰⺌儿
峌	山一厶土
峞	山⺈厂⺋
戧	人丶彐戈
刧	土厶刀󰁥
朧	月立月三
崉	山水曰󰀝
铴	钅氵ㄋ󰁤
蓴	艹一曰寸
瓴	人丶󰁻丶
洵	氵勹日󰀝
崵	山曰一󰁤
㳵	氵禾子󰀝
䳵	木人人灬
崝	山月󰀝
銟	釒山冂丨
侂	亻广丿七
嵋	山󰁅目󰀝
歠	又又又人
嵱	山宀八口
褈	衤󰁧丿土
礈	石䒑󰀓辶
荜	艹󰁴匕十
餈	冫⺈人艮
䤈	西一八皿
㤈	忄心󰁶
椈	木勹米󰁶
夈	夂米󰁧
帚	彐冖冂丨
䏜	月乃󰂃󰁶
幖	冂丨覀小
庎	广人󰀯󰀵
炟	火日一󰀝
灟	氵尸氺虫
轧	车乚󰁀
邥	冖󰁜阝󰀢
鉜	釒亻寸󰁶
欰	丿皿⺈人
鳵	⺄十󰁟灬
䥝	釒󰁙󰁴匕
糵	艹丿󰃧米
賵	貝󰀰目󰀝
峵	山宀厶
攴	󰀥又󰁧
戜	戈口王󰀌
绠	纟一日乂
觝	⺈用󰁚丶
衋	󰁬󰀟丆皿
廏	广白匕又
廞	广釒⺈人
鶠	匚日女灬
熥	火󰁻用辶
弚	丷弓丨󰀬
瑧	王三人禾
抜	扌又󰁶
儜	亻宀心丁
燊	火火火木
焜	火曰󰁴匕
掛	扌土土卜
葪	艹⺈用刂
滫	氵亻丨月
㨶	扌󰁟灬󰁶
䨶	󰀙厶目󰁈
創	人丶彐刂
樶	木曰耳又
珈	王力口󰀝
艵	䒑廾⺈巴
騶	󰀋灬勹丿
滝	氵立曰乚
枘	木冂人󰁶
菈	艹扌立󰀘
鏈	釒車辶󰁶
㾅	疒丿ㄅ丿
珚	王囗大󰁶
㨝	扌尸⺌月
凜	冫亠囗禾
觋	工人人󰁜
眧	目刀口󰀝
懜	忄艹罒夕
鵷	宀夕⺋灬
澞	氵虍口大
歷	厂禾禾止
奝	大󰀼土口
薦	艹󰁙一灬
玝	王𠂉十󰀢
瑚	王古月󰀝
珰	王⺌彐󰀝
䳧	󰁟灬亻大
摳	扌匚口口
扫	扌彐󰀝
湲	氵爫一又
䵫	宀夕⺋灬
㯉	木虍丿󰀛
鼙	士口䒑十
姶	女人一口
䧶	亻󰁷六󰁧
築	⺮工几木
毉	匚𠂉大人
駶	󰀋灬尸口
芵	艹ユ人󰁧
悴	忄亠人十
䕬	艹弓一一
鯉	󰁢灬曰土
诉	讠斤丶󰁶
肜	月彡󰁥
䂜	石三丨󰀢
唦	口氵小丿
礛	石匚丨皿
娿	阝丁口女
柧	木⺁厶󰂃
圮	土己󰁀
馧	禾日日皿
螝	虫白󰁜厶
阌	门爫冖又
䩙	廿󰀜亠幺
樣	木丷王󰀩
尯	乚⺈⺋
釴	釒󰀁丶󰁶
聱	主󰁡夂耳
晘	日曰干󰀢
寈	宀月󰀘
鹙	禾火󰁠一
妧	女二儿󰁀
轞	車匚丨皿
䇵	⺮氵斤󰀬
媶	女艹耳󰀝
萣	艹宀一󰁾
㑈	亻󰀂小󰁶
誶	言亠人十
骶	󰀾月󰁚丶
檶	木大匚口
簉	⺮丿土辶
谉	讠宀曰丨
鰉	󰁢灬白王
䥧	釒󰀥冖目
冦	冖二儿又
矒	目艹罒目
䊔	米艹ㄇ大
搊	扌勹凵丿
㑝	亻王廾󰀢
漰	氵山月月
匦	匚车九󰁫
㲋	⺈口󰁴匕
炦	火又丶
㿁	疒白大十
鵭	釒󰁟灬󰁶
恦	忄丿冂口
䁦	目虍󰀐一
墵	土󰀙二厶
撊	扌門月󰀝
傦	亻󰀾月󰀝
䕊	艹亠囗一
盝	󰁭氺皿󰀘
鉠	釒ㄇ大󰁶
琘	王󰁚󰀁日
欉	木业䒑又
婶	女宀日丨
䩶	廿󰀜凵虫
㩶	扌⺮一乂
憹	忄ㄇ󰁺󰀖
鈵	釒一冂人
舵	丿󰁪宀匕
琈	王爫子󰀝
搈	扌宀八口
鱉	㡀攵󰁢灬
豉	一口䒑又
剭	尸一厶刂
折	扌斤󰀢
忦	忄人󰀯󰀢
阠	阝⺄十󰀢
莦	艹⺌月󰀘
掦	扌日勹󰁤
玦	王ユ人󰁶
㕞	尸冂丨又
懹	忄亠口󰀔
喫	口三丨大
唰	口尸冂刂
鼈	㡀攵黽󰀘
笧	⺮󰀼󰀼一
靐	󰀙田󰀙田
斏	文丶艮󰁶
喏	口艹口
薏	艹立日心
缈	纟目小丿
鷭	丿米田灬
焴	火亠厶月
䖏	虍勹󰁤󰂃
㖏	口日土󰀝
鶞	⺁十目灬
渋	氵止󰀪󰁶
歞	日幺幺人
扦	扌丿十󰀢
䲥	九󰁟灬󰁧
㣅	弓󰀄󰁜日
驧	󰀋灬廿米
汞	工水󰁧
眶	目匚王󰀝
軷	車又丶
黷	󰀹土灬貝
倨	亻尸古󰀝
㜶	女⺈口丶
价	亻人󰀯󰀢
廷	丿士廴󰀌
滷	氵󰀥囗󰁘
镚	钅山月月
鈦	釒大丶󰁶
駏	󰀋灬匚󰁃
槧	車斤木󰁧
齈	丿目田󰀖
爦	火匚丨儿
腘	月囗王丶
焘	三丿寸灬
彈	弓口口十
敏	𠂉母夂󰁶
畏	田一󰀖󰁧
轈	車巛曰木
谞	讠乛󰁾月
怉	忄勹巳󰁀
㕏	厂一口十
佈	亻冂丨
摦	扌大二󰂃
摯	土䒑十手
䭕	車斤人艮
鋞	釒一巛工
铦	钅丿古󰀝
甏	士口䒑丶
恉	忄匕日󰀝
㻏	王彐火󰁶
蛶	虫爫寸󰁶
缷	𠂉十凵卩
揝	扌夂卜日
零	󰀙人丶󰁻
伷	亻由󰀝
㛶	女山火
漷	氵󰁸孑阝
強	弓厶虫󰁶
䓲	艹亻丷儿
聝	耳戈口󰀞
㠊	山虍业󰀝
漚	氵匚口口
擤	扌丿目󰀯
扪	扌门󰁀
笞	⺮厶口󰀘
阏	门方人󰁦
躈	口止白攵
纈	糹士口貝
溈	氵丶丿灬
嘏	古󰁃丨又
䘏	丿皿阝󰀢
㘏	䒑丿目匕
⺈	⺈丿乛
妆	丬女󰀝
苝	艹丬匕󰀅
㺹	王厶廾󰀢
蝦	虫󰁃丨又
杦	木ク󰂃󰁶
澊	氵丷西寸
螦	虫幺小
鞦	廿󰀜禾火
蠝	虫田田田
齷	止󰀆尸土
昞	日一冂人
罷	罒厶月匕
螶	匚󰁃虫虫
彷	彳方ノ
潷	氵⺮󰁬󰀟
㽷	疒水󰀦
佷	亻艮󰁶
䅸	禾艹辛󰀢
筊	⺮六乂󰁧
玙	王一ㄅ一
晌	日丿冂口
麧	木人人乙
鬖	󰂞彡厶彡
黈	󰁺由八王
晥	日宀二儿
终	纟夂󰁦󰁶
藏	艹厂󰄃丶
廈	广丆目夂
族	方𠂉𠂉大
㻈	王⺁一口
䗏	虫宀火又
莵	艹丿口丶
鷗	匚口口灬
琙	王戈口󰀞
騋	󰀋灬木人
尫	一儿王󰀌
鸧	人⺋󰁠一
愝	忄匚曰女
㗦	口耳󰁚卩
㘱	土冂土󰀝
栦	木丶丿丨
暘	日曰一󰁤
靶	廿󰀜巴󰁀
蝶	虫廿󰄃木
睶	目三人日
杶	木一凵乚
德	彳十罒心
侷	亻尸𠃌口
㝶	罒儿寸󰁧
覴	癶一口儿
湟	氵白王󰀝
茕	艹冖⺄十
灥	白水白水
曟	日日日󰀖
㰖	木匚丨儿
錦	釒白冂丨
溟	氵冖曰六
矦	⺈厂𠂉大
槚	木覀贝󰁶
㑴	亻彐冖又
㵝	氵亠󰀔口
岵	山古󰀝
䲵	小丿󰁟灬
瑴	士冖一又
沵	氵⺈小󰁶
覉	覀廿󰀜口
釈	丿米尸󰂃
榉	木󰀧一󰀟
燈	火癶一䒑
杞	木己󰁀
㗟	氵丶王匕
輟	車又又又
盞	戈戈皿󰀘
枺	木一木󰁶
㑕	亻山夕󰁶
厪	厂廿口
煥	火⺈ㄇ大
䇈	立又土󰀝
妉	女冖󰁜󰁀
轟	車車車󰀬
㦉	忄士冖䒑
柦	木日一󰀝
儤	亻曰󰁺氺
衺	亠󰀄亅󰀔
桺	木一󰀯󰁃
栟	木䒑廾󰀢
瀝	氵厂禾止
澟	氵亠囗禾
膥	一木戊人
桟	木二戈󰁶
傪	亻厶厶彡
烥	火匚丨丨
㒴	丿󰂃凵山
䱵	󰁢灬八羽
咴	口火󰁶
撴	扌󰁸孑攵
籵	米十󰀢
駉	󰀋灬冂口
钴	钅古󰀝
熈	丿匚丨灬
憈	忄虍业󰀝
棥	木乂乂木
䇙	⺮弓丨󰀬
鉥	釒木丶󰁶
椙	木曰曰󰀝
扥	扌丿七󰁀
斮	󰁺日斤󰀢
椟	木十乛大
䆄	禾亠囗一
冈	冂乂󰀦
䆈	禾尸氺辶
㧉	扌气󰁀
㾚	疒止匕二
灄	氵耳耳耳
懥	忄十冖󰁾
榟	木宀辛󰀢
廩	广亠囗禾
楻	木白王󰀝
钡	钅贝󰁶
驦	󰀋灬󰀙目
槞	木立曰乚
㰵	亠人人人
捥	扌宀夕⺋
鬦	丨王王十
樟	木立早󰀢
簵	⺮車夂口
氵	氵丶丶󰀞
尵	乚口貝
䏴	月⺌月󰀝
樉	木大乂乂
稉	禾一曰乂
鰵	𠂉母攵灬
騉	󰀋灬日匕
咤	口宀丿七
㴪	氵丿目木
䓩	艹木十又
㫦	亻丨夂日
橶	木十早戈
橺	木門日󰀝
檁	木亠囗禾
檙	木目󰁕󰁈
闞	門乛耳攵
㨉	扌󰁂󰀁日
䉈	⺮󰁺月攵
娉	女由一ㄅ
茥	艹土土󰀘
櫽	阝爫工木
䘡	󰁴匕亠󰀔
匥	匚厶廾󰀵
鶦	古月󰁟灬
欘	木尸氺虫
欟	木艹口儿
欥	日⺈人󰁶
㫾	日⺌冂口
㯵	木艹丿土
硑	石䒑廾󰀢
㒍	亻厶厶小
毵	厶大彡乚
琴	王王人乛
䯵	󰂞彡十廾
寵	宀立月三
穉	禾尸氺󰀟
戈	戈一󰁒丶
驉	󰀋灬虍业
鐴	釒尸口辛
汋	氵勹丶󰁶
沘	氵󰁴匕󰁀
悧	忄禾刂󰀢
㜀	女木目󰀝
苠	艹󰁃󰁐弋
鴊	一止󰁟灬
洉	氵⺁一口
籦	⺮釒丿土
㩉	扌人一羽
掞	扌火火󰁶
刈	乂刂󰀢
䈈	⺮月巴󰀅
鎞	釒丿囗匕
㽅	癶一口丶
箟	⺮曰󰁴匕
閥	門亻戈󰀦
涘	氵厶𠂉大
淦	氵金󰀝
琞	日月王丶
笂	⺮九丶󰁧
磥	石田幺小
騁	󰀋灬由ㄅ
胤	丿ㄠ月乚
炞	火亠卜󰁶
酵	西一土子
恞	忄一弓人
翑	羽勹口󰀝
䚥	⺈用弓冫
岉	山勹󰁤󰁥
慵	忄广󰁬丨
煵	火十冂十
腵	月󰁃丨又
溘	氵土厶皿
搟	扌車干󰀢
㤶	忄乚丶
䤶	釒大日乚
㖀	口󰁬󰀟󰀢
邗	干阝󰀢
烞	火木卜󰁶
厤	厂禾禾󰀦
铈	钅亠冂丨
駝	󰀋灬宀匕
瓈	王禾勹氺
蓈	艹丶󰁮阝
囫	囗勹󰁤󰀏
熞	火匚丨土
䑙	丿古冂二
馟	禾日爫子
螥	虫人丶口
䐃	月囗禾󰁶
坘	土一彑󰀝
澤	氵罒土十
濅	氵宀彐又
墁	土日罒又
㝜	宀󰁺日󰀘
㧟	扌氵匚󰁀
蛥	虫夕夕󰁶
醵	西一󰅋󰀓
戞	丆󰀐冖戈
蓮	艹車辶󰁧
棶	木木人人
咈	口弓󰀯󰀢
膵	月艹亠十
㒈	亻乛耳攵
竵	立一口丨
鑋	車一巛金
䣶	西一丿古
㣶	彳亠囗一
㢸	弓弓攵󰁶
遤	󰀋灬辶󰀦
䁑	目日一󰁤
籉	⺮士口土
㜟	女乛耳攵
针	钅十󰀢
蒈	艹󰁴匕白
璈	王󰁡攵
蟵	虫厂一寸
蛧	虫冂乂乂
琜	王木人人
抾	扌土厶󰁶
洦	氵丆日󰀝
䀸	扌斤目󰀘
轘	車罒一󰀔
婥	女󰀥早󰀢
爜	火业䒑又
疤	疒巴󰁫
焤	广亻寸火
軘	車一凵乚
瓝	⺁厶󰂃丶
珫	王亠厶儿
馶	󰀋灬十又
琤	王⺈󰁬亅
烵	火艹勹丶
覶	爫󰁻冂儿
妶	女亠幺󰁶
榶	木广󰁬口
㦶	戈一厶土
䦶	门⺈󰁬亅
釵	釒又丶󰁶
鶘	古月󰁟灬
瓟	⺁厶󰂃巳
瓥	⺁厶󰂃虫
瓧	一󰁐󰁊十
摍	扌宀亻日
畈	田⺁又󰁶
蕈	艹覀早󰀬
鴉	󰀄亅丿灬
鴞	口一ㄅ灬
瞞	目廿冂丶
膤	月󰀙彐󰀝
荝	艹贝刂󰀬
磟	石羽人彡
礍	石艹曰󰄃
茤	艹夕夕󰁧
陦	阝三丿寸
遃	立丿彡辶
闦	門ㄇ󰁺䒑
汥	氵十又󰁶
䏤	月𠃌一口
鉈	釒宀匕󰁀
聗	耳大人人
騥	󰀋灬󰁻木
鐤	釒目󰁕󰁈
饶	⺈󰁐弋儿
脵	月口一大
焵	火冂䒑山
攈	扌󰁙󰁴禾
嵉	山󰁸冖丁
䥶	釒厂禾止
㥶	宀󰀀八心
鶥	󰁅目󰁟灬
䂾	石木人人
萟	艹禾九丶
鎟	釒又又木
駟	󰀋灬四󰀝
蝐	虫󰀰目󰀝
赉	一米贝󰁧
甈	丿目木丶
褧	耳火亠󰀔
鵉	亠󰁗󰁟灬
〇  〇〇〇〇