⺁	⺁丿丿
⺄	⺄⺄〇〇
⺈	⺈丿乛
⺋	⺋𠃌乚
⺌	⺌丨丶丿
⺗	⺗亅丿丶
⺧	丿土󰀌
⺪	乛止󰀌
⺮	⺮丿一丶
⺳	冖丿󰁏󰀅
⺶	⺶丶丿丿
⺷	丷王󰀘
⺻	󰁬丨一󰀌
⻊	口止󰀘
㐀	丨一󰀥一
㐁	一囗人󰀦
㐂	七七七󰀅
㐃	囗丨󰀵
㐄	㐄一ㄥ丨
㐅	乂丿丶
㐆	⺁彐𠃌󰁫
㐇	九乙󰀅
㐈	丿󰂃乙󰀅
㐉	丁乙󰀅
㐊	士乙󰀅
㐋	土乙󰀅
㐌	𠂉也󰀅
㐍	爫乙󰀅
㐎	文乙󰀅
㐏	五乙󰀅
㐐	女又乙󰀅
㐑	夂󰁦乙󰀅
㐒	刀口乙󰀅
㐓	丁口乙󰀅
㐔	󰁸乙󰀅
㐕	由乙󰀅
㐖	士口乚󰁀
㐗	土丿匕乙
㐘	米乙󰀅
㐙	一口䒑乙
㐚	五口乙󰀅
㐛	亻口乙
㐜	一氺丶九
㐝	扌勹口乙
㐞	󰀎八乙󰀅
㐟	丨三丨乙
㐠	爫孑乚乙
㐡	九丆冂大
㐢	氵爫子乙
㐣	广車乙󰁫
㐤	九十󰀣八
㐥	釒󰀐󰀞乙
㐦	󰀗一󰁕乙
㐧	丶乛亅丿
㐨	󰁻乛亅亅
㐩	二󰀯二󰀯
㐪	一凵人󰀦
㐫	亠乂凵󰀬
㐬	亠厶󰀸󰀅
㐭	亠囗口󰀘
㐮	六󰀀󰀔󰁧
㐯	󰁸口禾日
㐰	亻口󰀝
㐱	人彡󰁣
㐲	亻大󰁶
㐳	亻一儿󰁀
㐴	亻夕󰁶
㐵	亻一󰀛󰀢
㐶	亻巳󰁀
㐷	亻󰀊一󰀝
㐸	亻⺈人󰁶
㐹	亻气󰁀
㐺	亻亻人󰁶
㐻	亻冂人󰁶
㐼	亻丿廾󰀢
㐽	亻几乂󰁶
㐾	亻二儿󰁀
㐿	亻手󰀢
㑀	亻大丶󰁶
㑁	亻凵山󰀢
㑂	亻一冂人
㑃	亻幺力󰁥
㑄	亻母󰁶
㑅	亻𠂉上󰀝
㑆	亻口儿󰁀
㑇	亻⺈彐󰀝
㑈	亻󰀂小󰁶
㑉	亻几一夕
㑊	亻亠󰁖󰁶
㑋	亻ㄇ󰁺󰀝
㑌	亻匚王󰀝
㑍	亻二木󰁶
㑎	亻巛山󰀢
㑏	亻宀寸󰁶
㑐	亻上小󰁶
㑑	亻丿目󰀝
㑒	人一口人
㑓	亻厶又
㑔	亻丆贝󰁶
㑕	亻山夕󰁶
㑖	亻亻口丨
㑗	亻丿󰀽丿
㑘	亻戈廾󰀢
㑙	亻耳乚󰁀
㑚	亻𠃌󰀠阝
㑛	亻木口󰀝
㑜	亻扌斤󰀢
㑝	亻王廾󰀢
㑞	亻火廾󰀢
㑟	亻丘八󰁶
㑠	亻〢又土
㑡	亻󰁮卩󰀢
㑢	亻土厶卩
㑣	亻木木󰁶
㑤	亻艹田󰀝
㑥	亻日勹󰁤
㑦	亻丶尸犬
㑧	亻禾子󰀝
㑨	亻口𠂉大
㑩	亻罒夕󰁶
㑪	亻文󰀳󰀝
㑫	亻人丶心
㑬	亻女古󰀝
㑭	亻田一󰀯
㑮	亻冖車󰀢
㑯	亻丆貝󰁶
㑰	亻彑󰀓󰁶
㑱	亻󰁻乛木
㑲	亻十冂十
㑳	亻勹凵丿
㑴	亻彐冖又
㑵	亻疒𠂉大
㑶	亻气米󰁶
㑷	亻厶月匕
㑸	亻古丁口
㑹	人一由日
㑺	亻亻󰁷乃
㑻	亻宀心山
㑼	亻田夂口
㑽	亻⺌冖土
㑾	亻󰁝言󰀝
㑿	亻巛日木
㒀	亻亠丷古
㒁	亻囗土十
㒂	亻艹土日
㒃	亻󰀁二丶
㒄	亻󰁝犬灬
㒅	亻亠夕󰀔
㒆	亻人一羽
㒇	亻𠂉一灬
㒈	亻乛耳攵
㒉	亻⺌冖木
㒊	亻刀丶止
㒋	亻󰀎八斤
㒌	亻火火几
㒍	亻厶厶小
㒎	亻丿大三
㒏	亻宀󰀀󰁦
㒐	亻⺮勹日
㒑	亻匚氵󰁷
㒒	亻业䒑未
㒓	亻土䒑辶
㒔	亻罒勹虫
㒕	亻亠󰁲󰁷
㒖	亻艹日丶
㒗	亻艹二土
㒘	亻匚丨立
㒙	亻糹白丨
㒚	亻爫工心
㒛	亻羽亻󰁷
㒜	亻󰀗一八
㒝	亻艹罒人
㒞	亻山亻𠃌
㒟	亻亠󰀋󰀔
㒠	亻󰀥夕一
㒡	亻爫𠂉小
㒢	亻人一艹
㒣	亻广亻心
㒤	亻耳耳耳
㒥	亻山三䒑
㒦	亻田田土
㒧	亻亠乂󰁷
㒨	亻󰀗丿巳
㒩	亻彑󰀓虫
㒪	人匚丨󰀓
㒫	一丨二儿
㒬	二儿王󰀌
㒭	口儿口儿
㒮	二儿一󰀓
㒯	⺌一儿󰀟
㒰	丿󰂃工󰀘
㒱	丿󰂃夕󰁧
㒲	丿󰂃日󰀘
㒳	冂丨丿丶
㒴	丿󰂃凵山
㒵	白八󰁧
㒶	八白󰀘
㒷	ㄇ人一八
㒸	䒑󰀓󰁧
㒹	十󰀣八八
㒺	冂䒑人󰄃
㒻	󰀰目儿󰀅
㒼	廿冂丨丶
㒽	󰀰丷夫⺋
㒾	󰀰方𠂉也
㒿	󰀰亠乂󰁷
㓀	冖卜󰁧
㓁	冖八󰁧
㓂	冖二儿女
㓃	冖言丿七
㓄	厶厶厶󰁜
㓅	冫丁󰀢
㓆	冫人匕󰁀
㓇	冫丿大󰁶
㓈	冫石󰀝
㓉	冫丿古󰀝
㓊	冫冂一口
㓋	冫󰁺八󰁶
㓌	冫人王󰀝
㓍	冫亠厶儿
㓎	冫彐冖又
㓏	冫冂八口
㓐	冫土八土
㓑	冫土䒑十
㓒	冫七人⺗
㓓	冫十冂十
㓔	冫丿󰀽寸
㓕	冫戊一火
㓖	冫日艹󰀟
㓗	冫三丨小
㓘	几一夕丶
㓙	文凵󰀵
㓚	工刂󰀢
㓛	工刀󰁥
㓜	幺刀󰁥
㓝	二󰀯刂󰀢
㓞	三丨刀󰁥
㓟	皮刂󰀢
㓠	󰀥口刂󰀢
㓡	𠂉十凵刂
㓢	夂口刂󰀢
㓣	人一口刂
㓤	士口刂󰀢
㓥	⺌彐刂󰀢
㓦	丆日刂󰀢
㓧	人丶乛刂
㓨	大人人刂
㓩	⺈用刂󰀢
㓪	丶󰁮刀󰁥
㓫	大一廾刂
㓬	丷夫刀刂
㓭	日勹人刂
㓮	󰀼土口刂
㓯	巛田刂󰀢
㓰	一由凵刂
㓱	人一月刂
㓲	丶尸冂刂
㓳	日一󰁾刂
㓴	丆冂〢刂
㓵	口口二刂
㓶	三丨刀刂
㓷	丿目木刂
㓸	匚󰁃󰀚刂
㓹	厂火火刂
㓺	虍文刂󰀢
㓻	罒一止刂
㓼	木人氺刂
㓽	山宀二刂
㓾	尸氺丿刂
㓿	禾人氺刂
㔀	日󰁸小刂
㔁	癶一口刂
㔂	米夕㐄刂
㔃	糹⺈巴刀
㔄	覀米刂󰀢
㔅	󰁬十󰀲刂
㔆	󰀄󰁜󰀄刂
㔇	癶弓几刂
㔈	艹丨三刂
㔉	尸丿口刂
㔊	亠囗口刂
㔋	匚丨󰁃刂
㔌	耳又乑刂
㔍	⺮目廾刂
㔎	凵人󰃧刀
㔏	石石石刂
㔐	⺮一丨刂
㔑	艹丿󰃧刀
㔒	山亻󰁷刂
㔓	丿十力󰁥
㔔	力口口󰀘
㔕	气力󰁥
㔖	力口乛󰀅
㔗	弓󰀯力󰁥
㔘	凵山力󰁥
㔙	䒑廾力󰁥
㔚	丿古力󰁥
㔛	士口力󰁣
㔜	爫孑力󰁥
㔝	一冂丨力
㔞	丿十丬力
㔟	丿九力
㔠	日勹人力
㔡	丿囗乂力
㔢	糹⺈巴力
㔣	田田田力
㔤	宀丿米力
㔥	罒厶月力
㔦	丷王飠力
㔧	虍田皿力
㔨	勹丬匕月
㔩	勹土厶皿
㔪	勹󰀥囗󰁘
㔫	匕󰁫
㔬	匕早󰀬
㔭	󰁴日一󰁾
㔮	廿口夫匕
㔯	匚几口󰀌
㔰	匚夕卜󰀦
㔱	匚󰀗人󰀦
㔲	匚人良九
㔳	匚人良几
㔴	匚田󰁺八
㔵	匚巳巳八
㔶	匚立早貝
㔷	匚一冂人
㔸	匚⺁虍几
㔹	十力󰁥
㔺	十七十󰀬
㔻	丆卜十󰀬
㔼	扌亻󰁷十
㔽	󰀥囗口󰀘
㔾	⺋𠃌乚
㔿	一󰁐丨󰀵
㕀	由⺋󰀅
㕁	乂厶卩
㕂	厂人丶乛
㕃	厂一廾󰀵
㕄	厂一幺󰀦
㕅	厂甲󰀵
㕆	厂古󰀌
㕇	厂立󰀌
㕈	厂亠󰀔󰀦
㕉	厂人一口
㕊	厂甫󰀦
㕋	厂金󰀌
㕌	厂日一寸
㕍	厂亻󰁷󰀌
㕎	厂土厶皿
㕏	厂一口十
㕐	厂臼勹灬
㕑	厂士口寸
㕒	厂丷王丶
㕓	厂󰀹土土
㕔	厂耳王心
㕕	厶厶󰁧
㕖	厶厶厶木
㕗	丷王ク厶
㕘	厶厶厶小
㕙	厶八夂丶
㕚	又󰁦󰀦
㕛	又又󰁧
㕜	口丨又󰁧
㕝	古又󰁧
㕞	尸冂丨又
㕟	󰀥冂艹又
㕠	冫亻󰁷又
㕡	󰀥冖一又
㕢	󰀥冖一又
㕣	八口󰀘
㕤	口九󰁀
㕥	口人󰁶
㕦	口大󰁧
㕧	口尸󰁥
㕨	口几丶󰁶
㕩	口三丨󰀢
㕪	口冖󰁜󰁀
㕫	口方󰁥
㕬	口八厶󰁶
㕭	口丿大󰁶
㕮	口八乂󰁶
㕯	冂人口󰀌
㕰	口毛󰁀
㕱	口乚丶
㕲	口木󰁶
㕳	口乂凵󰀢
㕴	口冖几󰁀
㕵	口王󰀝
㕶	口五󰀝
㕷	口白󰀝
㕸	口立󰀝
㕹	口又丶
㕺	口口一ㄅ
㕻	丶丆卜口
㕼	口勹乂󰄃
㕽	口󰁐丶人
㕾	小口匕󰀅
㕿	禾口󰀘
㖀	口󰁬󰀟󰀢
㖁	口乂厶
㖂	口日󰁒丿
㖃	口⺁一口
㖄	口丶丿丨
㖅	口戊一󰀝
㖆	口ㄇ󰁺󰀝
㖇	口丆冂〢
㖈	土丿匕口
㖉	口人止󰀝
㖊	口彐寸󰁶
㖋	人󰀯口匕
㖌	亻九口匕
㖍	󰁦十口匕
㖎	口匕人󰀯
㖏	口日土󰀝
㖐	口口󰁬丿
㖑	口戈廾󰀢
㖒	口丷弓丿
㖓	口夂三丨
㖔	口丿大口
㖕	口辛󰀢
㖖	辛口󰀘
㖗	口山人乛
㖘	口厂二󰀖
㖙	力口口匕
㖚	亻寸口匕
㖛	古口匕󰀅
㖜	󰁸口匕󰀅
㖝	未口匕󰀅
㖞	口口冂人
㖟	口爫冖又
㖠	口大二小
㖡	口亠亻丶
㖢	口广止匕
㖣	口立口󰀝
㖤	口了󰀪凵
㖥	口囗禾󰁶
㖦	口木日󰀝
㖧	口󰁚󰀁日
㖨	口󰁭氺󰁶
㖩	口耳又󰁶
㖪	口戈口󰀞
㖫	口土八夂
㖬	口臼又󰁶
㖭	口丿大⺗
㖮	口人一艹
㖯	冂一口匕
㖰	口匕冂口
㖱	亠亻夂口
㖲	女口口匕
㖳	氵女口匕
㖴	口艹勹󰁤
㖵	口󰀣八󰁶
㖶	口覀土󰀝
㖷	口日一󰁾
㖸	口虍匚一
㖹	口八刀皿
㖺	口三人日
㖻	口󰁻乛木
㖼	口甘木󰁶
㖽	口丆貝󰁶
㖾	口口䒑丿
㖿	口耳阝󰀢
㗀	口山幺幺
㗁	口口口ㄅ
㗂	口小丿目
㗃	口󰁂󰀁日
㗄	口罒方󰁥
㗅	口古月󰀝
㗆	口廿󰀜󰀢
㗇	口󰁃丨又
㗈	口󰁻用力
㗉	三丨刀口
㗊	口口口口
㗋	口⺈厂大
㗌	口宀一土
㗍	口禾日󰀝
㗎	口力口木
㗏	口丆卜止
㗐	口大丶皿
㗑	口三十
㗒	口󰁸󰀔󰁶
㗓	口丿󰃧辶
㗔	口虍文󰁶
㗕	口󰀀冂土
㗖	口爫臼󰀝
㗗	口力白十
㗘	口甫寸󰁶
㗙	口勹凵丿
㗚	口覀木󰁶
㗛	口⺮丿大
㗜	口亠幺田
㗝	口䒑王灬
㗞	口石皮󰁶
㗟	氵丶王匕
㗠	女厶口匕
㗡	艹亻乃匕
㗢	口丿一力
㗣	口廿儿丨
㗤	戊上小口
㗥	口󰁸孑阝
㗦	口耳󰁚卩
㗧	口宀八土
㗨	匚𠂉大口
㗩	口羽白󰀝
㗪	口止匕小
㗫	口󰁯二小
㗬	⺌冖口夕
㗭	口丿米心
㗮	夕口广人
㗯	土丿日匕
㗰	口彳人󰁾
㗱	口亻󰁷木
㗲	口󰁬土一
㗳	口⺮人口
㗴	口門月󰀝
㗵	口火火人
㗶	口癶弓又
㗷	口宀󰀀贝
㗸	口彳𠂉丁
㗹	口亻󰁷心
㗺	口一大三
㗻	口ㄇ󰁈辶
㗼	口业丷未
㗽	󰁲丿丶口
㗾	口廿󰀜ヒ
㗿	口門丁口
㘀	口臼米󰁶
㘁	口皿土十
㘂	口䒑幺心
㘃	口艹心
㘄	口木罒方
㘅	口彳釒丁
㘆	口士口土
㘇	口火火木
㘈	口匕𠂉󰁾
㘉	口⺮󰁮卩
㘊	口󰀙言󰀝
㘋	口匚丨貝
㘌	口虍一刂
㘍	口小亻戈
㘎	口门乛攵
㘏	䒑丿目匕
㘐	口󰀋灬乂
㘑	口士二氺
㘒	禾丿一匕
㘓	口門木󰀹
㘔	口宀󰀀貝
㘕	口艹匚皿
㘖	口立丿貝
㘗	口目目󰁷
㘘	言糹糹口
㘙	口口口攵
㘚	口門乛攵
㘛	口人一三
㘜	亻󰁷言口
㘝	囗又󰀦
㘞	囗力󰀏
㘟	囗廾󰀵
㘠	囗心丿󰀏
㘡	囗甲󰀵
㘢	囗⺌一儿
㘣	囗口月󰀌
㘤	囗氵󰀲一
㘥	囗爫𠂉小
㘦	土力󰁥
㘧	土󰁻乛亅
㘨	土冂人󰁶
㘩	土󰁴匕󰁀
㘪	土毛󰁀
㘫	土二󰀯󰀢
㘬	土勹厶󰁶
㘭	土幺𠃌󰁀
㘮	土尸󰂃󰁶
㘯	土𠂉力󰁥
㘰	土󰁦十󰀢
㘱	土冂土󰀝
㘲	土尸九󰁀
㘳	丬匕土󰀘
㘴	口人土󰀌
㘵	土冂丨
㘶	夕㐄土󰀘
㘷	土艹乂󰁶
㘸	一夕匕土
㘹	止匕土󰀘
㘺	土亻戈󰁶
㘻	土囗大󰁶
㘼	土土丿ㄅ
㘽	十戈土󰀌
㘾	土宀一󰀛
㘿	土日土󰀝
㙀	土宀八九
㙁	土𠂉母󰁶
㙂	土丷口儿
㙃	土丘八󰁶
㙄	土󰁴匕土
㙅	土口木󰁶
㙆	土宀厶
㙇	土一󰀓󰁶
㙈	土虍几󰁀
㙉	土ㄇ󰁺八
㙊	土󰀍󰀖󰁶
㙋	土󰀎八󰁶
㙌	土󰁬丨八
㙍	土又又又
㙎	土戊一女
㙏	土𠂉日夂
㙐	土山丆〢
㙑	丿口冂土
㙒	田󰁻乛土
㙓	土土土土
㙔	土󰁆口㐄
㙕	土田月󰀝
㙖	土丿口丶
㙗	土田一󰀖
㙘	土覀女󰀝
㙙	氵乚土
㙚	土丷王󰀟
㙛	土甫寸󰁶
㙜	󰁸冂口土
㙝	土力力月
㙞	土丿目木
㙟	土丶󰁮月
㙠	匚𠂉大土
㙡	土彳人󰁾
㙢	土廿冂丶
㙣	土弓󰀍󰀖
㙤	土虍丿󰀛
㙥	土六口󰀔
㙦	人一朩土
㙧	土一〢田
㙨	土幺幺人
㙩	土大丷小
㙪	土士冖䒑
㙫	土亻󰁷木
㙬	木人人土
㙭	土厂䒑人
㙮	土⺮人口
㙯	土八土厶
㙰	⺈用刀土
㙱	口一ㄅ土
㙲	土亠󰁲󰁷
㙳	土戊一心
㙴	土⺈厂言
㙵	土󰁸冂土
㙶	󰁸⺌冖土
㙷	土日幺灬
㙸	土亻业夫
㙹	土艹罒夕
㙺	土匚口貝
㙻	土广日土
㙼	土田田田
㙽	土大丆日
㙾	土󰀗乂子
㙿	土丷王丶
㚀	土虍一戈
㚁	土土土儿
㚂	土一口󰀔
㚃	士冖乂䒑
㚄	士冖田󰁾
㚅	夂一丿
㚆	亠日夂󰁧
㚇	乂凵八夂
㚈	夕十󰀢
㚉	乃夕夕󰁧
㚊	夕夕亠人
㚋	夕夕󰀼口
㚌	夕夕日木
㚍	夕夕口貝
㚎	大凵󰀬
㚏	大廾󰀬
㚐	大大󰁧
㚑	彐大󰁧
㚒	大丿丶丶
㚓	大木󰁧
㚔	大䒑十󰀬
㚕	大弓󰀯󰀬
㚖	白大󰁧
㚗	大󰀐一󰀘
㚘	夫夫󰁶
㚙	力口大󰁧
㚚	大夕口󰀘
㚛	大匕日󰀘
㚜	大戈口󰀞
㚝	大亻土土
㚞	大木木󰁧
㚟	⺈口󰁴大
㚠	大丷王灬
㚡	大丁口口
㚢	亻女󰀝
㚣	女女󰀘
㚤	女󰀁丶󰁶
㚥	女一󰀛󰀢
㚦	女一󰀯󰀢
㚧	女广󰁥
㚨	女⺄十󰀢
㚩	女冂二󰀝
㚪	女毛󰁀
㚫	女乃󰂃󰁶
㚬	女勹冫󰀝
㚭	女乚丶
㚮	女冖几󰁀
㚯	女几乂󰁶
㚰	女丆卜一
㚱	女丘󰀝
㚲	女󰀥口󰀝
㚳	女力口󰀝
㚴	女冂丨
㚵	女夂󰁦󰁶
㚶	女󰃧󰀝
㚷	女人小󰁶
㚸	女𠃌一口
㚹	女󰁚丿卩
㚺	女乃子󰀝
㚻	田女󰀘
㚼	女田󰀝
㚽	工一ㄅ女
㚾	女口儿󰁀
㚿	女勹巳󰁀
㛀	女⺈彐󰀝
㛁	女一丷十
㛂	女⺁巴󰁀
㛃	三丨刀女
㛄	女亠󰀔󰁶
㛅	女耳󰀝
㛆	女乃木󰁶
㛇	女广土󰀝
㛈	女土丿ㄅ
㛉	女西󰀝
㛊	女几木󰁶
㛋	女人⺗󰁶
㛌	女厶丿󰀟
㛍	女大人人
㛎	女口口󰀝
㛏	女一氺丶
㛐	女一日乂
㛑	󰀥夕又女
㛒	女一口䒑
㛓	女乂丨
㛔	女夂三丨
㛕	女口巴󰁀
㛖	女厶八夂
㛗	女人人土
㛘	女十冖子
㛙	女辛󰀢
㛚	女󰁻用󰀢
㛛	女丿󰀽丿
㛜	亻丨攵女
㛝	女貝󰁶
㛞	女王廾󰀢
㛟	女⺈ㄇ大
㛠	女门日󰀝
㛡	女宀二儿
㛢	女禾乃󰁥
㛣	女口贝󰁶
㛤	女一冂丶
㛥	女水日󰀝
㛦	女木木󰁶
㛧	女山石󰀝
㛨	女⺶乚󰁀
㛩	女亠厶月
㛪	女大日乚
㛫	女日勹󰁤
㛬	女土八土
㛭	女󰁺日󰀝
㛮	女宀火又
㛯	女⺈口力
㛰	女󰁂󰀁日
㛱	女田一󰀖
㛲	女丆貝󰁶
㛳	亠丷冖女
㛴	女巛丿乂
㛵	女爫冂土
㛶	女山火
㛷	禾乚女
㛸	女士口䒑
㛹	女亻一乂
㛺	女立日󰀝
㛻	女大土土
㛼	女丿十臼
㛽	女宀米󰁶
㛾	女戊一口
㛿	女一〣丨
㜀	女木目󰀝
㜁	女木日一
㜂	土土寸女
㜃	女亻言󰀝
㜄	女几丿虫
㜅	女亠幺田
㜆	女米辶󰁶
㜇	女土土心
㜈	󰁻乛亅女
㜉	女巛口巴
㜊	女尸󰁺󰀖
㜋	女䒑八皿
㜌	士冖一又
㜍	女广󰁬口
㜎	女爫幺大
㜏	女口貝󰁶
㜐	女山一䒑
㜑	氵甫女󰀘
㜒	女臼廾󰀢
㜓	女艹人口
㜔	女立口儿
㜕	女車辶󰁶
㜖	女一ㄇ日
㜗	女厶厶彡
㜘	女虍󰀐一
㜙	女󰁙󰁴匕
㜚	女宀亻日
㜛	女車⺈人
㜜	女󰁡攵
㜝	女人丶一
㜞	車斤女󰀘
㜟	女乛耳攵
㜠	女山亻󰁷
㜡	女彳人󰁾
㜢	女󰀻女󰀝
㜣	女󰁝犬灬
㜤	女覀早󰀢
㜥	女罒貝󰁶
㜦	女彐工寸
㜧	女厂䒑人
㜨	女尸氺󰀟
㜩	女丿ㄇ大
㜪	立朩斤女
㜫	女彳山攵
㜬	女⺈厂言
㜭	女⺌冖田
㜮	女匚丨皿
㜯	女匚丨灬
㜰	女白幺木
㜱	女斤斤貝
㜲	女󰄹月丶
㜳	女亠罒󰀔
㜴	女一ㄇ目
㜵	女亠󰀋󰀔
㜶	女⺈口丶
㜷	弓一八女
㜸	艹丿󰃧女
㜹	女目目󰁷
㜺	女丿土貝
㜻	女言糹心
㜼	女又又一
㜽	巛子󰀘
㜾	孑人󰀯󰀢
㜿	孑󰁻乛亅
㝀	母子󰀝
㝁	勹日子󰀘
㝂	孑扌斤󰀢
㝃	孑⺈口󰁜
㝄	󰁸孑一乚
㝅	士冖一又
㝆	孑士口口
㝇	󰁸孑󰁸子
㝈	言糹糹子
㝉	宀一󰀘
㝊	宀又󰁧
㝋	宀了󰀬
㝌	宀ク󰂃󰁧
㝍	宀一ㄅ一
㝎	宀之󰁧
㝏	宀人󰀯󰀬
㝐	宀八厶󰁧
㝑	宀方󰁣
㝒	宀古󰀘
㝓	宀人一口
㝔	宀六乂󰁧
㝕	宀心又󰁧
㝖	宀夕夕󰁧
㝗	宀丶艮󰁧
㝘	宀言󰀘
㝙	宀王一八
㝚	宀丿󰀥廴
㝛	宀亻一人
㝜	宀󰁺日󰀘
㝝	宀木木󰁧
㝞	宀一󰀚一
㝟	宀一目儿
㝠	宀日六󰁧
㝡	宀耳又󰁧
㝢	宀丿口丶
㝣	宀三丨大
㝤	宀󰀀冂土
㝥	宀爿米󰁧
㝦	宀亻󰁷乃
㝧	宀女人土
㝨	宀土口󰀔
㝩	宀广󰁬氺
㝪	宀土䒑丶
㝫	宀阝夂
㝬	宀三丨夫
㝭	宀忄日
㝮	宀凵山又
㝯	宀丿大口
㝰	宀丿目方
㝱	宀爿艹夕
㝲	宀爿艹丨
㝳	一⺗󰀦
㝴	二儿寸󰀦
㝵	日一寸󰁧
㝶	罒儿寸󰁧
㝷	彐工九寸
㝸	小白儿󰀅
㝹	小丿⺈丶
㝺	䒑󰁬〢丿
㝻	廿口丿
㝼	乚一󰀛
㝽	乚水󰀦
㝾	乚工
㝿	乚皮󰀦
㞀	乚火
㞁	乚日匕
㞂	乚爫女
㞃	八人口丶
㞄	乚大乚
㞅	乚日木
㞆	乚大口
㞇	乚田󰀖
㞈	乚丶艹
㞉	乚⺶工
㞊	凵山二乚
㞋	尸又󰀦
㞌	尸子󰀌
㞍	尸九丶󰀦
㞎	尸巴󰁫
㞏	尸丿之󰀦
㞐	尸立󰀌
㞑	尸二二乚
㞒	尸丿目󰀌
㞓	尸匕日󰀌
㞔	尸夕夕󰀦
㞕	尸八月󰀌
㞖	尸木冂󰁫
㞗	尸一氺丶
㞘	尸一󰀓丶
㞙	尸毛水󰀦
㞚	尸丿十臼
㞛	尸彳匕日
㞜	尸彳禾女
㞝	戊上小尸
㞞	尸彳人󰁾
㞟	尸丷西大
㞠	尸大丷小
㞡	尸工工󰀔
㞢	凵丨一󰀌
㞣	凵丨八刀
㞤	山人󰁧
㞥	山丿󰂃󰁧
㞦	山几󰁀
㞧	山乃󰁣
㞨	山子󰀝
㞩	山几丶󰁧
㞪	󰁭山󰀬
㞫	山之󰁧
㞬	山工󰀘
㞭	大山󰀬
㞮	山⺈丶󰁧
㞯	己山󰀬
㞰	山𠂉十󰀢
㞱	山日󰀘
㞲	山口丨󰀢
㞳	山󰁦十󰀢
㞴	山󰁚󰀁󰁀
㞵	山文󰁧
㞶	山文󰁶
㞷	凵丨王󰀘
㞸	山丆卜󰁧
㞹	山丁口󰀝
㞺	山𠂉大󰁧
㞻	山口一ㄅ
㞼	了󰀩山󰀬
㞽	山戈󰁐󰁀
㞾	山尸匕󰁀
㞿	山土乂󰁧
㟀	禾山󰀬
㟁	山厂干󰀢
㟂	山母󰁶
㟃	山𠃌一口
㟄	山羊󰀢
㟅	山乂凵儿
㟆	山亻ヒ十
㟇	山人人土
㟈	山一氺丶
㟉	山宀丿󰀟
㟊	山爫子󰀝
㟋	山丷口儿
㟌	山乚丶
㟍	山丶艮󰁶
㟎	山爫女󰀝
㟏	山人丶口
㟐	山艹亠󰄃
㟑	山十冖子
㟒	山󰁬丿口
㟓	山乂丨
㟔	山人丶口
㟕	山口󰁦十
㟖	山王廾󰀬
㟗	山八刀刀
㟘	山󰀼土口
㟙	山󰁺日󰀝
㟚	木十又山
㟛	山扌甘󰀘
㟜	山弓⺈小
㟝	山立口󰀝
㟞	山戈戈󰁶
㟟	山󰁺八⺋
㟠	山冂䒑山
㟡	山丷夫⺋
㟢	山大丁口
㟣	山木八厶
㟤	山󰁭氺󰁧
㟥	山厶大彡
㟦	山冖車󰀬
㟧	山口口ㄅ
㟨	山山丆〢
㟩	󰁂󰀁攵山
㟪	山田一󰀖
㟫	山白水󰁶
㟬	山臼丨又
㟭	山󰁂󰀁日
㟮	山宀八犬
㟯	山宀夂口
㟰	山冖日六
㟱	山丷王灬
㟲	山厂白小
㟳	山覀木󰁶
㟴	山白󰁜厶
㟵	山罒一止
㟶	山厂白小
㟷	山艹人口
㟸	山白大十
㟹	山耳󰁚卩
㟺	山󰀻女󰀘
㟻	車斤山󰀬
㟼	山󰁡攵
㟽	山覀二小
㟾	山广󰁬丨
㟿	山艹犬廾
㠀	󰁟灬山󰀬
㠁	山厶厶彡
㠂	山󰁡攵
㠃	山亠丷古
㠄	山羽白󰀘
㠅	山彳𠂉夂
㠆	山口口十
㠇	山󰁸小丶
㠈	山門王󰀝
㠉	山立日土
㠊	山虍业󰀝
㠋	山口口ㄅ
㠌	山󰀎八人
㠍	山亻󰁷木
㠎	山亻󰁷木
㠏	山艹一󰀟
㠐	山丿大口
㠑	山罒丨三
㠒	山覀二刂
㠓	山艹冖󰀓
㠔	山尸口辛
㠕	山阝丿厶
㠖	山丷王丶
㠗	山丿ㄇ大
㠘	山󰀗一八
㠙	山󰁸冖󰀓
㠚	山业丷寸
㠛	山艹亻又
㠜	山匕𠂉󰁾
㠝	山夫夫貝
㠞	彳山一山
㠟	山禾勹氺
㠠	山虍田皿
㠡	山亠󰀋󰀔
㠢	山白󰁜󰀔
㠣	山厂禾止
㠤	山亠口󰀔
㠥	山田田土
㠦	山山三䒑
㠧	山广木三
㠨	山木乂寸
㠩	人󰄃󰀸󰀅
㠪	一上󰀌
㠫	工几丶夫
㠬	工口夫󰁧
㠭	工工工工
㠮	䒑业日工
㠯	󰃧丨󰁈一
㠰	力口己󰀅
㠱	己󰀎八󰁧
㠲	冂丨匕󰁀
㠳	丿󰂃冂丨
㠴	冂丨刀丶
㠵	亠󰄃冂丨
㠶	冂丨丿几
㠷	冂丨乃󰂃
㠸	冂丨夫󰁶
㠹	冂丨人󰀯
㠺	冂丨小丿
㠻	土丿冂丨
㠼	冂丨斤󰀢
㠽	冂丨夂󰁦
㠾	夕⺋冂丨
㠿	止匕冂丨
㡀	㡀丶丿丶
㡁	冂丨大ㄅ
㡂	一夕刂丨
㡃	冂丨人󰀸
㡄	冂丨勹日
㡅	冂丨夕夕
㡆	冂丨亠󰀸
㡇	冂丨耳乚
㡈	冂丨⺈󰁜
㡉	冂丨弓幺
㡊	冂丨⺈臼
㡋	冂丨大乚
㡌	冂丨󰀰月
㡍	白大冂丨
㡎	冂丨厶彡
㡏	冂丨人刂
㡐	冂丨䒑刂
㡑	禾火冂丨
㡒	冂丨⺁目
㡓	冂丨冖車
㡔	󰁻乛亅丨
㡕	冂丨艹大
㡖	冂丨丿土
㡗	冂丨⺁几
㡘	冂丨䒑八
㡙	冂丨丿匕
㡚	冂丨󰀀土
㡛	冂丨艹󰀸
㡜	冂丨󰁯小
㡝	冂丨夂辶
㡞	冂丨󰀻女
㡟	冂丨一日
㡠	冂丨癶䒑
㡡	冂丨厂寸
㡢	冂丨日󰁡
㡣	亠丷冖三
㡤	冂丨业未
㡥	冂丨爫心
㡦	冂丨宀貝
㡧	冂丨宀䒑
㡨	冂丨人󰀞
㡩	言糹糹丨
㡪	冂丨爫夂
㡫	幺日勹󰄃
㡬	幺幺戈󰁡
㡭	幺幺一󰄃
㡮	幺幺戈气
㡯	广丿七󰁫
㡰	广一󰀛󰀵
㡱	广ク󰂃󰀦
㡲	广戈󰀦
㡳	广󰁚󰀁󰁫
㡴	广立󰀌
㡵	广人丶󰁻
㡶	广口八󰀦
㡷	广木一󰀌
㡸	广𠂉丨二
㡹	广󰀐一󰀌
㡺	广日一󰀌
㡻	广󰁚丿卩
㡼	广日󰁒丿
㡽	广󰁬󰀟󰀵
㡾	广艮󰀦
㡿	广䒑凵丿
㢀	广木冂󰁫
㢁	广夕夕󰀦
㢂	广丿󰃧󰀌
㢃	广丶艮󰀦
㢄	广一口䒑
㢅	广王廾󰀵
㢆	广日土󰀌
㢇	广言󰀌
㢈	广亻󰁷󰀌
㢉	广禾丿七
㢊	广大丁口
㢋	广亻夕夕
㢌	广阝丁口
㢍	广艹ㄇ大
㢎	广丿十臼
㢏	广人一刂
㢐	广ㄇ󰁈口
㢑	广亻󰁷十
㢒	广虍󰀐一
㢓	广立早󰀵
㢔	广彳人󰁾
㢕	广󰁲丿󰁷
㢖	广丿米田
㢗	广丿大口
㢘	广䒑󰁬灬
㢙	广廿口力
㢚	广虍田力
㢛	广人一人
㢜	广廿田心
㢝	广󰁢灬禾
㢞	广羽田八
㢟	󰀥󰄃廴󰁫
㢠	冂口廴󰀌
㢡	爿󰁝寸廾
㢢	⺌冂口廾
㢣	艹勹口廾
㢤	十󰀁󰁡丶
㢥	冂一口丶
㢦	丁口丁丶
㢧	弓一󰀌
㢨	弓干󰀢
㢩	弓勹丶󰁶
㢪	弓二ㄅ󰁀
㢫	弓山󰀢
㢬	弓厶󰁶
㢭	弓󰀥又󰁶
㢮	弓𠂉也󰁀
㢯	弓󰁂󰀁󰁀
㢰	弓皮󰁶
㢱	弓厶小󰁶
㢲	弓弓一八
㢳	弓𠂉󰀕󰁶
㢴	弓囗󰁤丶
㢵	弓人一口
㢶	弓丆日󰀝
㢷	弓山夕󰁶
㢸	弓弓攵󰁶
㢹	弓辛󰀢
㢺	弓立女󰀝
㢻	弓禾女󰀝
㢼	弓㡀󰁶
㢽	弓耳弓󰁀
㢾	弓覀土󰀝
㢿	弓亻ユ大
㣀	弓十󰀣八
㣁	弓󰁺丿用
㣂	弓一口丨
㣃	弓亠厶弓
㣄	弓氵匚木
㣅	弓󰀄󰁜日
㣆	弓一八王
㣇	彑󰁤冂丨
㣈	彑󰁤冂丨
㣉	工彡󰁥
㣊	夂彡󰁣
㣋	二󰀯丶彡
㣌	󰀥口彡󰁥
㣍	厶口彡󰁥
㣎	白小彡󰁣
㣏	大早彡󰁥
㣐	白水彡󰁥
㣑	广󰁬月彡
㣒	丷󰀺日彡
㣓	󰀥夕又彡
㣔	彳丁󰀢
㣕	彳大󰁶
㣖	彳大丶󰁶
㣗	彳丶尸󰁥
㣘	彳勹口󰀝
㣙	彳由󰀝
㣚	彳冂一口
㣛	彳人一口
㣜	彳一廾刂
㣝	彳戈󰁥
㣞	彳八厶儿
㣟	彳士口󰀝
㣠	彳丨夂󰁦
㣡	彳亻口丨
㣢	彳丷弓丿
㣣	彳大人人
㣤	彳戈戈󰁶
㣥	彳亻土寸
㣦	彳禾女󰀝
㣧	彳幺月乚
㣨	彳女古󰀝
㣩	彳木木󰁶
㣪	彳爫一又
㣫	彳丿一土
㣬	彳口耳󰀝
㣭	彳乂凵夂
㣮	彳十冂十
㣯	彳尸⺌月
㣰	彳丿米心
㣱	彳貝󰁶
㣲	彳山一攵
㣳	彳𠂉一灬
㣴	彳󰁺由八
㣵	彳土羊辶
㣶	彳亠囗一
㣷	彳宀心丁
㣸	彳业󰀓
㣹	彳广亻心
㣺	忄丶󰀦
㣻	乂心󰁧
㣼	忄刀丶󰁶
㣽	女心󰁧
㣾	忄又丶󰁶
㣿	忄勹丶󰁶
㤀	丿󰂃󰄃心
㤁	一大心󰁧
㤂	乃󰂃心󰁧
㤃	忄方󰁥
㤄	忄一冂丨
㤅	󰀄󰁜心󰁧
㤆	忄⺁又󰁶
㤇	忄丿大󰁶
㤈	忄心󰁶
㤉	忄󰀄亅丿
㤊	忄乂乂󰁶
㤋	忄八刀󰁥
㤌	忄甘󰀝
㤍	工一ㄅ心
㤎	力口心󰁧
㤏	忄夂󰁦󰁶
㤐	󰀥口心󰁧
㤑	忄口󰀝
㤒	忄大十󰀢
㤓	忄木一󰀝
㤔	忄亻寸󰁶
㤕	忄凵山󰀢
㤖	忄宀丁󰀢
㤗	三人⺗󰁧
㤘	忄⺈彐󰀝
㤙	囗󰁃心󰁧
㤚	忄彳一丁
㤛	忄亻丿土
㤜	忄戈人󰁶
㤝	忄亠厶儿
㤞	忄宀丿七
㤟	ㄇ󰁺心󰁧
㤠	一夕刂心
㤡	忄一夕刂
㤢	忄月󰀝
㤣	䒑廾心󰁧
㤤	忄日乂󰁶
㤥	忄亠ㄥ人
㤦	忄一口乂
㤧	忄⺁一口
㤨	忄󰁺八󰁶
㤩	夂口心󰁧
㤪	一夕⺋心
㤫	月心󰁧
㤬	忄土土󰀝
㤭	忄丿大󰀯
㤮	犭󰁥王心
㤯	忄冂八口
㤰	亻𠂉丨心
㤱	忄一口䒑
㤲	大人人心
㤳	忄丆卜口
㤴	忄耳乚󰁀
㤵	孑攵心󰁧
㤶	忄乚丶
㤷	忄人丶口
㤸	忄土󰁖󰁶
㤹	忄一氺丶
㤺	忄亠󰄃󰀸
㤻	󰁚丶丿心
㤼	忄土厶力
㤽	忄三丿寸
㤾	忄冖八木
㤿	忄大日乚
㥀	忄十󰀣󰀝
㥁	十罒󰄃心
㥂	忄日一寸
㥃	忄門󰀝
㥄	忄土八夂
㥅	忄爫冖又
㥆	忄󰁬氺󰁶
㥇	忄戈戈󰁶
㥈	冂丨󰀥心
㥉	忄立口󰀝
㥊	忄月月󰀝
㥋	亻亠󰀔心
㥌	忄勹米󰁶
㥍	忄󰀎八󰁶
㥎	禾勹丿心
㥏	忄ㄇ󰁺八
㥐	人一口心
㥑	丆󰀐冖心
㥒	忄爫木󰁶
㥓	忄大丁口
㥔	忄亠厶月
㥕	火火心󰁧
㥖	󰀼亠八心
㥗	忄日文󰁶
㥘	忄土厶丶
㥙	忄口丨心
㥚	忄臼人󰁶
㥛	忄了口一
㥜	忄田月󰀝
㥝	忄弓耳󰀝
㥞	忄䒑󰀓󰁶
㥟	忄彑󰀓󰁶
㥠	忄乛󰁾月
㥡	忄尸匕木
㥢	忄丷西一
㥣	大土土心
㥤	󰁻乛亅心
㥥	忄日冂丶
㥦	匚大人心
㥧	忄丆貝󰁶
㥨	女土土心
㥩	忄土丿日
㥪	忄米女󰀝
㥫	忄󰁸日󰀝
㥬	忄亠丷方
㥭	忄三人氺
㥮	忄勹凵丿
㥯	爫工彐心
㥰	忄臼丨又
㥱	忄匚丨三
㥲	十󰀣八心
㥳	忄厂白小
㥴	忄⺁虍几
㥵	忄囗一󰀓
㥶	宀󰀀八心
㥷	广大人心
㥸	󰁂󰀁田心
㥹	米八刀心
㥺	忄土厶皿
㥻	戊丿朩心
㥼	忄一止灬
㥽	忄貝󰁶
㥾	忄匚艹口
㥿	󰁡攵心
㦀	忄夂三辶
㦁	車辶心󰁧
㦂	⺌冖口心
㦃	忄立丿
㦄	广木木心
㦅	忄廿儿丨
㦆	忄虍丿󰀛
㦇	忄󰁙󰁴匕
㦈	忄丷王皿
㦉	忄士冖䒑
㦊	忄艹一󰀟
㦋	忄大土日
㦌	毛毛毛心
㦍	忄口口丿
㦎	忄󰁬土一
㦏	忄巳巳八
㦐	忄󰀁二丶
㦑	忄乛耳攵
㦒	忄罒言󰀝
㦓	忄󰁝犬灬
㦔	日月犬心
㦕	忄阝夂
㦖	忄門心󰁶
㦗	忄木木小
㦘	白方攵心
㦙	忄日冂心
㦚	辛心辛󰀢
㦛	󰀗一ㄅ心
㦜	忄艹亻又
㦝	豸白儿心
㦞	士乛工心
㦟	豸日土心
㦠	忄业丷寸
㦡	忄白幺木
㦢	忄⺮󰁮卩
㦣	彳󰁆口心
㦤	士冖一心
㦥	忄宀三心
㦦	忄門臼儿
㦧	忄丿土日
㦨	忄門木󰀹
㦩	忄阝爫心
㦪	忄言火又
㦫	忄丿土貝
㦬	忄罒糹󰁷
㦭	忄󰀙口人
㦮	二戈󰀦
㦯	戈厶󰀞󰀌
㦰	人人戈󰀦
㦱	一戈土󰀌
㦲	十戈󰁡󰁫
㦳	十戈土󰀌
㦴	戈夂口󰀌
㦵	丿未戈󰁶
㦶	戈一厶土
㦷	厶用戈󰁶
㦸	󰀥早戈󰁶
㦹	日一勹戈
㦺	厂二󰀖戈
㦻	羽白戈󰁶
㦼	三人臼戈
㦽	月戈巛
㦾	丶尸也󰁫
㦿	丶尸木󰀦
㧀	丶尸乃󰂃
㧁	丶尸土厶
㧂	丶尸田󰀌
㧃	扌󰁐丨󰀢
㧄	扌凵󰀢
㧅	扌刀󰁥
㧆	扌冂丨󰀢
㧇	扌冂一󰀝
㧈	扌弓󰁀
㧉	扌气󰁀
㧊	扌一冂丨
㧋	扌犬󰁶
㧌	扌毛󰁀
㧍	扌方󰁥
㧎	扌󰀄亅丿
㧏	扌冂乂󰁶
㧐	扌又又󰁶
㧑	扌丶力丶
㧒	扌宀八󰁶
㧓	扌⺁厶󰂃
㧔	扌戊󰁶
㧕	扌󰁚丿卩
㧖	扌丶尸乙
㧗	扌止匕󰁀
㧘	止匕手󰀬
㧙	扌心丿󰁥
㧚	扌一󰁐丶
㧛	〢𠂉丶手
㧜	扌匚冂丨
㧝	力口手󰀬
㧞	扌丿又
㧟	扌氵匚󰁀
㧠	扌厶小󰁶
㧡	扌亠ㄥ人
㧢	扌囗大󰁶
㧣	扌丿未󰁶
㧤	扌亠厶儿
㧥	扌丿土儿
㧦	扌勹日󰀝
㧧	扌亠厶󰀸
㧨	扌⺁一口
㧩	扌几一丨
㧪	扌⺈厂⺋
㧫	扌丆冂〢
㧬	工几丶手
㧭	工阝手󰀬
㧮	扌臼󰀝
㧯	扌土丿匕
㧰	扌丿󰄃小
㧱	人一口手
㧲	扌宀木󰁶
㧳	扌八刀手
㧴	扌丿扌丶
㧵	扌丆卜口
㧶	扌丿󰀽丿
㧷	扌一大口
㧸	扌󰁸了󰀢
㧹	扌日一寸
㧺	扌水日󰀝
㧻	扌一󰀓丶
㧼	白󰀔󰁶
㧽	扌囗古󰀝
㧾	扌勹󰁤心
㧿	扌人人󰁾
㨀	扌禾󰁬󰀝
㨁	扌十󰀣󰀝
㨂	扌木日󰀝
㨃	扌󰁸子󰀝
㨄	扌󰀼土口
㨅	扌艹冂人
㨆	扌木木󰁶
㨇	氵皮手󰀬
㨈	扌文󰀳󰀝
㨉	扌󰁂󰀁日
㨊	扌工月
㨋	扌土丿日
㨌	士冖手又
㨍	土土寸手
㨎	扌丆冂大
㨏	扌山火
㨐	扌亻口木
㨑	扌乂凵夂
㨒	扌大土土
㨓	扌宀八󰀟
㨔	扌戊一口
㨕	扌乃又皿
㨖	扌一厶攵
㨗	扌󰀥󰁬󰁾
㨘	扌小丿目
㨙	扌爫幺大
㨚	扌艹勹日
㨛	扌門人󰁶
㨜	扌虍文󰁶
㨝	扌尸⺌月
㨞	扌幺小
㨟	扌山一䒑
㨠	扌冖日六
㨡	扌囗一󰀓
㨢	扌厶月匕
㨣	扌八厶羽
㨤	扌匚亻󰁷
㨥	扌糹冂人
㨦	扌亻󰁷又
㨧	扌厶大田
㨨	扌󰁚丶田
㨩	扌广丿廴
㨪	扌日⺌儿
㨫	扌〢𠂉皿
㨬	扌土口󰀔
㨭	扌丶尸巴
㨮	扌白󰁚儿
㨯	扌󰁸孑阝
㨰	扌六厶󰀔
㨱	扌󰁝言󰀝
㨲	扌艹宀木
㨳	扌宀大口
㨴	扌十早乙
㨵	扌䒑月刀
㨶	扌󰁟灬󰁶
㨷	扌廿口
㨸	扌宀心山
㨹	扌三丨彐
㨺	扌廿冂丶
㨻	車斤手󰀬
㨼	田夂口手
㨽	扌一口刂
㨾	扌丷王󰀩
㨿	扌虍夂几
㩀	扌虍勹󰂃
㩁	扌宀亻󰁷
㩂	扌⺈用十
㩃	扌宀󰀀󰁦
㩄	扌山田心
㩅	扌一〢田
㩆	扌󰁸小丶
㩇	扌󰁬土一
㩈	扌宀八口
㩉	扌人一羽
㩊	扌爫罒寸
㩋	扌󰁬十󰀲
㩌	扌弓󰀯貝
㩍	扌⺮木冂
㩎	扌日月犬
㩏	扌󰀹土灬
㩐	扌⺮土寸
㩑	扌一大三
㩒	扌木木小
㩓	臼工几手
㩔	扌尸󰁺又
㩕	扌󰀙人󰁻
㩖	扌一田一
㩗	扌山亻乃
㩘	扌丷王丶
㩙	扌宀󰀀土
㩚	扌艹冖󰀓
㩛	扌囗一寸
㩜	扌匚丨皿
㩝	扌󰁸冖󰀓
㩞	扌火火木
㩟	扌宀󰀀朩
㩠	扌󰁙󰁴灬
㩡	扌石石石
㩢	扌艹罒人
㩣	扌羽冖車
㩤	扌甫方攵
㩥	扌十戈󰀞
㩦	扌亻󰁷口
㩧	扌日󰁺氺
㩨	扌三丨心
㩩	扌匕水貝
㩪	扌糹丆貝
㩫	扌斤斤貝
㩬	扌虍业戈
㩭	扌󰀗乂子
㩮	扌󰀗一手
㩯	扌𠂉母小
㩰	扌艹口木
㩱	扌爫罒寸
㩲	扌艹口󰁷
㩳	扌亻󰁷又
㩴	扌目目󰁷
㩵	扌虍一犬
㩶	扌⺮一乂
㩷	扌宀󰀀灬
㩸	扌田田亠
㩹	扌又又一
㩺	󰁴󰁴十又
㩻	⺈厂⺋又
㩼	夕夕十又
㩽	木口十又
㩾	丿士󰁺又
㩿	𠂉乙攵󰁶
㪀	一󰀛攵󰁶
㪁	人丶乛又
㪂	气󰀥又󰁶
㪃	丁口󰀥又
㪄	弓󰀯攵󰁶
㪅	一冂人又
㪆	󰁚󰀁丶又
㪇	丿土儿攵
㪈	土土󰀥又
㪉	人一口攵
㪊	󰁬丿口又
㪋	日干󰀥又
㪌	󰁻用󰀥又
㪍	十冖孑攵
㪎	大人人又
㪏	白丿十又
㪐	丶尸犬又
㪑	大日󰁐又
㪒	臼儿󰀥又
㪓	丿十丬又
㪔	木木󰀥又
㪕	󰀥早󰀥又
㪖	󰁭氺󰀥又
㪗	立口󰀥又
㪘	人一口攵
㪙	日木攵󰁶
㪚	󰁺日攵󰁶
㪛	󰀎八󰄃又
㪜	山丆冂又
㪝	木󰀹󰀥又
㪞	󰀰目󰀥又
㪟	󰁸日攵󰁶
㪠	䒑󰁬〢又
㪡	宀三丨又
㪢	臼丨又又
㪣	󰁸冂口攵
㪤	日艹󰀟攵
㪥	虍󰀐󰀞又
㪦	宀一由攵
㪧	人一口又
㪨	羊䒑口又
㪩	󰁬十󰀲又
㪪	一大丨又
㪫	󰀥冖一又
㪬	羽亻󰁷又
㪭	虍田皿又
㪮	󰀙口口又
㪯	文󰀟󰀬
㪰	文米󰁧
㪱	文⺈ㄇ大
㪲	󰁦十乛󰀅
㪳	󰁦十口󰀘
㪴	二儿󰁦十
㪵	丷󰀠󰁦十
㪶	丆日󰁦十
㪷	一口䒑十
㪸	󰀎八󰁦十
㪹	󰀻女󰁦十
㪺	大目目十
㪻	言糹糹十
㪼	丁口斤󰀢
㪽	一日斤󰀬
㪾	夂口斤󰀢
㪿	凵丿凵斤
㫀	日日斤󰀢
㫁	幺幺一斤
㫂	广廿灬斤
㫃	方人󰁶
㫄	二勹方󰁣
㫅	方人二󰀯
㫆	方人小󰁶
㫇	方人󰁦乛
㫈	方人󰁦口
㫉	方⺈厂⺋
㫊	方𠂉丁口
㫋	方𠂉冂土
㫌	方𠂉一止
㫍	方𠂉亻攵
㫎	方𠂉冖車
㫏	方𠂉覀女
㫐	日匕󰀅
㫑	日力󰁥
㫒	日廾󰀬
㫓	日𠂉乙󰁀
㫔	日上󰀘
㫕	日一儿󰀅
㫖	上日󰀘
㫗	日子󰀘
㫘	丆卜日󰀘
㫙	日夫󰁶
㫚	勹󰁤日󰀘
㫛	日口儿󰁀
㫜	日日一󰀝
㫝	日󰁚󰀁丶
㫞	日凵丨又
㫟	日几口󰀝
㫠	日丷󰀟󰀢
㫡	日夂󰁦󰁧
㫢	日土厶󰁶
㫣	日日乚󰀅
㫤	日丶𠃌󰀩
㫥	日夕口󰀝
㫦	亻丨夂日
㫧	日米󰁧
㫨	日宀女󰀝
㫩	十艹日󰀘
㫪	三人丨日
㫫	日一业󰀘
㫬	日勹日󰀝
㫭	日土寸󰁧
㫮	止匕日󰀘
㫯	日日一儿
㫰	日丶艮󰁶
㫱	日土󰁖󰁧
㫲	日十冖子
㫳	厂二󰀖日
㫴	日土丿子
㫵	日丨三三
㫶	日彐冖丨
㫷	󰀎八日󰀘
㫸	日一󰁬󰁾
㫹	日⺁󰁃斤
㫺	人人人日
㫻	日人一艹
㫼	日𠂉一刂
㫽	日󰁭氺󰁶
㫾	日⺌冂口
㫿	日亻󰁷󰀝
㬀	日󰁸子󰀝
㬁	日氵人口
㬂	日日冂丶
㬃	日厶口火
㬄	日厂土󰁖
㬅	日罒方󰁣
㬆	日󰁂󰀁日
㬇	日⺈ㄇ大
㬈	日日皿󰀝
㬉	日丆冂大
㬊	日爫一又
㬋	日亻ユ大
㬌	日亠日小
㬍	日甫寸󰁶
㬎	日幺幺灬
㬏	日一口丨
㬐	日一业日
㬑	日󰁸孑阝
㬒	日艹犬廾
㬓	日覀二小
㬔	日羽人彡
㬕	日礻󰁶羊
㬖	日丶尸口
㬗	日󰁝犬灬
㬘	日󰁬十󰀲
㬙	日爫丿灬
㬚	日亠厶攵
㬛	日人一羽
㬜	一厶土日
㬝	日丷󰀺日
㬞	日山日󰄃
㬟	勹󰁤丷日
㬠	日⺈彐灬
㬡	日󰀙人󰁻
㬢	日丷王丶
㬣	日业丷寸
㬤	日日幺灬
㬥	日凵山米
㬦	日艹亻又
㬧	日凵山小
㬨	日土󰁖󰁖
㬩	日三丨心
㬪	日日日彑
㬫	廿口丬日
㬬	日目目󰁷
㬭	日爫罒寸
㬮	日廿口󰁷
㬯	日󰄹月丶
㬰	日人󰀦
㬱	丿土儿日
㬲	一日乂皿
㬳	月𠂉十󰀢
㬴	月󰁺八󰁶
㬵	月六乂󰁶
㬶	月丿土口
㬷	月囗木󰁶
㬸	月艹亻ヒ
㬹	月⺈󰁬亅
㬺	月丷夫丨
㬻	月艹亠󰀸
㬼	月𠂉夂
㬽	月口口ㄅ
㬾	匚𠂉大月
㬿	月󰁸孑攵
㭀	月⺮工人
㭁	木乃󰁥
㭂	木小󰁶
㭃	木幺󰁶
㭄	木⺄十󰀢
㭅	木三󰀝
㭆	乃一木󰁧
㭇	木厶儿󰁀
㭈	木ユ人󰁶
㭉	艹木󰁧
㭊	木丿丨󰁈
㭋	木三丨󰀢
㭌	木丿󰀟󰀢
㭍	冫七木󰁧
㭎	木冂乂󰁶
㭏	木二𠃌丨
㭐	大一木󰁧
㭑	木未󰁶
㭒	木󰃧󰀝
㭓	木厶廾󰀢
㭔	木丿丷󰀛
㭕	木土厶󰁶
㭖	木亻󰀁丶
㭗	木皿󰀘
㭘	木人一口
㭙	木土寸󰁶
㭚	木𠂉󰀕󰁶
㭛	木⺁󰀕󰁶
㭜	木戈󰁥
㭝	木木九󰀅
㭞	木小丿力
㭟	󰁺八木󰁧
㭠	木丿土儿
㭡	木丿囗乂
㭢	木一廾刂
㭣	木门口󰀝
㭤	木󰁠一󰀝
㭥	木⺈贝󰁶
㭦	木宀丿七
㭧	丿󰁪木󰁧
㭨	木󰀄亅阝
㭩	木爫寸󰁶
㭪	木甫󰁶
㭫	木人人土
㭬	木一󰀓󰁶
㭭	木口力刂
㭮	木巛一夕
㭯	木耳乚󰁀
㭰	止匕木冂
㭱	木匚甲󰀢
㭲	木八人口
㭳	木土丿子
㭴	木〢又土
㭵	木勹田󰀝
㭶	木艹方󰁥
㭷	木田力󰁥
㭸	木⺈口丶
㭹	木弓亠幺
㭺	木大日乚
㭻	木⺌冂口
㭼	木水日󰀝
㭽	木广󰁚丶
㭾	木尸凵山
㭿	木日󰁚卩
㮀	木了󰀪凵
㮁	木乂月
㮂	目大木󰁧
㮃	木禾女󰀝
㮄	木二勹方
㮅	木亻󰁷󰀘
㮆	木人羊󰀢
㮇	木一大⺗
㮈	木大二小
㮉	木亻一大
㮊	木󰁻乛木
㮋	木月阝
㮌	木丆囗二
㮍	䒑月刂木
㮎	木丆卜皿
㮏	木木二小
㮐	木小丿目
㮑	木丿十臼
㮒	木覀土󰀝
㮓	木忄一一
㮔	木丿一土
㮕	木丆冂大
㮖	木廿󰀜󰀢
㮗	󰁻乛亅木
㮘	木󰁻乛攵
㮙	木口口ㄅ
㮚	󰀥囗人木
㮛	木日一󰁾
㮜	木匚爿士
㮝	木八人卩
㮞	木冫⺈口
㮟	木石木󰁶
㮠	木艹冖木
㮡	火匚󰁃木
㮢	木亻ユ大
㮣	󰁮󰀄󰁜木
㮤	宀八人木
㮥	木厶大田
㮦	木十冖小
㮧	木󰁞灬󰁶
㮨	木田八夂
㮩	木丿目心
㮪	木工几木
㮫	木宀三口
㮬	木八厶羽
㮭	木󰁻囗十
㮮	木三丨手
㮯	木囗一󰀓
㮰	木丿囗匕
㮱	木艹丿儿
㮲	木勹凵丿
㮳	木月䒑大
㮴	木臼丨又
㮵	木方𠂉亠
㮶	木䒑凵月
㮷	木乚日
㮸	木䒑大辶
㮹	木一厶攵
㮺	木一口口
㮻	木又丶虫
㮼	木丶尸羽
㮽	木丿󰁪又
㮾	丶󰁮月木
㮿	木日艹󰀟
㯀	木方𠂉󰁾
㯁	木阝立口
㯂	木廿儿丨
㯃	木木人氺
㯄	木木⺁巴
㯅	木广白十
㯆	木立丿
㯇	木丨三土
㯈	木木口辶
㯉	木虍丿󰀛
㯊	木一止灬
㯋	匕木丆貝
㯌	木一󰀓辶
㯍	木爿󰁝寸
㯎	木言木󰁶
㯏	士󰁅几木
㯐	阝工木
㯑	木弓󰀍󰀖
㯒	木爫目儿
㯓	木人一羽
㯔	毛毛毛木
㯕	木󰀎八斤
㯖	木十罒心
㯗	木門木󰁶
㯘	木士二人
㯙	木亠厶攵
㯚	木⺮人口
㯛	木士冖一
㯜	木艹亠十
㯝	木口止口
㯞	木糹口月
㯟	木木󰁭氺
㯠	木亠幺󰀟
㯡	木人氺巳
㯢	木巳巳八
㯣	木艹八木
㯤	木人人人
㯥	木日木日
㯦	木󰀎八木
㯧	木土󰁾口
㯨	木覀米󰁶
㯩	又又又人
㯪	木󰀙人󰁻
㯫	木虍一󰀓
㯬	木木󰁬廴
㯭	木虍田力
㯮	木罒勹虫
㯯	木夂㐄貝
㯰	木罒十󰀣
㯱	一口丨木
㯲	木木木小
㯳	木艹勹攵
㯴	木艹宀口
㯵	木艹丿土
㯶	木󰁘凵夂
㯷	木亻业夫
㯸	木󰁬丨皿
㯹	木覀二寸
㯺	匚丨󰁃木
㯻	一口丨木
㯼	木艹土皿
㯽	木宀󰁅貝
㯾	木一ㄇ辶
㯿	木巛囗󰁒
㰀	木禾勹氺
㰁	木石石石
㰂	木宀丿田
㰃	木白冂小
㰄	木貝戈戈
㰅	木亠丷辶
㰆	一口丨木
㰇	木十戈󰀞
㰈	木木車辶
㰉	木一厶禾
㰊	木土八火
㰋	木止󰀤貝
㰌	木󰀙亻󰁷
㰍	立月一木
㰎	木山亻𠃌
㰏	木⺮󰁸口
㰐	木阝辶
㰑	木心心木
㰒	木󰀗乂子
㰓	木匚丨貝
㰔	木言火又
㰕	木丷王丶
㰖	木匚丨儿
㰗	木戊上󰁾
㰘	木彑米廾
㰙	木廿口󰁷
㰚	木亠乂󰁷
㰛	木艹白木
㰜	木十󰀣貝
㰝	󰁂⺈人󰁶
㰞	山⺈人󰁶
㰟	气⺈人󰁶
㰠	亠几⺈人
㰡	人󰀯⺈人
㰢	一廾⺈人
㰣	止󰁴⺈人
㰤	丁口⺈人
㰥	廿󰄃⺈人
㰦	土厶⺈人
㰧	厶口⺈人
㰨	口八⺈人
㰩	虫⺈人󰁶
㰪	土土⺈人
㰫	丿土儿人
㰬	勹日⺈人
㰭	大二ㄅ人
㰮	厂二󰀖人
㰯	一口䒑人
㰰	大人人人
㰱	丿一日人
㰲	戈口󰀞人
㰳	一󰀚󰀞人
㰴	立口⺈人
㰵	亠人人人
㰶	夂卜口人
㰷	一夕󰁴人
㰸	人一口人
㰹	戊一口人
㰺	󰁃丨二人
㰻	士口䒑人
㰼	匚大人人
㰽	匚日女人
㰾	白方⺈人
㰿	爫幺大人
㱀	勹凵丿人
㱁	凵山二人
㱂	广󰁬氺人
㱃	人丶乛人
㱄	󰀹土灬人
㱅	士冖一人
㱆	虍一口人
㱇	土人人人
㱈	木木二人
㱉	业䒑未人
㱊	丆󰀐冖人
㱋	󰀙亻󰁷人
㱌	耳耳耳人
㱍	言糹糹人
㱎	罒󰀫󰁢人
㱏	二止󰀘
㱐	二止丶󰀦
㱑	止夕󰁧
㱒	止丁口󰀘
㱓	止人丶󰁻
㱔	止匕夕󰁧
㱕	止彐冖丨
㱖	止亠人十
㱗	止丿目犬
㱘	厂日月止
㱙	一夕一ㄅ
㱚	一夕月󰀝
㱛	一夕一夕
㱜	一夕󰁾󰁶
㱝	一夕󰁴力
㱞	一夕立󰀝
㱟	一夕皮󰁶
㱠	一夕古󰀝
㱡	一夕丿儿
㱢	一夕丶艮
㱣	一夕爫女
㱤	一夕木斤
㱥	一夕土夂
㱦	一夕大口
㱧	一夕宀⺋
㱨	一夕宀󰁾
㱩	一夕十大
㱪	一夕󰁂日
㱫	一夕木󰀹
㱬	一夕田󰀖
㱭	一夕丿又
㱮	一夕口贝
㱯	一夕山䒑
㱰	一夕宀辛
㱱	一夕白厶
㱲	一夕䒑皿
㱳	艹日大夕
㱴	一夕貝
㱵	一夕十貝
㱶	一夕士彡
㱷	一夕亻木
㱸	一夕尸辛
㱹	一夕厂止
㱺	一夕虍皿
㱻	一夕󰄹丶
㱼	󰁂几又󰁶
㱽	冖󰁜几又
㱾	亠ㄥ丿又
㱿	士冂一又
㲀	厂二󰀖又
㲁	宀八工又
㲂	⺌冂口又
㲃	󰀥日󰁴又
㲄	士冖王又
㲅	宀三丨又
㲆	士󰁅几󰁻
㲇	士󰁅几󰁦
㲈	士󰁅几口
㲉	士冖一又
㲊	󰀥冖一又
㲋	⺈口󰁴匕
㲌	毛乃󰀏
㲍	十又毛󰁫
㲎	毛毛󰁀
㲏	丿丨一毛
㲐	毛人丶乛
㲑	毛水󰀦
㲒	勹口毛󰁀
㲓	毛戈人󰀦
㲔	辛毛󰁀
㲕	爫寸毛󰁀
㲖	⺌月毛󰁀
㲗	爫孑毛󰁀
㲘	貝毛󰁀
㲙	毛亠厶󰀸
㲚	氵小丿毛
㲛	𠂉大口毛
㲜	火火毛󰁀
㲝	毛亻󰁷󰀌
㲞	亠人人毛
㲟	艹ㄇ大毛
㲠	未攵毛󰀅
㲡	木二小毛
㲢	丶尸冂毛
㲣	臼丨又毛
㲤	亠口一毛
㲥	广󰁬丨毛
㲦	十早人毛
㲧	毛又丶虫
㲨	艹耳毛󰁀
㲩	毛日羽󰀌
㲪	癶一口毛
㲫	业䒑夫毛
㲬	亻󰁷灬毛
㲭	火火火毛
㲮	毛⺮人口
㲯	匚丨󰁃毛
㲰	宀心皿毛
㲱	毛巛囗󰁒
㲲	又又又毛
㲳	󰁚󰀁丶夫
㲴	气口丨󰀵
㲵	气⺌月󰀌
㲶	气󰀥囗󰁘
㲷	气口口十
㲸	氵乙󰁀
㲹	氵几󰁀
㲺	氵七󰁀
㲻	亻水󰁶
㲼	氵乂󰁶
㲽	氵刀丶󰁶
㲾	宀水󰁧
㲿	氵广󰁥
㳀	氵戈󰁶
㳁	氵厂人󰁶
㳂	氵八厶󰁶
㳃	氵九十󰀢
㳄	氵⺈人󰁶
㳅	氵丆卜󰁶
㳆	氵󰁦十󰀢
㳇	氵八乂󰁶
㳈	氵十儿󰁀
㳉	氵月󰀝
㳊	氵攵󰁶
㳋	氵丘󰀝
㳌	氵甲󰀢
㳍	氵冂丨
㳎	氵厶廾󰀢
㳏	氵口乂󰁶
㳐	氵木乚󰁀
㳑	氵皿󰀝
㳒	氵大厶󰁶
㳓	氵口󰀝
㳔	氵又寸󰁶
㳕	氵丷三󰀝
㳖	氵亠󰀔󰁶
㳗	氵又丶土
㳘	氵亠厶儿
㳙	氵厶月󰀝
㳚	氵戈人󰁶
㳛	氵臼人󰁶
㳜	氵亻木󰁶
㳝	氵亻丿士
㳞	氵亻口丨
㳟	󰁺八氺󰁧
㳠	氵大辶󰁶
㳡	氵寸辶󰁶
㳢	氵丿大󰀯
㳣	氵土丿匕
㳤	氵廾灬󰁶
㳥	氵王廾󰀢
㳦	氵戈廾󰀢
㳧	氵耳乚󰁀
㳨	氵巛一夕
㳩	氵工󰀼亠
㳪	氵丆卜口
㳫	水臼󰀘
㳬	氵𠂉乛󰁾
㳭	氵口木󰁶
㳮	氵尸水󰁶
㳯	氵辛󰀢
㳰	氵亠厶廾
㳱	氵阝日󰀝
㳲	氵氵大丶
㳳	氵十口儿
㳴	氵心丿土
㳵	氵禾子󰀝
㳶	氵爫孑乚
㳷	氵勹󰁤日
㳸	氵艹亻ヒ
㳹	氵木王󰀝
㳺	氵扌𠂉子
㳻	氵󰁺日󰀝
㳼	戈口󰀞水
㳽	氵弓𠂉小
㳾	氵⺶乚󰁀
㳿	氵亠厶木
㴀	氵艹丿之
㴁	氵一大󰀯
㴂	氵工冂土
㴃	氵丶尸水
㴄	氵囗八ㄇ
㴅	水囗八口
㴆	氵彐冖丨
㴇	水水水󰁶
㴈	氵丘山󰀢
㴉	氵厶厶二
㴊	氵䒑凵刂
㴋	氵󰁬丨八
㴌	氵女古󰀝
㴍	氵了三󰀩
㴎	氵大二小
㴏	氵宀八王
㴐	氵目一ㄅ
㴑	氵广䒑丿
㴒	氵亠󰁖廾
㴓	氵田心󰁶
㴔	氵⺈彐心
㴕	氵艹禾󰁶
㴖	氵廿󰀜󰀢
㴗	氵覀女󰀝
㴘	氵󰀰目󰀝
㴙	氵丿十臼
㴚	氵䒑󰀓󰁶
㴛	氵一厶攵
㴜	氵丶尸艹
㴝	禾刂人水
㴞	氵爫丨日
㴟	氵厂日子
㴠	氵了口凵
㴡	氵禾日󰀝
㴢	氵氵亻丨
㴣	氵氵一人
㴤	氵木丶王
㴥	氵山⺌月
㴦	氵宀口口
㴧	氵丿目心
㴨	氵月䒑大
㴩	氵巛口巴
㴪	氵丿目木
㴫	氵󰁬丿阝
㴬	氵丿󰀽寸
㴭	氵宀八目
㴮	氵尸⺌月
㴯	氵月匕日
㴰	氵厶月匕
㴱	氵宀八丷
㴲	氵⺁虍几
㴳	氵土丶
㴴	氵火一󰄃
㴵	氵心丿皿
㴶	氵冖亻󰁷
㴷	氵耳冖󰁜
㴸	氵門人󰁶
㴹	氵米辶󰁶
㴺	氵氵大人
㴻	氵一口寸
㴼	氵宀亻日
㴽	氵丿米心
㴾	氵十冖攵
㴿	氵丁丆貝
㵀	氵方𠂉大
㵁	氵艹亠󰀸
㵂	氵广廿灬
㵃	氵虫宀匕
㵄	氵戈口大
㵅	氵人丶貝
㵆	氵日丿口
㵇	氵丿古甘
㵈	氵氵女古
㵉	氵氵木木
㵊	氵日耳又
㵋	氵罒貝󰁶
㵌	氵彳⺁目
㵍	氵門心󰁶
㵎	氵門月󰀝
㵏	氵艹亠十
㵐	氵厂䒑人
㵑	氵力口貝
㵒	氵弓󰀯貝
㵓	氵宀日󰁾
㵔	氵大土日
㵕	氵厶厶⺗
㵖	氵女口小
㵗	冫󰀋灬水
㵘	水水水水
㵙	氵士口口
㵚	氵八乂金
㵛	氵羊䒑口
㵜	氵氵十十
㵝	氵亠󰀔口
㵞	氵禾火心
㵟	氵彳山攵
㵠	氵宀八山
㵡	氵󰀙勹巳
㵢	氵󰀙田󰀝
㵣	氵日勹人
㵤	氵羽大人
㵥	氵宀心皿
㵦	氵工辶
㵧	氵艹日󰄃
㵨	尸口辛水
㵩	氵艹廿木
㵪	氵丷王人
㵫	氵子孑日
㵬	氵月乃皿
㵭	氵土丿灬
㵮	氵大廿󰀟
㵯	氵几一灬
㵰	氵󰀗一八
㵱	氵覀二寸
㵲	氵𠂉一㐄
㵳	氵宀羽彡
㵴	氵戈爿丨
㵵	氵耳又乑
㵶	氵十戈󰁷
㵷	辛氵辛󰀢
㵸	氵人一艹
㵹	氵山艹大
㵺	氵⺮白十
㵻	氵月臼又
㵼	氵冖臼灬
㵽	氵田田田
㵾	氵月儿
㵿	氵白白白
㶀	氵月羽彡
㶁	氵爫寸几
㶂	氵氵󰁺八
㶃	氵氵𠂉灬
㶄	氵門⺈臼
㶅	氵󰀗乂子
㶆	氵言土日
㶇	氵木󰁺八
㶈	氵火火虫
㶉	氵爫幺一
㶊	氵匚丨貝
㶋	氵业󰀓
㶌	氵耳幺一
㶍	氵󰁢灬羊
㶎	氵罒一辶
㶏	氵阝爫心
㶐	氵广亻心
㶑	氵人一人
㶒	氵門󰀋灬
㶓	氵艹戈丨
㶔	氵罒罒大
㶕	氵⺮門日
㶖	氵亻丨灬
㶗	𠂉母幺水
㶘	氵⺮覀早
㶙	氵氵业
㶚	氵覀廿月
㶛	氵方𠂉八
㶜	氵尸䒑刂
㶝	氵氵广心
㶞	氵日亠󰀔
㶟	氵田田小
㶠	氵󰀋灬十
㶡	几火󰀦
㶢	火九󰀅
㶣	干火󰁧
㶤	火夕󰁶
㶥	火干󰀢
㶦	火󰁻乛亅
㶧	火冂人󰁶
㶨	丆卜灬󰁧
㶩	火冖󰁜󰁀
㶪	丆卜火󰁧
㶫	大丷火󰁧
㶬	火一木󰁶
㶭	火幺力󰁥
㶮	一冂人火
㶯	火󰁚丿卩
㶰	火甘󰀝
㶱	火木一󰀝
㶲	火用󰀢
㶳	󰁬󰀟火󰁧
㶴	火夕夕󰁶
㶵	亻丿士灬
㶶	火冖󰀔󰁶
㶷	火勹日󰀝
㶸	火力力力
㶹	火工水󰁶
㶺	火一大口
㶻	夂三丨灬
㶼	火厶𠂉大
㶽	火口冂人
㶾	覀一火󰁧
㶿	火十冖子
㷀	火火⺄十
㷁	火󰁻用󰀢
㷂	匚丨󰁃火
㷃	火󰀍󰀖󰁧
㷄	火日木󰁶
㷅	耳又火󰁧
㷆	火丿󰃧十
㷇	夕夕火
㷈	火大日乚
㷉	尸二火寸
㷊	木木灬󰁧
㷋	火火火󰁶
㷌	火彐冖丨
㷍	火人一艹
㷎	火日勹󰄃
㷏	禾𠂉十火
㷐	火臼土󰀝
㷑	火覀土󰀘
㷒	火日冂丶
㷓	火勹󰁤心
㷔	火爫丨日
㷕	丷西一火
㷖	日火刀口
㷗	丿󰃧巳火
㷘	火厶口木
㷙	火䒑月刂
㷚	火󰁸冖丁
㷛	亻口木灬
㷜	火亠󰁖大
㷝	火宀八犬
㷞	火厂日子
㷟	火丿󰃧辶
㷠	火火夕㐄
㷡	目匚󰁃火
㷢	⺶工火󰁧
㷣	火丷王󰀟
㷤	士冖一又
㷥	火火了一
㷦	耳火灬󰁧
㷧	火厂白小
㷨	火山夂丨
㷩	丿匚丨火
㷪	火亻󰁷乃
㷫	士󰁅几火
㷬	火艹日大
㷭	夂三丨火
㷮	火一ㄇ日
㷯	火土三󰀟
㷰	火亠乂厶
㷱	厶月土灬
㷲	火丿一力
㷳	厂亻亻火
㷴	厂禾禾火
㷵	火󰀹土灬
㷶	亻󰁺丿灬
㷷	火巳巳八
㷸	火日一󰀟
㷹	火艹󰀥早
㷺	⺈臼攵火
㷻	火𠂉一灬
㷼	廿口丬火
㷽	火羊䒑口
㷾	火虍一󰀓
㷿	火人一人
㸀	火󰁸冂土
㸁	火业䒑未
㸂	䒑󰀓辶火
㸃	󰀹土󰀥灬
㸄	火󰀴󰀳󰀝
㸅	火⺮󰁮卩
㸆	火丿土三
㸇	火夫夫貝
㸈	亻󰁷亻火
㸉	辛火火火
㸊	火木口貝
㸋	󰁝火丿田
㸌	火󰀙亻󰁷
㸍	火虍一戈
㸎	火耳耳耳
㸏	广木木火
㸐	廿口夫灬
㸑	󰀗ㄇ一火
㸒	爫丿士󰀘
㸓	爫日󰀘
㸔	丿丷目
㸕	⺁丨󰂃又
㸖	八乂󰀐一
㸗	八乂冂口
㸘	八乂罒丁
㸙	八乂土日
㸚	乂乂乂乂
㸛	爿刀口󰀝
㸜	爿宀八工
㸝	丿丨一人
㸞	丿丨一󰁈
㸟	丿丨一日
㸠	丿丨一󰀪
㸡	丿丨一未
㸢	丿丨一用
㸣	丿丨一未
㸤	辛丿丨辛
㸥	丿丨一丶
㸦	󰀄亅󰂃󰀦
㸧	󰀄亅丿艮
㸨	牜󰁐丨󰀢
㸩	牜干󰀢
㸪	牜川󰀢
㸫	牜斤󰀢
㸬	牜一冂丨
㸭	牜巴󰁀
㸮	牜八刀󰁥
㸯	牜󰁦十󰀢
㸰	牜宀匕󰁀
㸱	牜𠂉也󰁀
㸲	牜𠂉丨二
㸳	牜人丶󰁻
㸴	石丿󰀟󰀬
㸵	牜士口󰀝
㸶	牜囗大󰁶
㸷	三丨刀󰀟
㸸	牜⺁一口
㸹	牜爫寸󰁶
㸺	氵小丿󰀟
㸻	牜厶𠂉大
㸼	牜夂三丨
㸽	牜貝󰁶
㸾	牜刀丶心
㸿	牜士冖几
㹀	牜十冖子
㹁	牜󰁸小󰁶
㹂	匚丨󰁃󰀟
㹃	丨三丨󰀟
㹄	牜田八夂
㹅	牜勹󰁤心
㹆	牜冖車󰀢
㹇	牜日勹󰄃
㹈	未攵丿󰀟
㹉	牜厂白小
㹊	牜冖亻󰁷
㹋	牜亻丨彡
㹌	牜立丿
㹍	牜亠丷古
㹎	牜田幺小
㹏	牜廿口
㹐	彳人人󰀟
㹑	牜󰀁二丶
㹒	牜业䒑夫
㹓	牜土土儿
㹔	牜一田一
㹕	二儿丆󰀟
㹖	牜丷夫󰀓
㹗	牜士乛寸
㹘	牜󰀙丆〢
㹙	牜火火目
㹚	牜火火口
㹛	牜丆目夂
㹜	犬犬󰁶
㹝	犭󰁥󰁚󰀁
㹞	犭󰁥斤󰀢
㹟	犭󰁥ユ人
㹠	犭󰁥一乚
㹡	犭󰁥亠幺
㹢	犭󰁥力口
㹣	犭󰁥夂󰁦
㹤	犭󰁥土厶
㹥	犭󰁥丶王
㹦	犭󰁥刀口
㹧	犭󰁥ㄇ大
㹨	犭󰁥由󰀝
㹩	犭󰁥又土
㹪	犭󰁥󰀼一
㹫	犭󰁥一人
㹬	犭󰁥一乂
㹭	犭󰁥日丿
㹮	犭󰁥丆日
㹯	犭󰁥亻木
㹰	犭󰁥⺌儿
㹱	犭󰁥口󰁾
㹲	犭󰁥土子
㹳	犭󰁥五口
㹴	犭󰁥一乂
㹵	犭󰁥一工
㹶	犭󰁥丿廴
㹷	乂冂犬
㹸	犭󰁥白儿
㹹	犭󰁥广人
㹺	犭󰁥水日
㹻	犭󰁥禾女
㹼	犭󰁥勹米
㹽	犭󰁥戈戈
㹾	犭󰁥夂口
㹿	犭󰁥󰀥早
㺀	犭󰁥勹心
㺁	犭󰁥巛乂
㺂	犭󰁥戊口
㺃	犭󰁥艹口
㺄	犭󰁥人刂
㺅	犭󰁥⺈大
㺆	犭󰁥讠贝
㺇	犭󰁥匚犬
㺈	犭󰁥凵虫
㺉	士冖一又
㺊	犭󰁥丷心
㺋	犭󰁥八羽
㺌	犭󰁥䒑八
㺍	犭󰁥宀八
㺎	犭󰁥广丨
㺏	犭󰁥󰀻女
㺐	犭󰁥巛木
㺑	犭󰁥厶彡
㺒	犭󰁥羽彡
㺓	犭󰁥貝
㺔	犭󰁥爫灬
㺕	犭󰁥丿田
㺖	犭󰁥乛攵
㺗	犭󰁥口十
㺘	犭󰁥亻灬
㺙	犭󰁥宀贝
㺚	犭󰁥土辶
㺛	犭󰁥󰀋廾
㺜	犭󰁥ㄇ󰀖
㺝	犭󰁥匚皿
㺞	犭󰁥󰀗八
㺟	犭󰁥羽󰁷
㺠	犭󰁥宀󰂃
㺡	犭󰁥厂止
㺢	犭󰁥󰀙󰁷
㺣	犭󰁥虍戈
㺤	犭󰁥人󰀞
㺥	犭󰁥⺈丶
㺦	犭󰁥耳一
㺧	犭󰁥口口
㺨	王厶󰁶
㺩	王󰁐丨󰀢
㺪	王卜󰁶
㺫	王刂󰀢
㺬	王几丶󰁶
㺭	王子󰀝
㺮	王二ㄅ󰁀
㺯	王大󰁧
㺰	王一冂丨
㺱	亻乃王丶
㺲	王󰁈丨一
㺳	王󰀥又󰁶
㺴	王犬󰁶
㺵	王⺈人󰁶
㺶	王󰁦十󰀢
㺷	王木丶󰁶
㺸	亻几丶丶
㺹	王厶廾󰀢
㺺	王目󰀝
㺻	王一冂丨
㺼	王乛󰁾󰁶
㺽	王丆卜一
㺾	王冂口󰀝
㺿	王匚丨丨
㻀	王日乂󰁶
㻁	王囗口󰀝
㻂	王䒑廾󰀢
㻃	ㄇ󰁺王丶
㻄	王丿一󰁾
㻅	王人二厶
㻆	王厶月󰀝
㻇	王人王󰀝
㻈	王⺁一口
㻉	王止󰀤󰁥
㻊	王⺈口󰁜
㻋	王木口󰀝
㻌	王人一朩
㻍	王口一大
㻎	大王王󰀌
㻏	王彐火󰁶
㻐	王厶八夂
㻑	王禾子󰀝
㻒	王囗禾󰁶
㻓	王耳又󰁶
㻔	王丿士󰁺
㻕	王尸凵山
㻖	王󰁬氺󰁶
㻗	丨三丨丶
㻘	王宀日丨
㻙	王亠厶月
㻚	王月月󰀝
㻛	王日勹󰁤
㻜	王人人󰁾
㻝	王木口刂
㻞	王丶尸艹
㻟	王工月
㻠	王宀八犬
㻡	王廿󰄃木
㻢	王方𠂉也
㻣	王󰀎八󰄃
㻤	王艹勹口
㻥	王丷西一
㻦	王日冂丶
㻧	王夕㐄木
㻨	匚丨󰁃丶
㻩	王䒑󰁬八
㻪	王亻󰁷乃
㻫	王日艹󰀟
㻬	王󰀙二ㄅ
㻭	王亠幺十
㻮	王󰁯二小
㻯	王虍丿󰀛
㻰	王三丨彐
㻱	王夂三辶
㻲	王󰀻女󰀝
㻳	王艹禾刂
㻴	王日罒又
㻵	王尸子子
㻶	王⺮󰁬󰀟
㻷	王木冂冂
㻸	王󰀄󰁜日
㻹	石一󰀓丶
㻺	厂禾禾丶
㻻	王󰁸孑攵
㻼	王覀早󰀢
㻽	王亻󰁷𠃌
㻾	亠󰁲丿丶
㻿	王罒勹虫
㼀	王土䒑辶
㼁	王丷王丶
㼂	󰀗一ㄅ丶
㼃	王巛囗󰁒
㼄	王幺幺田
㼅	王广󰁺八
㼆	王火火丶
㼇	王山亻𠃌
㼈	王罒糹󰁷
㼉	⺁厶󰂃󰁜
㼊	一凵󰁐󰂃
㼋	古⺁厶󰂃
㼌	⺁厶丶󰂃
㼍	二木⺁󰂃
㼎	⺁厶󰂃乂
㼏	爫女⺁󰂃
㼐	丶尸冂󰂃
㼑	木󰀹⺁󰂃
㼒	⺁厶󰂃󰁤
㼓	⺁厶丶八
㼔	日皿⺁󰂃
㼕	⺌冖口󰂃
㼖	⺁厶丶虫
㼗	丁一󰁐丶
㼘	山一󰁐丶
㼙	冂丨一丶
㼚	亠几一丶
㼛	一廾一丶
㼜	ㄇ大一丶
㼝	夕⺋一丶
㼞	一丷十丶
㼟	白一󰁐丶
㼠	宀匕一丶
㼡	丿未一丶
㼢	匚丨口丶
㼣	丆日一丶
㼤	三丨刀丶
㼥	土丿一丶
㼦	工几丶丶
㼧	󰁻用一丶
㼨	人丶乛丶
㼩	戊𠃌一丶
㼪	大人人丶
㼫	日木一丶
㼬	土䒑十丶
㼭	土󰀥口丶
㼮	一󰁬丨丶
㼯	木日一丶
㼰	白丿十丶
㼱	丬匕冖丶
㼲	丆冂〢丶
㼳	小丿目丶
㼴	日冂丨丶
㼵	日一󰁾丶
㼶	人一月丶
㼷	山丆冂丶
㼸	宀八人丶
㼹	艹亠󰄃丶
㼺	广󰁬丨丶
㼻	彳人人丶
㼼	覀二小丶
㼽	大乂乂丶
㼾	󰁙󰁴󰁴丶
㼿	立日土丶
㽀	丷西一丶
㽁	厂禾禾丶
㽂	人一口丶
㽃	丿米田丶
㽄	󰀎八斤丶
㽅	癶一口丶
㽆	⺌冖口丶
㽇	󰀗乂乂丶
㽈	匕𠂉大丶
㽉	匚丨󰁃丶
㽊	言火火丶
㽋	言糹糹丶
㽌	󰀙󰁚丶丶
㽍	甘一󰁐丶
㽎	󰀎八󰄃󰁜
㽏	氵人一甘
㽐	甘䒑󰁬八
㽑	甘覀早󰀢
㽒	田力丿
㽓	丿丿
㽔	业󰀓丿
㽕	由󰀊󰀅
㽖	田力󰁥
㽗	田人󰁶
㽘	田亠几󰁀
㽙	田厶儿󰁀
㽚	田丿󰀟󰀬
㽛	田勹口󰀝
㽜	夕⺋田󰀘
㽝	一夕刂田
㽞	口口田󰀘
㽟	田爫寸󰁶
㽠	田大人人
㽡	田白丿十
㽢	田大日乚
㽣	田戈口󰀞
㽤	田勹米󰁶
㽥	田󰁻乛木
㽦	火火冖田
㽧	田䒑幺幺
㽨	田⺶工󰀝
㽩	田厶厶彡
㽪	田丷󰀺日
㽫	亠󰁲丿田
㽬	一口田田
㽭	田󰀙丆〢
㽮	田田田
㽯	田山亻口
㽰	月月乛󰁾
㽱	疒󰁐丨󰀵
㽲	疒一ㄅ󰁫
㽳	疒一󰀛󰀵
㽴	疒󰂃󰀦
㽵	疒土󰀌
㽶	疒己󰁫
㽷	疒水󰀦
㽸	疒冖󰁜󰁫
㽹	疒⺁又󰀦
㽺	疒丿󰁈又
㽻	疒十又󰀦
㽼	疒弓丨󰀵
㽽	疒古󰀌
㽾	疒凵山󰀵
㽿	疒⺁厶󰂃
㾀	疒土厶󰀦
㾁	疒木丶󰀦
㾂	疒厶口󰀌
㾃	疒宀匕󰁫
㾄	疒由󰀌
㾅	疒丿ㄅ丿
㾆	疒冂土󰀌
㾇	疒目󰀌
㾈	疒亻寸󰀦
㾉	疒人丶󰁻
㾊	疒木冂󰁫
㾋	疒亻木󰀦
㾌	疒丿土儿
㾍	疒丆冂〢
㾎	疒丨󰁎一
㾏	疒土土󰀌
㾐	疒一夕刂
㾑	疒人一口
㾒	疒女口󰀌
㾓	疒口月󰀌
㾔	疒口口󰀌
㾕	疒辛󰀵
㾖	疒日土󰀌
㾗	疒丶艮󰀦
㾘	疒一日乂
㾙	疒乂丨
㾚	疒止匕二
㾛	疒彐冖又
㾜	疒大人人
㾝	疒車󰀵
㾞	疒西一󰀌
㾟	疒止󰀤󰀏
㾠	疒犭󰁥王
㾡	疒土厶卩
㾢	疒木人人
㾣	疒金󰀌
㾤	疒宀八工
㾥	疒上小又
㾦	疒立口󰀌
㾧	疒日木󰀦
㾨	疒大丁口
㾩	疒丿十匕
㾪	疒小丿目
㾫	疒丶尸艹
㾬	疒󰁴匕白
㾭	疒禾火󰀦
㾮	疒白王󰀌
㾯	疒田一󰀖
㾰	疒古月󰀌
㾱	疒癶二儿
㾲	疒󰁡攵
㾳	疒冫⺈女
㾴	疒木日一
㾵	疒言十󰀵
㾶	疒󰀾月󰀌
㾷	疒⺁虍几
㾸	疒󰁸冂口
㾹	疒止匕木
㾺	疒󰀋灬󰀦
㾻	疒阝人朩
㾼	疒艮辶󰀦
㾽	疒丿󰃧辶
㾾	疒䒑󰁬八
㾿	疒丶󰁮阝
㿀	疒王丶王
㿁	疒白大十
㿂	疒山王攵
㿃	疒廿儿丨
㿄	疒匚𠂉又
㿅	疒彳止󰁾
㿆	疒禾亠󰀔
㿇	疒羽白󰀌
㿈	疒󰁲丿󰁷
㿉	疒口丨貝
㿊	疒󰀄儿日
㿋	疒口口木
㿌	疒人一人
㿍	疒⺈用󰀟
㿎	疒十艹貝
㿏	疒󰁬丿羊
㿐	疒土󰁾夕
㿑	疒羽亻󰁷
㿒	疒士乛寸
㿓	疒大人󰁾
㿔	疒田田田
㿕	疒門⺈臼
㿖	疒虍田皿
㿗	疒禾几貝
㿘	疒火火口
㿙	疒罒罒大
㿚	疒罒糹󰁷
㿛	疒一冂匕
㿜	疒丿目艹
㿝	白厶󰁧
㿞	白毛󰁀
㿟	白白󰀝
㿠	白⺌一儿
㿡	白儿󰀪󰁧
㿢	日月白󰀘
㿣	白日勹󰄃
㿤	白三人日
㿥	白冖亻󰁷
㿦	士󰁅几白
㿧	白士乛寸
㿨	白厂禾止
㿩	白⺌冖灬
㿪	皮九丶󰁶
㿫	󰁴匕皮󰁧
㿬	皮巴󰁀
㿭	斤丶皮󰁶
㿮	ㄇ大皮󰁶
㿯	人一口皮
㿰	六乂皮󰁶
㿱	扌斤皮󰁧
㿲	大丁口皮
㿳	皮巛田󰀝
㿴	大耳皮󰁶
㿵	皮丆冂大
㿶	亠丷冖皮
㿷	⺶工皮󰁶
㿸	皮日罒又
㿹	皮土羊辶
㿺	日󰁺八皮
㿻	干皿󰀘
㿼	一廾皿󰀘
㿽	八一ㄅ皿
㿾	宀丁皿󰀘
㿿	乛󰁾皿󰀘
䀀	氵⺋皿󰀘
䀁	月皿󰀘
䀂	宀女皿󰀘
䀃	一󰀓皿󰀘
䀄	宀心丿皿
䀅	礻󰁶土皿
䀆	󰁬丨一皿
䀇	古𠂉十皿
䀈	󰁮󰀄󰁜皿
䀉	丿大口皿
䀊	氵羽人皿
䀋	土𠂉󰀥皿
䀌	󰁬󰀟丆皿
䀍	立早夂皿
䀎	目一ㄅ󰁀
䀏	勹目󰀌
䀐	目彡󰁥
䀑	目又丶󰁶
䀒	目丿十󰀢
䀓	目九丶󰁶
䀔	目刀丶󰁶
䀕	目弓丨󰀢
䀖	目一大󰁶
䀗	目ユ人󰁶
䀘	目一廾󰀢
䀙	目七刀󰁥
䀚	目󰁚卩󰀬
䀛	目勹󰁤󰁥
䀜	勹󰁤目󰀘
䀝	目󰁴匕󰁀
䀞	目󰁦十󰀢
䀟	目弓󰀯󰀢
䀠	目目󰀝
䀡	目󰀥口󰀝
䀢	目𠂉大󰁶
䀣	目心丿󰁥
䀤	夕卜目󰀘
䀥	目丿󰄃小
䀦	目古󰀝
䀧	目󰁺八󰁶
䀨	目丿古󰀝
䀩	目夂口󰀝
䀪	目彳一丁
䀫	目人一口
䀬	目人王󰀝
䀭	目亠ㄥ人
䀮	目亠󰄃󰀸
䀯	目甫󰁶
䀰	目八人口
䀱	目夂三丨
䀲	目𠂉母󰁶
䀳	目木口󰀝
䀴	目一巛工
䀵	目厶𠂉大
䀶	目丶艮󰁶
䀷	目土厶力
䀸	扌斤目󰀘
䀹	目大人人
䀺	亻丨攵目
䀻	目由一ㄅ
䀼	目厂二󰀖
䀽	目丿󰀥廴
䀾	石又目󰀘
䀿	目扌斤󰀢
䁀	目扌斤󰀬
䁁	目󰁸小󰁶
䁂	匚丨󰁃目
䁃	目󰀔󰁶
䁄	目土䒑十
䁅	目子皿󰀝
䁆	目大日乚
䁇	宀心丿目
䁈	丶尸攵目
䁉	丶尸戈目
䁊	目又丶目
䁋	目廿󰄃木
䁌	目田月󰀝
䁍	目戊一口
䁎	目󰁸冖丁
䁏	目覀女󰀝
䁐	目艹ㄇ大
䁑	目日一󰁤
䁒	目口耳󰀝
䁓	目乂凵夂
䁔	目爫一又
䁕	目󰁂󰀁日
䁖	目米女󰀝
䁗	目山一䒑
䁘	目爫𠂉凵
䁙	目日宀女
䁚	目口貝󰁶
䁛	目白󰁜厶
䁜	目日⺌儿
䁝	火火冖目
䁞	人人人目
䁟	目⺶工󰀝
䁠	目䒑󰁬八
䁡	目門人󰁶
䁢	目方𠂉󰁾
䁣	目一日寸
䁤	目亠丷古
䁥	目匚艹口
䁦	目虍󰀐一
䁧	目艹口夫
䁨	目󰁸孑阝
䁩	目󰁢灬󰁶
䁪	目車斤󰀢
䁫	目󰀹土灬
䁬	目丷󰀺日
䁭	目犬犬犬
䁮	目󰀄󰁜日
䁯	目人一羽
䁰	目工丆貝
䁱	目土土儿
䁲	目罒貝󰁶
䁳	目艹犬廾
䁴	目亠囗一
䁵	目罒一󰀔
䁶	目白方攵
䁷	󰀗乂乂目
䁸	目ㄇ󰁺󰀖
䁹	目尸口辛
䁺	目罒土十
䁻	目白幺木
䁼	目󰀹土土
䁽	目巛囗󰁒
䁾	目艹罒人
䁿	󰀹土灬目
䂀	目丷王丶
䂁	目⺈口丶
䂂	目目目󰁷
䂃	目爫罒寸
䂄	目目目又
䂅	目言糹虫
䂆	󰁻乛亅丶
䂇	󰁻乛亅一
䂈	󰁻乛亅虫
䂉	󰁻乛亅大
䂊	󰁻乛亅󰀓
䂋	古㐄󰁻木
䂌	󰁻乛亅土
䂍	󰁻乛亅氺
䂎	󰁻乛亅貝
䂏	𠂉大刀口
䂐	𠂉大凵山
䂑	𠂉大止匕
䂒	𠂉大士口
䂓	𠂉大目儿
䂔	𠂉大土十
䂕	𠂉大彑󰀓
䂖	丆丶口󰀘
䂗	石ヒ󰁀
䂘	石又丶󰁶
䂙	石阝󰀢
䂚	石乂乂󰁶
䂛	石󰁻乛亅
䂜	石三丨󰀢
䂝	石戈󰁶
䂞	石木󰁧
䂟	力口石󰀘
䂠	石𠂉大󰁶
䂡	石丘󰀝
䂢	石夂󰁦󰁶
䂣	石止匕󰁀
䂤	石亻寸󰁶
䂥	石󰁂󰀁󰁀
䂦	石人彡󰁥
䂧	石⺈小󰁶
䂨	石斤丶󰁶
䂩	石囗大󰁶
䂪	石儿󰀪󰁶
䂫	石夂㐄󰀢
䂬	工几丶石
䂭	石六乂󰁶
䂮	三丨刀石
䂯	石广土󰀝
䂰	石禾刂󰀢
䂱	石丷口儿
䂲	土厶力石
䂳	石人人土
䂴	石言󰀝
䂵	石工贝󰁶
䂶	石土厶力
䂷	石丿十匕
䂸	石戈口󰀞
䂹	石󰁝火󰁶
䂺	石日木󰁶
䂻	石󰀍󰀖󰁶
䂼	石人丶心
䂽	石󰀥早󰀢
䂾	石木人人
䂿	石水日󰀝
䃀	石一󰁬女
䃁	石一󰀚一
䃂	石日󰁴匕
䃃	石冂䒑󰄃
䃄	石󰁸小󰁶
䃅	石丷日十
䃆	石󰀎八󰁶
䃇	石白冂丨
䃈	石󰁴匕白
䃉	石󰁂󰀁日
䃊	石艹󰀐一
䃋	石人一刂
䃌	石覀土󰀝
䃍	石䒑󰀓󰁶
䃎	石大夕夕
䃏	石日丿
䃐	石宀八犬
䃑	石丿󰁪又
䃒	石一口丨
䃓	石󰀀冂土
䃔	石宀口口
䃕	火火冖石
䃖	石󰁞灬󰁶
䃗	石󰁭氺刂
䃘	石匚丨土
䃙	石󰁙󰁴匕
䃚	石方𠂉大
䃛	石車辶󰀢
䃜	匚𠂉大石
䃝	石土丿攵
䃞	󰁸孑九石
䃟	石󰁺月攵
䃠	石方𠂉󰁾
䃡	石󰀄󰁜日
䃢	石釒⺈人
䃣	石爫丿灬
䃤	石󰁬十󰀲
䃥	石立日土
䃦	󰁸孑攵石
䃧	阝夂一石
䃨	石弓口虫
䃩	石ㄇ󰁺󰀖
䃪	石亠囗一
䃫	石⺈厂言
䃬	石山白厶
䃭	石戊一心
䃮	石土羊辶
䃯	石白󰀪木
䃰	石宀󰁯小
䃱	石十戈󰀞
䃲	石丿󰁪皿
䃳	石巛囗󰁒
䃴	石言土日
䃵	石亠󰀋󰀔
䃶	石亠罒󰀔
䃷	石󰄹月丶
䃸	石人人󰀞
䃹	石門木󰀹
䃺	石广木三
䃻	石󰀙廿月
䃼	礻󰁶卜󰁶
䃽	礻󰁶十又
䃾	礻󰁶󰁴匕
䃿	礻󰁶夫󰁶
䄀	礻󰁶戈󰁶
䄁	礻󰁶廿󰄃
䄂	礻󰁶由󰀝
䄃	礻󰁶ㄇ大
䄄	礻󰁶囗大
䄅	丷夫二小
䄆	礻󰁶丿古
䄇	礻󰁶口王
䄈	礻󰁶一䒑
䄉	礻󰁶丿丶
䄊	礻󰁶士心
䄋	礻󰁶大乚
䄌	礻󰁶又又
䄍	礻󰁶󰁺日
䄎	礻󰁶大口
䄏	礻󰁶艹大
䄐	凵山二巳
䄑	礻󰁶󰁚日
䄒	礻󰁶人心
䄓	礻󰁶白王
䄔	礻󰁶丿丶
䄕	礻󰁶水田
䄖	礻󰁶人刂
䄗	礻󰁶󰀲一
䄘	礻󰁶亠方
䄙	礻󰁶冖六
䄚	礻󰁶一日
䄛	礻󰁶󰀻女
䄜	礻󰁶亠厶
䄝	礻󰁶三臼
䄞	礻󰁶󰁯小
䄟	毛毛毛小
䄠	礻󰁶亠一
䄡	礻󰁶⺈言
䄢	礻󰁶󰀴󰀳
䄣	礻󰁶士貝
䄤	礻󰁶木貝
䄥	礻󰁶󰀙人
䄦	禾了󰀢
䄧	禾乃󰁥
䄨	禾一󰀛󰀢
䄩	禾󰀁丶󰁶
䄪	禾勹丶󰁶
䄫	禾己󰁀
䄬	禾也󰁀
䄭	禾丿十󰀢
䄮	禾夫󰁶
䄯	禾一廾󰀢
䄰	禾󰀄亅丿
䄱	禾方󰁥
䄲	禾冂人󰁶
䄳	禾止󰀝
䄴	禾月󰀝
䄵	禾㐄󰀬
䄶	禾弓󰀯󰀢
䄷	禾石󰀝
䄸	禾白󰀝
䄹	禾人丿十
䄺	禾一弓人
䄻	禾儿󰀪󰁶
䄼	禾一囗人
䄽	禾西󰀝
䄾	禾戈󰁥
䄿	禾日󰁒丿
䅀	禾一夕刂
䅁	宀女禾󰁧
䅂	禾夂口󰀝
䅃	工几丶禾
䅄	禾力力力
䅅	禾土土󰀝
䅆	禾冫⺈人
䅇	覀禾󰁧
䅈	丷夫禾󰁧
䅉	禾一业󰀝
䅊	禾广丿七
䅋	禾⺈口󰁜
䅌	禾口月󰀝
䅍	禾丿士廴
䅎	禾禾乃󰁥
䅏	禾尸毛󰁀
䅐	禾目儿󰁀
䅑	禾爫女󰀝
䅒	禾艹亠󰄃
䅓	禾勹口又
䅔	禾巛田󰀝
䅕	禾尸古󰀝
䅖	禾大日乚
䅗	禾禾女󰀝
䅘	禾木人人
䅙	禾日󰁴匕
䅚	禾丷夫⺋
䅛	禾日日󰀝
䅜	禾丿士󰁺
䅝	禾宀八工
䅞	禾日一寸
䅟	禾厶大彡
䅠	禾日一󰁾
䅡	禾丆貝󰁶
䅢	禾由月󰀝
䅣	禾白王󰀝
䅤	禾丿十臼
䅥	禾日勹󰄃
䅦	禾艹田󰀝
䅧	禾立日󰀝
䅨	禾禾日󰀝
䅩	禾十又八
䅪	禾口丨贝
䅫	禾亠日小
䅬	禾䒑八皿
䅭	禾亠丷方
䅮	禾人丶口
䅯	禾广󰁬口
䅰	禾囗大心
䅱	禾山一䒑
䅲	禾土丿日
䅳	禾勹凵丿
䅴	禾十冖小
䅵	禾丷王灬
䅶	禾厂二寸
䅷	禾艹人朩
䅸	禾艹辛󰀢
䅹	禾󰀻女󰀝
䅺	禾覀二小
䅻	禾亠乂厶
䅼	禾日罒又
䅽	士󰁅几禾
䅾	禾󰀄󰁜日
䅿	禾艹一󰀟
䆀	禾󰀹土灬
䆁	禾罒土十
䆂	禾广䒑八
䆃	䒑丿目禾
䆄	禾亠囗一
䆅	禾冫⺈貝
䆆	禾口口木
䆇	禾几󰁟灬
䆈	禾尸氺辶
䆉	禾罒厶匕
䆊	禾丬匕八
䆋	禾⺈󰁵󰀝
䆌	禾禾言
䆍	禾立月三
䆎	禾人人󰀞
䆏	禾米田八
䆐	三八禾禾
䆑	宀八丁󰀬
䆒	宀八九丶
䆓	宀八厶儿
䆔	宀八口丨
䆕	宀八ユ人
䆖	宀八厶
䆗	宀八口丨
䆘	宀八甲󰀬
䆙	宀八一止
䆚	宀八冂口
䆛	宀八口七
䆜	宀八月
䆝	宀八丿皿
䆞	宀八日匕
䆟	宀八人口
䆠	宀八匚丨
䆡	宀八丶艮
䆢	宀八扌大
䆣	宀八厂󰀖
䆤	宀八丿丿
䆥	宀八一󰀓
䆦	宀八火火
䆧	宀八禾女
䆨	宀八日大
䆩	宀八目大
䆪	⺌一儿工
䆫	宀八勹心
䆬	宀八口貝
䆭	宀八車干
䆮	宀八氵又
䆯	宀八又女
䆰	宀八匚口
䆱	宀八氵火
䆲	宀八广氺
䆳	宀八一辶
䆴	宀八⺈乚
䆵	宀八丷日
䆶	宀八亻灬
䆷	宀八󰁻口
䆸	宀八癶䒑
䆹	宀八立土
䆺	宀八丿田
䆻	宀八乛攵
䆼	宀八ㄇ辶
䆽	宀八虍󰀓
䆾	宀八匚皿
䆿	宀八爿木
䇀	宀八廿耳
䇁	宀八󰁢羊
䇂	立丨󰀵
䇃	立巳󰁀
䇄	立𠂉乙󰁀
䇅	立戈󰁶
䇆	立󰁦十󰀢
䇇	立󰁂󰀁󰁀
䇈	立又土󰀝
䇉	立石󰀝
䇊	立广厶󰁶
䇋	立夕夕󰁶
䇌	立⺌月󰀝
䇍	立口󰁾󰁶
䇎	立󰁺日󰀝
䇏	立󰁸子󰀝
䇐	立󰁬氺󰁶
䇑	立白丿十
䇒	󰁮󰀄󰁜立
䇓	彡丆貝立
䇔	󰄹月立丶
䇕	立󰀙丆〢
䇖	⺮勹丿󰁣
䇗	⺮八厶󰁧
䇘	⺮一彑󰀘
䇙	⺮弓丨󰀬
䇚	⺮亻卜󰁧
䇛	⺮止󰀘
䇜	⺮⺈人󰁧
䇝	⺮戈󰁧
䇞	⺮甘󰀘
䇟	⺮夕力󰁣
䇠	⺮丶王󰀘
䇡	⺮宀丁󰀬
䇢	⺮古󰀘
䇣	⺮人小󰁧
䇤	⺮一冂人
䇥	⺮一止󰀘
䇦	⺮ㄇ大󰁧
䇧	⺮一囗人
䇨	⺮夂㐄󰀬
䇩	⺮日󰁒丿
䇪	⺮一厶土
䇫	⺮匚丨丨
䇬	⺮丿未󰁧
䇭	⺮土丿匕
䇮	⺮亻丿士
䇯	⺮耳󰀘
䇰	⺮了󰀩一
䇱	⺮囗夕󰁧
䇲	⺮一丷大
䇳	⺮二戈󰁧
䇴	⺮西󰀘
䇵	⺮氵斤󰀬
䇶	⺮⺈用󰀬
䇷	⺮口力刂
䇸	⺮口王󰀘
䇹	⺮󰁬丿口
䇺	⺮一口䒑
䇻	⺮尸毛󰀅
䇼	⺮口巴󰀅
䇽	⺮扌斤󰀬
䇾	⺮言󰀘
䇿	⺮木口󰀘
䈀	⺮󰀼󰀼刂
䈁	⺮人一艹
䈂	⺮䒑廾󰀬
䈃	⺮氵刀口
䈄	⺮了󰀪凵
䈅	⺮戈口󰀞
䈆	⺮丶尸犬
䈇	⺮󰀥早󰀬
䈈	⺮月巴󰀅
䈉	⺮立女󰀘
䈊	⺮土八夂
䈋	⺮水日󰀘
䈌	⺮氵󰀐一
䈍	⺮亠󰄃目
䈎	⺮廿󰄃木
䈏	⺮一口田
䈐	⺮忄火
䈑	⺮ㄇ󰁈口
䈒	⺮十冂十
䈓	⺮日勹󰄃
䈔	⺮󰁃丨又
䈕	⺮日一󰁾
䈖	⺮禾󰁦十
䈗	⺮亻厶夂
䈘	⺮䒑幺幺
䈙	⺮糹寸󰁧
䈚	⺮厶口心
䈛	⺮󰀥冂又
䈜	⺮亻彐又
䈝	⺮乛󰁾月
䈞	⺮亠口日
䈟	⺮貝刂󰀬
䈠	⺮爫一又
䈡	⺮勹󰁤心
䈢	⺮厶口木
䈣	⺮一止攵
䈤	⺮木甘󰀘
䈥	⺮⺈用力
䈦	⺮乂凵夂
䈧	⺮爫丿灬
䈨	⺮阝艮󰁧
䈩	⺮人一刂
䈪	⺮一口丨
䈫	⺮糹冂人
䈬	⺮氵甫󰁧
䈭	⺮白󰁜厶
䈮	⺮立勹口
䈯	⺮十󰀣八
䈰	⺮扌⺌月
䈱	⺮爫臼󰀘
䈲	⺮丿󰁪又
䈳	⺮日羽󰀘
䈴	⺮䒑󰁬八
䈵	⺮八厶羽
䈶	⺮宀八口
䈷	⺮木夂口
䈸	⺮⺈用十
䈹	⺮宀亻日
䈺	⺮糹夂󰁦
䈻	⺮月甫󰁧
䈼	⺮宀心山
䈽	⺮廿口
䈾	⺮木⺌月
䈿	⺮冖日六
䉀	⺮广廿灬
䉁	⺮耳人󰁻
䉂	⺮田幺小
䉃	⺮爿󰁝寸
䉄	⺮阝土夂
䉅	⺮土䒑丶
䉆	⺮󰁟灬󰁧
䉇	⺮󰀎八刂
䉈	⺮󰁺月攵
䉉	⺮⺈用󰂃
䉊	⺮厶大車
䉋	⺮女󰁅目
䉌	⺮阝䒑󰀓
䉍	⺮門心󰁧
䉎	⺮⺌冖木
䉏	⺮⺈用󰀟
䉐	⺮車古󰀘
䉑	⺮𠂉一灬
䉒	⺮丿米田
䉓	⺮木日木
䉔	⺮一夕戈
䉕	⺮丷󰀺日
䉖	⺮車人󰁻
䉗	⺮扌口耳
䉘	⺮木宀小
䉙	⺮󰀙二厶
䉚	⺮罒冖丶
䉛	⺮丿ㄇ大
䉜	⺮𠂉大󰁷
䉝	⺮丷王丶
䉞	⺮戊一心
䉟	⺮扌亻又
䉠	⺮彳山攵
䉡	⺮亠囗一
䉢	⺮土人口
䉣	⺮臼勹灬
䉤	⺮米女攵
䉥	⺮扌丿心
䉦	⺮覀大辶
䉧	⺮󰁚丶刂
䉨	⺮立󰀓又
䉩	⺮木匚口
䉪	⺮田田田
䉫	⺮禾勹氺
䉬	⺮广癶又
䉭	⺮巛囗󰁒
䉮	⺮門亻󰁷
䉯	⺮匚丨貝
䉰	⺮󰀾月乂
䉱	⺮衤󰁧口
䉲	⺮弓一乂
䉳	⺮󰁢灬羊
䉴	⺮亠口󰀔
䉵	⺮目大艮
䉶	⺮亻󰁷又
䉷	⺮口口攵
䉸	⺮辛言辛
䉹	⺮󰀙口人
䉺	米工󰀝
䉻	米󰁚󰀁󰁀
䉼	米斤󰀢
䉽	米丷󰀟󰀢
䉾	丬匕米󰁧
䉿	米丿丷󰀛
䊀	米古󰀝
䊁	米丿土儿
䊂	米木冂󰁀
䊃	米几一丨
䊄	工几丶米
䊅	米夕口󰀝
䊆	臼米󰁧
䊇	米甫󰁶
䊈	米𠂉母󰁶
䊉	米宀木󰁶
䊊	米尸毛󰁀
䊋	米爿士󰀝
䊌	米广󰁴匕
䊍	禾勹丿米
䊎	米丷夫⺋
䊏	米火火󰁶
䊐	米日󰁴匕
䊑	米⺌冂口
䊒	米亻󰁷󰀝
䊓	米日一󰁾
䊔	米艹ㄇ大
䊕	米󰁬󰀟廴
䊖	米十冂十
䊗	米白王󰀝
䊘	米由月󰀝
䊙	石一廾米
䊚	米丿󰃧辶
䊛	米乂朩又
䊜	米一日寸
䊝	米丿米心
䊞	米亠丷古
䊟	米廿冂丶
䊠	󰁮󰀄󰁜米
䊡	米日罒又
䊢	爿󰁝寸米
䊣	米󰁺由八
䊤	米覀早󰀢
䊥	米󰁬十󰀲
䊦	米士冖䒑
䊧	米弓󰀯貝
䊨	󰄹月米几
䊩	米丿米田
䊪	米艹日丶
䊫	米罒丨三
䊬	禾日木米
䊭	米士乛寸
䊮	米羽亻󰁷
䊯	米广󰁺八
䊰	米言土日
䊱	米人人󰀞
䊲	覀米立
䊳	米广木三
䊴	米⺮人人
䊵	糹九󰁀
䊶	糹也󰁀
䊷	糹󰀛丿󰁥
䊸	糹二ㄅ󰁀
䊹	糹丿十󰀢
䊺	糹一彑󰀝
䊻	糹⺈人󰁶
䊼	糹止󰀝
䊽	糹ユ人󰁶
䊾	糹木󰁶
䊿	糹夫󰁶
䋀	丶尸幺小
䋁	糹亠几󰁀
䋂	糹乂乂󰁶
䋃	糹毛󰁀
䋄	糹冂乂󰁶
䋅	糹丿󰀟󰀢
䋆	糹丶尸󰁥
䋇	糹尸󰂃󰁶
䋈	女又幺小
䋉	糹宀八󰁶
䋊	糹一止󰀝
䋋	糹󰁂󰀁󰁀
䋌	糹匚󰁃󰀝
䋍	糹丁口󰀝
䋎	糹日一󰀝
䋏	糹𠂉丨二
䋐	糹戈󰁐󰁀
䋑	糹一冂人
䋒	糹󰁻乛丿
䋓	糹⺈彐󰀝
䋔	糹丆卜一
䋕	亻丿士小
䋖	糹󰁬󰀟󰀢
䋗	糹匚丨丨
䋘	糹二木󰁶
䋙	糹耳󰀝
䋚	糹羽󰀝
䋛	糹米󰁶
䋜	丶尸又小
䋝	糹󰀧女󰀝
䋞	糹冂乂乂
䋟	糹己心󰁶
䋠	糹甫󰁶
䋡	糹人一朩
䋢	扌斤幺小
䋣	𠂉母幺小
䋤	幺小丶
䋥	糹日土󰀝
䋦	糹𠂉母󰁶
䋧	糹尸古󰀝
䋨	糹立口󰀝
䋩	糹臼儿󰁀
䋪	糹阝丁口
䋫	糹⺈󰁬亅
䋬	糹一大⺗
䋭	糹亠厶月
䋮	糹金󰀝
䋯	丶尸戈小
䋰	目大幺小
䋱	糹木人人
䋲	糹口日乚
䋳	糹丬匕月
䋴	糹󰁻乛木
䋵	糹日勹󰄃
䋶	糹丆貝󰁶
䋷	󰁻乛亅小
䋸	糹⺁十目
䋹	糹一口田
䋺	糹禾火󰁶
䋻	糹十冂十
䋼	糹乃又皿
䋽	糹土土寸
䋾	糹大夕夕
䋿	糹田一󰀖
䌀	糹禾󰁦十
䌁	糹覀女󰀝
䌂	糹尸一土
䌃	糹⺌月刂
䌄	糹一冂又
䌅	糹广󰁬口
䌆	糹白󰁜厶
䌇	糹十冖小
䌈	糹日羽󰀝
䌉	糹罒一止
䌊	糹爫𠂉凵
䌋	糹艹人口
䌌	糹羽白󰀝
䌍	糹廿口
䌎	田夂口小
䌏	糹宀心山
䌐	糹爫目儿
䌑	糹匚丨土
䌒	糹󰁙󰁴匕
䌓	𠂉母几小
䌔	糹匚口口
䌕	糹广木木
䌖	糹亻󰁷木
䌗	糹𠂉一灬
䌘	㡀攵幺小
䌙	糹󰁺由八
䌚	糹覀米󰁶
䌛	󰁝言丿小
䌜	糹业䒑未
䌝	糹木木小
䌞	糹人一人
䌟	糹尸口辛
䌠	戊一口小
䌡	糹ㄇ󰁺䒑
䌢	糹󰀙人󰁻
䌣	糹⺮宀󰃧
䌤	糹一八乂
䌥	糹爫工心
䌦	糹羽亻󰁷
䌧	糹士乛寸
䌨	糹艹󰁯小
䌩	糹艹罒人
䌪	糹門⺈臼
䌫	糹匚丨儿
䌬	糹立月三
䌭	糹艹亻灬
䌮	糹󰀙木目
䌯	糹艹口󰁷
䌰	糹耳耳耳
䌱	糹󰄹月丶
䌲	糹艹丿灬
䌳	糹一八丶
䌴	糹󰄹月丶
䌵	糹尸氺虫
䌶	纟󰀛丿󰁥
䌷	纟由󰀝
䌸	纟二󰁓丶
䌹	纟冂口󰀝
䌺	纟耳󰀝
䌻	纟羽󰀝
䌼	纟丷口儿
䌽	纟爫木󰁶
䌾	纟十冂十
䌿	纟一口田
䍀	纟〢𠂉皿
䍁	纟䒑󰀓辶
䍂	𠂉十凵󰀛
䍃	爫𠂉十凵
䍄	𠂉十凵口
䍅	𠂉十凵󰁻
䍆	𠂉十凵丁
䍇	𠂉十凵之
䍈	𠂉十凵十
䍉	𠂉十凵八
䍊	𠂉十凵乂
䍋	𠂉十凵󰁺
䍌	𠂉十凵口
䍍	士冖一又
䍎	𠂉十凵灬
䍏	冂〢一󰀌
䍐	罒干󰀬
䍑	冂乂乂干
䍒	罒木󰁧
䍓	罒󰀄亅丿
䍔	罒厶󰁧
䍕	罒󰁚󰀁丶
䍖	罒勹巳󰀅
䍗	罒亠幺󰁧
䍘	罒米󰁧
䍙	罒𠂉母󰁧
䍚	罒丶艮󰁧
䍛	罒囗古󰀘
䍜	罒亻󰁷󰀘
䍝	罒水日󰀘
䍞	冂乂乂󰀞
䍟	罒乂凵夂
䍠	罒亠乂厶
䍡	罒󰁙󰁴匕
䍢	罒𠂉一灬
䍣	罒󰀙田󰀘
䍤	罒󰀴󰀳󰀘
䍥	罒厂禾止
䍦	罒亠乂󰁷
䍧	牜羊󰀢
䍨	⺶一冂丨
䍩	⺶攵󰁶
䍪	⺶一木󰁶
䍫	⺶宀匕󰁀
䍬	⺶一丷十
䍭	⺶母󰁶
䍮	⺶儿󰀪󰁶
䍯	⺶⺈厂⺋
䍰	⺶囗大󰁶
䍱	⺶人一朩
䍲	⺶臼儿󰁀
䍳	⺶又又又
䍴	⺶禾女󰀝
䍵	⺶⺈󰁬亅
䍶	⺶木日󰀝
䍷	⺶󰁆口㐄
䍸	⺶甫寸󰁶
䍹	⺶丿目犬
䍺	⺶口口心
䍻	⺶巳巳八
䍼	⺶󰀄󰁜日
䍽	⺶厂禾止
䍾	一廾羽󰀝
䍿	羽王󰀘
䎀	羽戈󰁐󰁀
䎁	古羽󰀝
䎂	羽勹巳󰁀
䎃	冂土羽󰀝
䎄	刀口羽󰀝
䎅	白羽󰀝
䎆	羽人丶󰁻
䎇	丿󰁪羽󰀝
䎈	羽日󰁒丿
䎉	羽戈人󰁶
䎊	夂口羽󰀝
䎋	丿土口羽
䎌	羽口󰁾󰁶
䎍	羽甫󰁶
䎎	羽耳乚󰁀
䎏	人丶乛羽
䎐	十早羽󰀝
䎑	羽󰁭氺󰁶
䎒	羽戈戈󰁶
䎓	羽水日󰀝
䎔	羽甫寸󰁶
䎕	火火冖羽
䎖	丷󰀺日羽
䎗	丿大口羽
䎘	󰁬十󰀲羽
䎙	宀一󰀤羽
䎚	羽三丨心
䎛	土丿匕口
䎜	土丿󰁴匕
䎝	土丿匕羽
䎞	土丿日乛
䎟	女丆冂〢
䎠	九丶丆〢
䎡	丆冂〢火
䎢	二木𠂉乙
䎣	二木󰁐人
䎤	二木尸口
䎥	二木八口
䎦	二木火火
䎧	二木立口
䎨	二木大乚
䎩	二木巛田
䎪	二木日寸
䎫	二木乂夂
䎬	二木罒厶
䎭	二木丿辶
䎮	二木亠古
䎯	二木廿夫
䎰	二木󰁺斤
䎱	二木罒匕
䎲	耳乙󰁀
䎳	耳月󰀝
䎴	耳二󰀯󰀢
䎵	耳心丿󰁥
䎶	耳日丨󰀢
䎷	耳丿未󰁶
䎸	耳五口󰀝
䎹	丿米耳󰀘
䎺	耳𠂉一刂
䎻	耳󰀼土口
䎼	耳󰁭氺󰁶
䎽	耳󰁚󰀁日
䎾	耳人一艹
䎿	耳禾火󰁶
䏀	耳木口刂
䏁	耳宀辛󰀢
䏂	耳臼丨又
䏃	耳冖日六
䏄	耳宀八土
䏅	耳󰁯二小
䏆	耳一ㄇ日
䏇	耳覀二小
䏈	耳糹幺小
䏉	耳日幺灬
䏊	耳立月三
䏋	󰁬丨八巳
䏌	八月󰀘
䏍	厶月󰀘
䏎	月几丶󰁶
䏏	月一󰀛󰀢
䏐	月ユ人󰁶
䏑	󰁝冂人人
䏒	月丿丨󰁈
䏓	󰀼冫二儿
䏔	月󰁈丨一
䏕	月丿士󰀝
䏖	月弓丨󰀢
䏗	月气󰁀
䏘	月匚儿󰁀
䏙	月冖󰁜󰁀
䏚	月小丿󰁥
䏛	月勹冫󰀝
䏜	月乃󰂃󰁶
䏝	月二󰁓丶
䏞	月一木󰁶
䏟	月心丿󰁥
䏠	月立󰀝
䏡	月二小󰁶
䏢	月皮󰁶
䏣	月󰀐一󰀝
䏤	月𠃌一口
䏥	月冂土󰀝
䏦	月丿古󰀝
䏧	月夕夕󰁶
䏨	月丿󰃧󰀝
䏩	月人一口
䏪	月耳󰀝
䏫	月亻木󰁶
䏬	月厶丿󰀟
䏭	月丿未󰁶
䏮	月力󰀪󰁶
䏯	月士心󰁶
䏰	月刀丶心
䏱	月尸𠃌口
䏲	月丷弓丿
䏳	月扌斤󰀢
䏴	月⺌月󰀝
䏵	月乚丶
䏶	月󰁴匕土
䏷	月日干󰀢
䏸	月五口󰀝
䏹	月目儿󰁀
䏺	月夂三丨
䏻	厶月土厶
䏼	月戈戈󰁶
䏽	月立口󰀝
䏾	月三人󰀟
䏿	丶尸攵月
䐀	月大丁口
䐁	月一󰀓丶
䐂	月󰁭氺󰁶
䐃	月囗禾󰁶
䐄	月⺈臼󰀝
䐅	月尸𠂉大
䐆	月爫木󰁶
䐇	月勹󰁤日
䐈	月十󰀣󰀝
䐉	月巛田󰀝
䐊	月日󰁴匕
䐋	月八厶心
䐌	ㄇ󰁺八月
䐍	月士口䒑
䐎	月日一󰁾
䐏	月三人日
䐐	月禾火󰁶
䐑	月廿󰄃木
䐒	月大夕夕
䐓	月丆貝󰁶
䐔	月丶尸艹
䐕	月口耳󰀝
䐖	月尸米󰁶
䐗	月土丿日
䐘	月爫一又
䐙	月廿󰀜󰀢
䐚	月󰁮卩󰀢
䐛	月大耳󰀝
䐜	月十󰀣八
䐝	月⺌貝󰁶
䐞	月弓冫冫
䐟	月󰀀冂土
䐠	月艹亠󰀸
䐡	󰀴冂人人
䐢	月勹凵丿
䐣	月口貝󰁶
䐤	月⺶工󰀝
䐥	月八厶羽
䐦	月土厶皿
䐧	月󰁸冂口
䐨	士冖一又
䐩	月山一䒑
䐪	月亻󰁷乃
䐫	月彳人󰁾
䐬	月一ㄇ日
䐭	月廿儿丨
䐮	月立丿
䐯	月田幺小
䐰	月亻丨月
䐱	月亠丷古
䐲	月羽白󰀝
䐳	月󰁢灬󰁶
䐴	󰁮󰀄󰁜月
䐵	月󰁺由八
䐶	月󰀄󰁜日
䐷	月口口十
䐸	月󰁬土一
䐹	月󰁬十󰀲
䐺	月覀早󰀢
䐻	月古辛󰀢
䐼	月三丨小
䐽	月廿冂丶
䐾	月罒土十
䐿	月丿ㄇ大
䑀	月尸口辛
䑁	󰀗乂乂月
䑂	月󰀗一八
䑃	月艹冖󰀓
䑄	月丿目󰀯
䑅	月艹罒夕
䑆	月丷王艮
䑇	月斤斤貝
䑈	月白幺木
䑉	月󰄹月丶
䑊	月口丨辶
䑋	月亠口󰀔
䑌	月門木󰀹
䑍	月貝貝女
䑎	月人人󰀞
䑏	月艹口󰁷
䑐	匚丨󰁃小
䑑	匚丨󰁃夫
䑒	一厶土丶
䑓	艹二冖土
䑔	臼一冂丨
䑕	臼几󰀟󰀬
䑖	臼一󰁬󰁾
䑗	臼日一󰁤
䑘	臼⺶工󰀝
䑙	丿古冂二
䑚	丿古月󰀝
䑛	丿古󰁚丶
䑜	丿古廿木
䑝	口口冖㐄
䑞	匚火火㐄
䑟	爫冖夕王
䑠	丿󰁪了󰀢
䑡	丿󰁪又丶
䑢	丿󰁪一儿
䑣	丿󰁪彡󰁥
䑤	丿󰁪人乛
䑥	丿󰁪乃󰂃
䑦	丿󰁪勹口
䑧	丿󰁪亻寸
䑨	丿󰁪𠂉也
䑩	丿󰁪古󰀝
䑪	丿󰁪人口
䑫	丿󰁪䒑廾
䑬	丿󰁪儿󰀪
䑭	丿󰁪氵工
䑮	丿󰁪几木
䑯	丿󰁪丷丿
䑰	丿󰁪止󰀤
䑱	丿󰁪宀⺋
䑲	丿󰁪󰀥早
䑳	丿󰁪人艹
䑴	丿󰁪󰀎八
䑵	丿󰁪󰀰月
䑶	丿󰁪月
䑷	丿󰁪丶月
䑸	丿󰁪宀小
䑹	丿󰁪宀又
䑺	丿󰁪几虫
䑻	丿󰁪方子
䑼	丿󰁪勹丿
䑽	丿󰁪日羽
䑾	丿󰁪亻又
䑿	丿󰁪宀日
䒀	丿󰁪⺮寸
䒁	丿󰁪羽白
䒂	丿󰁪爿寸
䒃	丿󰁪丿辶
䒄	丿󰁪冖田
䒅	丿󰁪丷目
䒆	丿󰁪亠攵
䒇	丿󰁪宀田
䒈	丿󰁪十貝
䒉	丿󰁪𠂉㐄
䒊	八一ㄅ巴
䒋	ㄇ大⺈巴
䒌	冖日六巴
䒍	亠丷冖巴
䒎	艹犬廾巴
䒏	丷󰀺日巴
䒐	艹罒冖巴
䒑	䒑丶丿一
䒒	艹𠃌󰀞󰀘
䒓	艹一ㄅ󰀅
䒔	艹八󰁧
䒕	艹小󰁧
䒖	艹⺄十󰀬
䒗	艹𠂉乙󰀅
䒘	艹夂󰁧
䒙	艹上󰀘
䒚	艹小丿󰁣
䒛	艹幺𠃌󰀅
䒜	艹丿󰀟󰀬
䒝	艹乂乂󰁧
䒞	艹冖󰁜󰀅
䒟	艹󰀼亠󰀘
䒠	艹三丨󰀬
䒡	艹弓丨󰀬
䒢	艹󰁚卩󰀬
䒣	艹冂二󰀘
䒤	艹日󰀘
䒥	艹一冂丨
䒦	艹丿之󰁧
䒧	艹土厶󰁧
䒨	艹𠂉大󰁧
䒩	艹禾󰁧
䒪	艹厶廾󰀬
䒫	艹亻󰀁丶
䒬	艹二小󰁧
䒭	艹ユ寸󰁧
䒮	艹冖几丶
䒯	艹冖九丶
䒰	艹匚王󰀘
䒱	艹了󰀩一
䒲	艹女丿七
䒳	艹几木󰁧
䒴	艹月󰀘
䒵	艹女子󰀘
䒶	艹日󰁒丿
䒷	艹丿古󰀘
䒸	艹丿皿󰀘
䒹	艹二木󰁧
䒺	艹幺小󰁧
䒻	艹山巳󰀅
䒼	艹ㄇ󰁺󰀘
䒽	艹冂乂乂
䒾	艹亠󰀔󰁧
䒿	艹冖月󰀘
䓀	艹士口󰀘
䓁	艹土寸󰁧
䓂	艹言󰀘
䓃	艹口巴󰀅
䓄	艹犭󰁥斤
䓅	艹氵斤󰀬
䓆	艹扌斤󰀬
䓇	艹土󰁖󰁧
䓈	艹彳几又
䓉	艹󰀄亅阝
䓊	艹五口󰀘
䓋	艹氵󰁚󰀁
䓌	艹士心󰁧
䓍	艹日干󰀬
䓎	艹火勹丶
䓏	艹丆卜口
䓐	艹大一乚
䓑	艹氵一廾
䓒	艹勹田󰀘
䓓	艹三丿寸
䓔	艹土丿子
䓕	艹二儿辶
䓖	艹宀八力
䓗	艹八厶心
䓘	艹夂卜口
䓙	艹丿十匕
䓚	艹彳󰀐一
䓛	艹尸凵山
䓜	艹氵󰁚丶
䓝	艹子皿󰀘
䓞	艹丶尸犬
䓟	艹󰀼土口
䓠	艹水日󰀘
䓡	艹𠂉大口
䓢	艹囗古󰀘
䓣	艹一冂丶
䓤	艹勹󰁤心
䓥	丿󰂃艹早
䓦	艹ㄇ󰁺八
䓧	艹了口一
䓨	艹冖𠂉凵
䓩	艹木十又
䓪	艹日勹󰁤
䓫	艹大丁口
䓬	艹󰀥早󰀬
䓭	艹乂朩刂
䓮	艹󰁻乛攵
䓯	艹母󰁧
䓰	艹覀土󰀘
䓱	艹止匕木
䓲	艹亻丷儿
䓳	艹彳艮󰁧
䓴	艹丆冂大
䓵	艹口口口
䓶	艹木口刂
䓷	艹氵彳丁
䓸	艹女女干
䓹	艹人丶艮
䓺	艹丷王大
䓻	艹冖二女
䓼	艹女丶
䓽	艹言己󰀅
䓾	艹氵小女
䓿	艹󰁻囗十
䔀	艹亻禾女
䔁	艹覀木󰁧
䔂	艹宀辛󰀬
䔃	艹礻󰁶一
䔄	艹爫𠂉凵
䔅	艹丁口口
䔆	艹犭󰁥土
䔇	艹山一䒑
䔈	艹工貝󰁧
䔉	艹禾禾󰁧
䔊	艹王䒑廾
䔋	艹糹小丿
䔌	艹白木一
䔍	艹󰀋灬󰁧
䔎	艹木口辶
䔏	艹丿土辶
䔐	艹氵戈戈
䔑	艹人一十
䔒	艹阝立口
䔓	艹言𠂉十
䔔	艹立日儿
䔕	艹月甫󰁧
䔖	艹阝土夂
䔗	艹礻󰁶羊
䔘	艹𠂉十一
䔙	艹釒勹丶
䔚	艹厂二月
䔛	艹󰁴丆貝
䔜	艹耳冂土
䔝	艹止匕小
䔞	艹亠幺十
䔟	艹禾夕夕
䔠	艹木⺌月
䔡	艹󰁢灬󰁧
䔢	艹人人ㄅ
䔣	艹禾刂󰀟
䔤	艹白丆日
䔥	艹󰁬米󰀯
䔦	艹木𠂉母
䔧	艹禾刂木
䔨	艹󰁲丿󰁷
䔩	艹木口攵
䔪	艹大乂乂
䔫	艹乛止冂
䔬	艹田󰁺八
䔭	艹宀心用
䔮	艹󰀎八斤
䔯	艹西一古
䔰	艹宀一田
䔱	艹扌口耳
䔲	艹癶一䒑
䔳	艹󰁝犬灬
䔴	艹凵山又
䔵	艹門木󰁧
䔶	艹扌日󰁾
䔷	艹王王乛
䔸	艹犬犬犬
䔹	艹阝䒑󰀓
䔺	艹阝月
䔻	艹󰁸孑攵
䔼	艹刀丶止
䔽	艹氵日󰄃
䔾	艹扌日󰄃
䔿	艹丷西寸
䕀	艹士二人
䕁	艹丨三木
䕂	艹厶口辶
䕃	艹阝人󰂞
䕄	艹了󰀩皿
䕅	艹女臼又
䕆	艹木人刂
䕇	艹广白厶
䕈	艹爿廿木
䕉	艹罒土十
䕊	艹亠囗一
䕋	艹土广口
䕌	艹禾亻󰁷
䕍	艹亠󰀔口
䕎	艹日一田
䕏	艹丷王丶
䕐	艹礻󰁶田
䕑	艹糹爫女
䕒	艹士口口
䕓	艹宀󰁯小
䕔	艹彳釒丁
䕕	艹氵日又
䕖	艹孑丿辶
䕗	艹丿目󰀯
䕘	艹人丶貝
䕙	艹十戈󰁷
䕚	艹匚口貝
䕛	艹言大人
䕜	艹羽亠十
䕝	艹禾爫土
䕞	艹門丶艮
䕟	艹󰀗ㄇ八
䕠	艹广癶又
䕡	艹門口口
䕢	艹石⺶工
䕣	艹衤󰁧󰄃
䕤	艹口口阝
䕥	艹八八乂
䕦	艹󰄹月丶
䕧	艹󰀾月乂
䕨	艹月丷小
䕩	艹木大小
䕪	艹氵罒十
䕫	艹白止夂
䕬	艹弓一一
䕭	艹土八火
䕮	艹土䒑米
䕯	艹覀二󰂃
䕰	艹火丿田
䕱	艹一口貝
䕲	艹广亠小
䕳	艹弓一乂
䕴	艹禾亻灬
䕵	艹士口灬
䕶	艹言亻又
䕷	艹广木小
䕸	艹󰀹土口
䕹	艹亠人󰁷
䕺	艹业丷又
䕻	艹一ㄇ匕
䕼	艹廿口󰁷
䕽	艹口止虫
䕾	艹口口攵
䕿	艹廿口灬
䖀	艹口口口
䖁	艹日冂心
䖂	艹言糹手
䖃	艹口口
䖄	艹廿口灬
䖅	艹󰀙口人
䖆	艹西一󰀔
䖇	艹木𠂉彡
䖈	虍匕󰁫
䖉	虍一󰀛󰀵
䖊	乂虍几󰁀
䖋	虍几人󰁶
䖌	虍几刂󰀢
䖍	虍攵󰀦
䖎	阝虍几󰁀
䖏	虍勹󰁤󰂃
䖐	斤虍几󰁀
䖑	虍几日󰀌
䖒	虍一口䒑
䖓	凵山虍几
䖔	土厶虍几
䖕	虍几󰀐一
䖖	虍几甲󰀵
䖗	虍戊一口
䖘	虍几⺈丶
䖙	匚丨󰁃几
䖚	虍几󰁞灬
䖛	虍几十小
䖜	虍几虍日
䖝	丿虫󰀦
䖞	虫寸󰁶
䖟	亠󰄃虫󰁧
䖠	虫几丶󰁶
䖡	虫󰁈丨一
䖢	虫小丿󰁥
䖣	虫⺁丨󰂃
䖤	夕⺋虫󰁧
䖥	󰁻乛亅虫
䖦	虫凵山󰀢
䖧	虫日一󰀝
䖨	虫石󰀝
䖩	虫心丿󰁥
䖪	止匕虫󰁧
䖫	虫八干󰀢
䖬	虫甲󰀢
䖭	丷夫虫󰁧
䖮	虫丿冂口
䖯	土土虫󰁧
䖰	虫⺁󰀕󰁶
䖱	虫匚王󰀝
䖲	虫勹日󰀝
䖳	虫宀丿七
䖴	虫儿󰀪󰁶
䖵	虫虫󰁶
䖶	虫一󰀓󰁶
䖷	虫乂丨
䖸	丿扌󰁒虫
䖹	虫丨一干
䖺	亻丨夂虫
䖻	虫亠厶󰀸
䖼	虫土厶卩
䖽	禾刂虫󰁧
䖾	虫宀二儿
䖿	禾勹丿虫
䗀	虫土八夂
䗁	虫大丁口
䗂	虫虍几󰁀
䗃	虫戈戈󰁶
䗄	虫八乂斤
䗅	虫󰀍󰀖󰁶
䗆	虫宀󰃧󰀝
䗇	虫勹米󰁶
䗈	虫亠󰄃目
䗉	虫日日󰀝
䗊	虫火火󰁶
䗋	虫甘木󰁶
䗌	虫日丿
䗍	彑󰀓虫󰁧
䗎	虫覀土󰀝
䗏	虫宀火又
䗐	方𠂉也虫
䗑	虫日立󰀝
䗒	虫䒑业󰀝
䗓	虫勹󰁤心
䗔	虫亻ユ大
䗕	宀夕⺋虫
䗖	虫一〣丨
䗗	虫⺮一廾
䗘	虫土厶皿
䗙	宀󰀀八虫
䗚	虫甫寸󰁶
䗛	虫亻丨月
䗜	虫󰁚丶田
䗝	礻󰁶日虫
䗞	一大虫虫
䗟	匚𠂉大虫
䗠	方𠂉乛虫
䗡	虫一止灬
䗢	虫丿土辶
䗣	甘虫虫󰁧
䗤	虫广󰁬丨
䗥	虫彳人󰁾
䗦	虫夂三辶
䗧	虫广󰁬氺
䗨	虫󰁢灬󰁶
䗩	虫戊上小
䗪	广廿灬虫
䗫	虫广木木
䗬	夂三丨虫
䗭	虫口口心
䗮	虫大乂乂
䗯	虫亻󰁷辶
䗰	虫毌貝󰁶
䗱	虫业䒑夫
䗲	虫米夕㐄
䗳	虫癶一䒑
䗴	虫⺮丿廴
䗵	虫一田一
䗶	虫艹日󰄃
䗷	虫立日心
䗸	亠󰁲丿虫
䗹	虫䒑幺心
䗺	丿󰀥󰄃虫
䗻	虫⺮󰁮卩
䗼	虫丿一灬
䗽	糹亻󰁷虫
䗾	虫日幺灬
䗿	虫宀心丁
䘀	丿󰃧十虫
䘁	十戈亻虫
䘂	虫十戈󰀞
䘃	虫󰀹土土
䘄	土丿日虫
䘅	厶月匕虫
䘆	虫宀三心
䘇	文虫虫虫
䘈	虫厂艹力
䘉	一大虫虫
䘊	虫⺮罒人
䘋	虫人人󰀞
䘌	匚艹虫
䘍	艹日冂虫
䘎	虫言糹弓
䘏	丿皿阝󰀢
䘐	丿皿刀八
䘑	丿皿丶󰀩
䘒	丿皿厶夂
䘓	丿皿⺈臼
䘔	丿皿宀口
䘕	彳亠几丁
䘖	彳𠂉十丁
䘗	彳山丿丁
䘘	彳幺丁
䘙	彳󰁆口丁
䘚	亠󰀔十󰀬
䘛	衤󰁧几󰁀
䘜	衤󰁧冂丨
䘝	衤󰁧󰀁丶
䘞	衤󰁧󰀊一
䘟	衤󰁧弓丨
䘠	衤󰁧乂
䘡	󰁴匕亠󰀔
䘢	衤󰁧宀丁
䘣	衤󰁧止匕
䘤	衤󰁧木丶
䘥	衤󰁧甲󰀢
䘦	衤󰁧尸匕
䘧	衤󰁧ㄇ大
䘨	衤󰁧六乂
䘩	衤󰁧勹日
䘪	衤󰁧亠儿
䘫	女口亠󰀔
䘬	衤󰁧戈
䘭	衤󰁧一土
䘮	土人人󰀖
䘯	衤󰁧⺌月
䘰	衤󰁧丿廴
䘱	六人口󰀔
䘲	衤󰁧󰁬又
䘳	衤󰁧金󰀝
䘴	衤󰁧木厶
䘵	衤󰁧󰁭氺
䘶	衤󰁧了凵
䘷	衤󰁧㡀󰁶
䘸	衤󰁧亠丶
䘹	衤󰁧亠十
䘺	衤󰁧宀󰁾
䘻	衤󰁧亠月
䘼	衤󰁧宀⺋
䘽	衤󰁧臼儿
䘾	衤󰁧宀󰃧
䘿	衤󰁧尸山
䙀	衤󰁧月月
䙁	衤󰁧戈戈
䙂	衤󰁧八心
䙃	衤󰁧月
䙄	衤󰁧丿臼
䙅	衤󰁧覀女
䙆	衤󰁧癶大
䙇	衤󰁧丆大
䙈	衤󰁧亻大
䙉	衤󰁧⺁目
䙊	衤󰁧一丨
䙋	衤󰁧宀一
䙌	衤󰁧口贝
䙍	衤󰁧⺄丨
䙎	衤󰁧爫大
䙏	衤󰁧甫寸
䙐	衤󰁧一丨
䙑	衤󰁧亠󰀔
䙒	衤󰁧亠田
䙓	衤󰁧罒厶
䙔	衤󰁧匚口
䙕	衤󰁧彳󰁾
䙖	衤󰁧山月
䙗	衤󰁧亠古
䙘	衤󰁧戊小
䙙	衤󰁧尸󰀟
䙚	󰁟灬亠󰀔
䙛	衤󰁧六󰀔
䙜	衤󰁧夂辶
䙝	亠土䒑󰀔
䙞	衤󰁧癶䒑
䙟	衤󰁧囗㐄
䙠	衤󰁧厂人
䙡	衤󰁧口貝
䙢	衤󰁧丷日
䙣	衤󰁧一三
䙤	衤󰁧ㄇ辶
䙥	衤󰁧󰀙󰁻
䙦	衤󰁧艹夕
䙧	衤󰁧丿灬
䙨	衤󰁧日󰀔
䙩	衤󰁧艹󰀓
䙪	木乂乂󰀔
䙫	衤󰁧丬八
䙬	衤󰁧貝女
䙭	衤󰁧宀󰁾
䙮	衤󰁧艹󰁷
䙯	衤󰁧戊󰁾
䙰	衤󰁧亠󰁷
䙱	衤󰁧尸虫
䙲	覀大󰁧
䙳	覀火󰁧
䙴	覀大巳󰀅
䙵	覀土土󰀘
䙶	西冖󰀔󰁶
䙷	目儿寸󰁧
䙸	目儿寸󰀦
䙹	一廾目儿
䙺	火目儿󰁀
䙻	丿ㄅ丨儿
䙼	刀口目儿
䙽	大丷目儿
䙾	宀匕目儿
䙿	未目儿󰁀
䚀	丿󰁪目儿
䚁	丿冂口儿
䚂	土󰁖目儿
䚃	󰀥囗󰁃儿
䚄	󰁭氺目儿
䚅	木人人儿
䚆	艹ㄇ大儿
䚇	小丿目儿
䚈	覀土目儿
䚉	三丨刀儿
䚊	䒑八皿儿
䚋	口貝目儿
䚌	白大十儿
䚍	貝目儿
䚎	三人臼儿
䚏	米夕㐄儿
䚐	𠂉大口儿
䚑	罒貝目儿
䚒	立日土儿
䚓	覀早目儿
䚔	宀一󰀤儿
䚕	一ㄇ丶儿
䚖	󰀙口口儿
䚗	⺈用八厶
䚘	彳⺈用丁
䚙	⺈用一一
䚚	⺈用丿儿
䚛	⺈用丿口
䚜	⺈用白十
䚝	⺈用亠十
䚞	⺈用木人
䚟	⺈用日寸
䚠	⺈用日匕
䚡	⺈用田心
䚢	⺈用廿木
䚣	⺈用日󰁾
䚤	⺈用日丶
䚥	⺈用弓冫
䚦	⺈用⺁几
䚧	⺈用羽彡
䚨	⺈用癶又
䚩	⺈用丿口
䚪	⺈用罒󰀔
䚫	白方攵用
䚬	⺈用米㐄
䚭	⺈用艹󰁷
䚮	言乃󰁥
䚯	言刂󰀢
䚰	言匕󰁀
䚱	言小󰁶
䚲	言彡󰁥
䚳	言十又󰁶
䚴	言月󰀝
䚵	言󰁦十󰀢
䚶	言一大󰁶
䚷	言八一ㄅ
䚸	言人󰀯󰀢
䚹	言󰁴匕󰁀
䚺	言攵󰁶
䚻	󰁝言󰀘
䚼	言󰁈丨一
䚽	言毛󰁀
䚾	言丿士󰀝
䚿	言⺈人󰁶
䛀	言⺁又󰁶
䛁	言冂二󰀝
䛂	言丿廾󰀢
䛃	言二儿󰁀
䛄	言夕⺋󰁀
䛅	言甲󰀢
䛆	言由󰀝
䛇	言几口󰀝
䛈	言𠂉大󰁶
䛉	言󰁂󰀁󰁀
䛊	言口八󰁶
䛋	言戊󰁶
䛌	言勹巳󰁀
䛍	言弓󰀯󰀢
䛎	言宀八󰁶
䛏	言尸匕󰁀
䛐	𠃌一口言
䛑	言心丿󰁥
䛒	工一ㄅ言
䛓	〢𠂉丶言
䛔	言丆冂〢
䛕	言日乂󰁶
䛖	言日󰁒丿
䛗	匚丨󰁃言
䛘	言亻丿士
䛙	言亻木󰁶
䛚	三丨刀言
䛛	言囗口󰀝
䛜	言丿囗乂
䛝	言󰁈丨山
䛞	言日干󰀢
䛟	言大人人
䛠	言一口䒑
䛡	言󰁚󰀁口
䛢	言禾几󰁀
䛣	言由一ㄅ
䛤	言口󰁾󰁶
䛥	言乂丨
䛦	言八人口
䛧	言米󰄃󰁀
䛨	言辛󰀢
䛩	言一󰀚一
䛪	言宀八弓
䛫	言󰀍󰀖󰁶
䛬	言勹𠂉凵
䛭	言土䒑十
䛮	言夂卜口
䛯	言尸古󰀝
䛰	言日󰁴匕
䛱	言口丨心
䛲	言白冂丨
䛳	言大日乚
䛴	言大丁口
䛵	言爫冖又
䛶	言三丨木
䛷	言宀夕⺋
䛸	言广󰀥口
䛹	言彑󰀓󰁶
䛺	言田八󰀯
䛻	言⺁十目
䛼	言臼工󰀝
䛽	言丿十臼
䛾	言幺小
䛿	言一口丨
䜀	言刀丶止
䜁	言土土大
䜂	言白大十
䜃	言亻󰁷土
䜄	言尸氺󰀟
䜅	言山亻󰁷
䜆	广木木言
䜇	言六厶󰀔
䜈	言巛日木
䜉	言木人氺
䜊	言一ㄇ日
䜋	言口丨貝
䜌	言糹糹󰁶
䜍	言大丷小
䜎	言火火力
䜏	言阝辶
䜐	阝工言
䜑	言一󰀚心
䜒	言丿ㄇ大
䜓	言艹廿木
䜔	言工辶
䜕	言艹日丶
䜖	言覀貝󰁶
䜗	言戊一心
䜘	言艹勹攵
䜙	言日幺灬
䜚	言罒󰀫辶
䜛	言⺈口󰁜
䜜	言󰀥冖目
䜝	言幺幺󰄃
䜞	言󰀴󰀳󰀝
䜟	言十戈󰀞
䜠	言斤斤貝
䜡	言丆󰀐夂
䜢	言宀三心
䜣	讠斤󰀢
䜤	讠󰁺八󰁶
䜥	讠日一廴
䜦	讠艹勹日
䜧	讠刀丶止
䜨	讠口口心
䜩	讠廿口灬
䜪	八人口九
䜫	八人口工
䜬	八人口由
䜭	󰀥冖一口
䜮	八人口󰀟
䜯	八人口米
䜰	八人口十
䜱	八人口又
䜲	八人口󰁒
䜳	一口䒑󰄃
䜴	一口䒑又
䜵	一口䒑皮
䜶	一口䒑㐄
䜷	一口䒑又
䜸	一口䒑毛
䜹	一口䒑口
䜺	一口䒑日
䜻	一口䒑󰁾
䜼	󰁻乛亅䒑
䜽	一口䒑刂
䜾	一口䒑日
䜿	匚丨󰁃䒑
䝀	一口䒑田
䝁	火火冖䒑
䝂	匚丨󰁃䒑
䝃	一口䒑灬
䝄	一口䒑又
䝅	一󰀓土󰀝
䝆	勹󰁤一󰀓
䝇	八儿一󰀓
䝈	一󰀓⺁⺋
䝉	〢丷冖󰀓
䝊	一󰀓一󰁾
䝋	一󰀓宀小
䝌	一󰀓又又
䝍	一󰀓冖車
䝎	一󰀓山〢
䝏	一󰀓󰀻女
䝐	一󰀓阝月
䝑	一󰀓立土
䝒	一󰀓耳乑
䝓	一󰀓巛󰁒
䝔	一󰀓艹󰁷
䝕	一󰀓耳耳
䝖	豸⺁丨󰂃
䝗	豸木󰁶
䝘	豸几又󰁶
䝙	豸匚乂󰁶
䝚	豸尸匕󰁀
䝛	豸皮󰁶
䝜	豸厶八夂
䝝	豸大丁口
䝞	豸虍几󰁀
䝟	豸三丨大
䝠	豸厂白小
䝡	豸廿冂丶
䝢	豸日罒又
䝣	豸氵匚木
䝤	豸大丷小
䝥	豸丿目十
䝦	豸丿皿乑
䝧	貝勹冫󰀝
䝨	〢又貝󰁧
䝩	貝人彡󰁥
䝪	貝乛󰁾󰁶
䝫	貝𠂉丨二
䝬	貝丶王󰀝
䝭	貝勹口󰀝
䝮	貝亠幺󰁶
䝯	貝𠂉也󰁀
䝰	貝土寸󰁶
䝱	力力力貝
䝲	貝尸󰂃󰁦
䝳	󰀥夕又貝
䝴	一口丨貝
䝵	貝甫󰁶
䝶	貝󰁸小󰁶
䝷	𠂉大口貝
䝸	貝艹十又
䝹	貝宀夕⺋
䝺	文文貝󰁧
䝻	貝尸古󰀝
䝼	貝月󰀝
䝽	貝厂土土
䝾	一󰀁止貝
䝿	臼人貝󰁧
䞀	貝亻ユ大
䞁	貝匚日女
䞂	貝丆冂大
䞃	貝一厶攵
䞄	方𠂉也貝
䞅	貝厂二口
䞆	貝⺌貝󰁶
䞇	土八土貝
䞈	貝爫丿灬
䞉	貝丷夫貝
䞊	貝虍八目
䞋	貝立朩儿
䞌	贝丿古󰀝
䞍	贝月󰀝
䞎	贝日日󰀝
䞏	贝田心󰁶
䞐	贝三人日
䞑	土󰁖工󰀝
䞒	土󰁖冂口
䞓	土󰁖一工
䞔	土󰁖尸毛
䞕	土󰁖󰀙〢
䞖	土󰁾󰀁丶
䞗	土󰁾󰀛丿
䞘	土󰁾𠂉乙
䞙	土󰁾一丨
䞚	土󰁾十又
䞛	土󰁾一ㄅ
䞜	土󰁾丆卜
䞝	土󰁾王丶
䞞	土󰁾弓󰀯
䞟	土󰁾白󰀌
䞠	土󰁾石󰀌
䞡	土󰁾日一
䞢	土󰁾𠂉二
䞣	土󰁾斤丶
䞤	土󰁾勹口
䞥	土󰁾月
䞦	土󰁾夂口
䞧	土󰁾⺁口
䞨	土󰁾土土
䞩	土󰁾人口
䞪	土󰁾匚斤
䞫	土󰁾󰁬口
䞬	土󰁾禾乃
䞭	土󰁾厶夂
䞮	土󰁾人朩
䞯	土󰁾爫子
䞰	土󰁾土󰁖
䞱	土󰁾八口
䞲	土󰁾丿丶
䞳	土󰁾立口
䞴	土󰁾󰀼口
䞵	土󰁾又又
䞶	土󰁾日󰁤
䞷	土󰁾尸山
䞸	土󰁾二口
䞹	土󰁾白王
䞺	土󰁾⺁目
䞻	土󰁾󰁻力
䞼	土󰁾彑󰀓
䞽	土󰁾十小
䞾	土󰁾⺁几
䞿	宀󰀀八󰁾
䟀	土󰁾⺶工
䟁	土󰁾巛木
䟂	土󰁾日又
䟃	土󰁾厶彡
䟄	土󰁾貝
䟅	車斤土󰁾
䟆	土󰁾日󰀟
䟇	土󰁾幺人
䟈	土󰁾十王
䟉	土󰁾罒虫
䟊	土󰁾虍󰀓
䟋	土󰁾⺈言
䟌	土󰁾十󰁷
䟍	土󰁾丿方
䟎	土󰁾夫貝
䟏	土󰁾白木
䟐	土󰁾厂止
䟑	土󰁾人艹
䟒	土󰁾艹󰁷
䟓	口止丁󰀢
䟔	口止卜󰁶
䟕	口止又丶
䟖	口止山󰀢
䟗	口止󰁚󰀁
䟘	口止亠几
䟙	口止七刀
䟚	口止二󰀯
䟛	口止一丨
䟜	口止冂人
䟝	口止几又
䟞	口止小丿
䟟	斤丶口󰁾
䟠	口止戈󰁐
䟡	口止󰁚丶
䟢	口止⺈小
䟣	口止木丶
䟤	口止心丿
䟥	口止󰁻丿
䟦	口止丿又
䟧	口止田󰀝
䟨	口止󰁂󰀁
䟩	口止土厶
䟪	口止丿之
䟫	⺌冖口󰁾
䟬	口止丘󰀝
䟭	口止𠂉二
䟮	口止亻犬
䟯	口止丿古
䟰	口止彳丁
䟱	口止木冂
䟲	口止亠儿
䟳	口󰁾羽󰀌
䟴	口止厂󰀖
䟵	口止一丶
䟶	口止人土
䟷	口止扌斤
䟸	口止󰁝廾
䟹	口止爫寸
䟺	口止貝󰁶
䟻	口止人朩
䟼	口止一丶
䟽	口止亠󰀸
䟾	口止又又
䟿	口止󰁭氺
䠀	口止⺌口
䠁	口止厶二
䠂	木木口󰁾
䠃	口止一丶
䠄	口止ㄇ八
䠅	口止囗禾
䠆	口止󰀍󰀖
䠇	口止尸山
䠈	口止󰁬氺
䠉	口止宀󰃧
䠊	口止丨三
䠋	口止白十
䠌	口止水月
䠍	口止󰁃又
䠎	口止尸土
䠏	口止癶大
䠐	口止目犬
䠑	口止大土
䠒	口止古月
䠓	口止丷一
䠔	口止䒑󰀓
䠕	口止止木
䠖	口止冫口
䠗	口止丿犬
䠘	口止丿匕
䠙	口止亠方
䠚	口止宀󰂃
䠛	口止爫凵
䠜	口止艹耳
䠝	口止口貝
䠞	口止戊小
䠟	土䒑十󰁾
䠠	廿儿冖󰁾
䠡	口止虍一
䠢	艹罒冖󰁾
䠣	口止󰁂八
䠤	口止口十
䠥	口止㡀攵
䠦	口止𠂉日
䠧	口止尸日
䠨	口止⺈言
䠩	口止止󰀤
䠪	口止幺󰄃
䠫	口止耳乑
䠬	口止癶阝
䠭	口止木貝
䠮	口止丷灬
䠯	口止人艹
䠰	口止艹󰁷
䠱	口止尸虫
䠲	丿󰀽三󰁻
䠳	丿󰀽三山
䠴	丿󰀽三立
䠵	丿󰀽三寸
䠶	丿󰀽三大
䠷	丿󰀽三󰀪
䠸	丿󰀽三ㄅ
䠹	丿󰀽三人
䠺	丿󰀽三口
䠻	丿󰀽三弓
䠼	丿󰀽三刂
䠽	丿󰀽三䒑
䠾	丿󰀽三人
䠿	丿󰀽三貝
䡀	丿󰀽三一
䡁	丿󰀽三三
䡂	車󰁐丨󰀢
䡃	車力󰁥
䡄	車几󰁀
䡅	車川󰀢
䡆	車八厶󰁶
䡇	車二儿󰁀
䡈	車乂乂󰁶
䡉	車亠几󰁀
䡊	車⺁又󰁶
䡋	車十又󰁶
䡌	車厶󰁶
䡍	車夫󰁶
䡎	車丶尸󰁥
䡏	車弓厶󰁶
䡐	車宀匕󰁀
䡑	車󰁂󰀁󰁀
䡒	車田󰀝
䡓	彳車一丁
䡔	車夕夕󰁶
䡕	車了󰀩一
䡖	車一八土
䡗	工几丶車
䡘	車勹田󰀝
䡙	車丶艮󰁶
䡚	車白儿󰁀
䡛	車車󰀢
䡜	車土八土
䡝	車宀夕⺋
䡞	󰀣八車󰀬
䡟	車白丿十
䡠	車󰀥貝󰁶
䡡	車󰁴匕白
䡢	車丶尸艹
䡣	車冖車󰀢
䡤	土丿日車
䡥	車宀八口
䡦	車又又木
䡧	車󰁞灬󰁶
䡨	⺶工車󰀬
䡩	車十󰀣八
䡪	車丶尸羽
䡫	車夂三辶
䡬	車日罒又
䡭	車⺶󰁈一
䡮	車彳人󰁾
䡯	車丿囗心
䡰	士󰁅几車
䡱	車匚口口
䡲	車口口十
䡳	車󰀎八斤
䡴	車立日土
䡵	車䒑󰀓辶
䡶	車尸口辛
䡷	車艹土皿
䡸	車艹罒󰁐
䡹	車十冖󰁾
䡺	車三丨心
䡻	車丿目方
䡼	車󰀙口口
䡽	車丿土貝
䡾	車虍一犬
䡿	車󰀙口人
䢀	车𠂉乙󰁀
䢁	车月󰀝
䢂	车立󰀝
䢃	尸口辛乂
䢄	厶口木木
䢅	臼厂二󰀖
䢆	冖几厂寸
䢇	宀几厂寸
䢈	厂二󰀖日
䢉	󰀗丿囗󰀖
䢊	子辶󰀌
䢋	一󰀯辶󰀵
䢌	一冂丨辶
䢍	方辶󰀏
䢎	一廾辶󰀵
䢏	󰁦十辶󰀵
䢐	󰀐一辶󰀌
䢑	󰁚󰀁丶辶
䢒	六乂辶󰀦
䢓	宀一󰀛辶
䢔	人一口辶
䢕	戊一辶󰀌
䢖	󰁬󰀟辶󰀵
䢗	ㄇ󰁺辶󰀌
䢘	宀寸辶󰀦
䢙	貝辶󰀦
䢚	一日乂辶
䢛	冂八口辶
䢜	彐冖冂辶
䢝	一󰀚一辶
䢞	木木辶󰀦
䢟	方攵辶󰀦
䢠	火廾辶󰀵
䢡	廿󰄃木辶
䢢	人丶彐辶
䢣	夕言辶󰀌
䢤	禾木丶辶
䢥	一止目辶
䢦	亠幺󰀪辶
䢧	羽人彡辶
䢨	彳人人辶
䢩	五口攵辶
䢪	丿大口辶
䢫	阝工辶
䢬	爫冖夕辶
䢭	丷王冫辶
䢮	󰀙田辶󰀌
䢯	火火夕辶
䢰	羽亻󰁷辶
䢱	士罒貝辶
䢲	目目亻辶
䢳	几阝󰀢
䢴	丿阝󰀢
䢵	二厶阝󰀢
䢶	木阝󰀢
䢷	󰀼亠阝󰀢
䢸	󰀐󰀞阝󰀢
䢹	匚󰁃阝󰀢
䢺	凵山阝󰀢
䢻	匚丨󰁃阝
䢼	󰁺八阝󰀢
䢽	󰁺八口巴
䢾	丿土儿阝
䢿	宀女阝󰀢
䣀	⺈厂⺋阝
䣁	羽阝󰀢
䣂	二木阝󰀢
䣃	𠂉一止阝
䣄	人一朩阝
䣅	厂二󰀖阝
䣆	一巛工阝
䣇	一氺丶阝
䣈	口巴口巴
䣉	氵小丿巴
䣊	⺌冂口阝
䣋	丿米阝󰀢
䣌	广󰁚󰀁阝
䣍	大日󰁐阝
䣎	巛田阝󰀢
䣏	亻󰁺八阝
䣐	艹ㄇ大阝
䣑	厂日土阝
䣒	口丨一阝
䣓	一口冂阝
䣔	⺌貝阝󰀢
䣕	󰀋灬阝󰀢
䣖	󰀋灬口巴
䣗	白大十阝
䣘	⺌冖口阝
䣙	山月月阝
䣚	󰀻女阝󰀢
䣛	木人氺阝
䣜	虍󰀐󰀞阝
䣝	尸土丿阝
䣞	口口䒑阝
䣟	󰀄󰁜󰀄阝
䣠	夫夫日阝
䣡	丷王丿阝
䣢	二木󰁺阝
䣣	⺌冖口阝
䣤	目目亻阝
䣥	西一匕󰁀
䣦	西一力󰁥
䣧	西一󰀁丶
䣨	西一丿七
䣩	西一一乚
䣪	西一一丨
䣫	西一十又
䣬	西一戈󰁶
䣭	西一犬󰁶
䣮	西一丶
䣯	西一󰀐一
䣰	西一匚󰁃
䣱	西一勹口
䣲	西一厶廾
䣳	西一𠃌口
䣴	西一乂儿
䣵	西一耳󰀝
䣶	西一丿古
䣷	西一丿未
䣸	亻丿士一
䣹	西一亻戈
䣺	西一口月
䣻	西一人口
䣼	西一󰁸小
䣽	𠂉大口一
䣾	西一宀一
䣿	西一一皿
䤀	西一艹口
䤁	西一󰀎󰄃
䤂	西一甘木
䤃	西一立日
䤄	西一丆二
䤅	西一人刂
䤆	西一癶大
䤇	西一宀又
䤈	西一八皿
䤉	西一心皿
䤊	西一艹耳
䤋	丷西一󰀞
䤌	西一人口
䤍	西一廿丶
䤎	西一󰁻口
䤏	西一丨手
䤐	西一󰀄日
䤑	西一󰁺八
䤒	西一幺人
䤓	西一艹󰀓
䤔	氵車斤一
䤕	西一白木
䤖	西一日氺
䤗	立早夂一
䤘	西一人󰀞
䤙	西一彑虫
䤚	月日土󰀝
䤛	釒󰁐丨󰀢
䤜	釒丿七󰁀
䤝	釒󰁚卩󰀢
䤞	釒乚丶
䤟	釒冖几󰁀
䤠	釒止󰀝
䤡	釒冂土󰀝
䤢	釒口力󰁥
䤣	釒丿丷󰀛
䤤	釒亠ㄥ人
䤥	釒⺈厂⺋
䤦	釒亻戈󰁶
䤧	釒囗口󰀝
䤨	釒⺁󰀕󰁶
䤩	釒宀丿七
䤪	釒几木󰁶
䤫	釒山人乛
䤬	釒氵小丿
䤭	釒乂丨
䤮	釒止󰀤󰁥
䤯	釒一廾彡
䤰	土⺈人金
䤱	釒山斤󰀢
䤲	釒土󰁖󰁶
䤳	釒亠亻丶
䤴	釒了󰀪凵
䤵	釒丨三三
䤶	釒大日乚
䤷	釒匚日女
䤸	釒彑󰀓󰁶
䤹	釒宀火又
䤺	釒石斤󰀢
䤻	釒工月
䤼	釒白水󰁶
䤽	釒罒󰀫󰁶
䤾	釒爫臼󰀝
䤿	釒三丨手
䥀	釒凵丨虫
䥁	釒󰁻囗十
䥂	釒冖二󰀓
䥃	釒冖亻󰁷
䥄	釒厂󰁺日
䥅	十王王金
䥆	亠丨三金
䥇	釒丶尸羽
䥈	釒艹犬廾
䥉	釒宀⺈丶
䥊	釒貝󰁶
䥋	釒󰁸了灬
䥌	宀日日金
䥍	土䒑十金
䥎	釒厂二月
䥏	釒彳𠂉卩
䥐	󰁻乛亅金
䥑	釒木人夕
䥒	弓厶虫金
䥓	釒󰀎八土
䥔	釒覀米󰁶
䥕	釒㡀攵󰁶
䥖	釒丷西大
䥗	釒士二人
䥘	釒人人日
䥙	釒阝䒑󰀓
䥚	几目目金
䥛	釒三丨小
䥜	釒門木󰁶
䥝	釒󰁙󰁴匕
䥞	釒白方攵
䥟	釒扌日󰄃
䥠	釒艹戊口
䥡	釒丿丨木
䥢	士口䒑金
䥣	臼工几金
䥤	釒󰀙勹巳
䥥	釒立丿八
䥦	釒工辶
䥧	釒󰀥冖目
䥨	釒門口口
䥩	釒彳山攵
䥪	釒日幺灬
䥫	釒十戈󰁷
䥬	釒艹甫寸
䥭	一氺丶金
䥮	釒覀匚卩
䥯	釒罒厶匕
䥰	釒亠󰄃虫
䥱	釒宀臼灬
䥲	釒匚口人
䥳	釒丆󰀐夂
䥴	釒山亻𠃌
䥵	釒日土儿
䥶	釒厂禾止
䥷	釒⺮目刂
䥸	弓一八金
䥹	釒三丨󰀆
䥺	钅󰀄亅丿
䥻	钅二󰁜󰁀
䥼	钅勹󰁤󰁥
䥽	钅ㄥ丿丶
䥾	钅冖一一
䥿	钅⺁一󰁡
䦀	钅羽󰀝
䦁	钅三丿阝
䦂	钅丶尸羽
䦃	钅艹土日
䦄	钅一日󰀔
䦅	钅羊䒑口
䦆	钅目目又
䦇	󰂞八ㄅ󰁀
䦈	󰂞工󰀝
䦉	󰂞四󰀝
䦊	󰂞上小󰁶
䦋	󰂞󰁡攵
䦌	門土󰀌
䦍	門𠂉乙󰁫
䦎	門二儿󰁫
䦏	門人󰀯󰀵
䦐	門手󰀵
䦑	門ユ人󰀦
䦒	門石󰀌
䦓	門󰀥口󰀌
䦔	門日一󰀌
䦕	門䒑廾󰀵
䦖	門士口󰀌
䦗	門丿皿󰀌
䦘	門艮󰀦
䦙	門士寸󰀦
䦚	門丿古󰀌
䦛	門⺈󰁬亅
䦜	門五口󰀌
䦝	門土󰁖󰀦
䦞	門氵王󰀌
䦟	門人人土
䦠	門一󰀓丶
䦡	門宀󰃧󰀌
䦢	門氵土厶
䦣	門立口󰀌
䦤	門又又又
䦥	門木木󰀦
䦦	門金󰀌
䦧	門臼儿󰁫
䦨	門木日󰀌
䦩	門目夂󰀦
䦪	門日勹󰄃
䦫	門艹ㄇ大
䦬	門三丨大
䦭	門禾日󰀌
䦮	門三人日
䦯	門一厶攵
䦰	門⺈日乚
䦱	門爫丿灬
䦲	門⺈厂言
䦳	門󰁲丿阝
䦴	門罒土十
䦵	門一八乂
䦶	门⺈󰁬亅
䦷	门人人土
䦸	门ㄇ一丶
䦹	阝十󰀢
䦺	阝丁󰀢
䦻	阝子󰀝
䦼	阝ユ人󰁶
䦽	阝󰁻乛亅
䦾	丿󰃧厶儿
䦿	阝口丨󰀢
䧀	阝厶󰁶
䧁	阝勹口󰀝
䧂	阝刀口󰀝
䧃	阝田󰀝
䧄	阝夂口󰀝
䧅	阝一弓人
䧆	阝󰁺八󰁶
䧇	阝亠󰀔󰁶
䧈	阝西󰀝
䧉	阝日土󰀝
䧊	阝丿土口
䧋	阝目儿󰁀
䧌	阝爫女󰀝
䧍	阝八人口
䧎	阝口月󰀝
䧏	阝夂三丨
䧐	阝󰁸子󰀝
䧑	阝宀一󰁾
䧒	阝木人人
䧓	阝󰀼土口
䧔	阝人丶心
䧕	阝戈口󰀞
䧖	阝戈戈󰁶
䧗	阝𠂉日夂
䧘	阝彑󰀓󰁶
䧙	阝山人⺗
䧚	阝󰁸冂口
䧛	阝亠丷方
䧜	阝广󰁬口
䧝	阝凵丨虫
䧞	阝󰀋灬󰁶
䧟	阝爫臼󰀝
䧠	阝一日寸
䧡	阝广󰁬丨
䧢	阝匚口口
䧣	阝覀二小
䧤	阝业䒑夫
䧥	阝一日心
䧦	阝爫丿灬
䧧	阝丷王丶
䧨	阝业䒑未
䧩	阝乛耳攵
䧪	阝广大女
䧫	阝󰁸冖󰀓
䧬	阝宀一貝
䧭	阝丿囗心
䧮	阝宀三心
䧯	阝⺈口丶
䧰	阝󰁢灬小
䧱	九亻󰁷󰀝
䧲	干亻󰁷󰀝
䧳	止亻󰁷󰀝
䧴	十又亻󰁷
䧵	冖󰁜亻󰁷
䧶	亻󰁷六󰁧
䧷	夂󰁦亻󰁷
䧸	古亻󰁷󰀝
䧹	广亻亻󰁷
䧺	口亻󰁷
䧻	人一口󰁷
䧼	丿土口󰁷
䧽	丿米亻󰁷
䧾	人干口󰁷
䧿	󰁺日亻󰁷
䨀	丿丶米󰁷
䨁	󰁻乛亅󰁷
䨂	禾火亻󰁷
䨃	日宀女󰁷
䨄	人丶乛󰁷
䨅	大丷日󰁷
䨆	㡀攵亻󰁷
䨇	亻󰁷又又
䨈	宀一󰀤󰁷
䨉	貝貝女󰁷
䨊	亻󰁷亻一
䨋	󰀙丿七󰀅
䨌	󰀙二儿󰀅
䨍	󰀙二󰀯󰀬
䨎	󰀙弓厶󰁧
䨏	󰀙冫⺈人
䨐	󰀙人一口
䨑	󰀙一弓人
䨒	󰀙羽󰀘
䨓	󰀙囗口󰀘
䨔	󰀙⺌一儿
䨕	󰀙氵一󰀛
䨖	󰀙月󰀘
䨗	󰀙爫子󰀘
䨘	󰀙目儿󰀅
䨙	󰀙氵丿士
䨚	󰀙勹󰁤心
䨛	󰀙木斤󰀬
䨜	󰀙月月󰀘
䨝	󰀙月󰀘
䨞	󰀙丿口丶
䨟	󰀙氵土土
䨠	󰀙日勹󰄃
䨡	󰀙了󰀪凵
䨢	󰀙󰀎八󰄃
䨣	󰀙廿󰀜󰀬
䨤	󰀙由辶󰁧
䨥	󰀙亻󰁷又
䨦	󰀙亠丷方
䨧	󰀙立人󰁻
䨨	󰀙丿󰃧辶
䨩	󰀙礻󰁶丨
䨪	󰀙土日土
䨫	󰀙木人夕
䨬	󰀙氵木木
䨭	󰀙二厶月
䨮	󰀙三丨彐
䨯	󰀙阝木日
䨰	󰀙氵廿󰀜
䨱	󰀙彳𠂉夂
䨲	󰀙丆冂丶
䨳	󰀙目儿儿
䨴	󰀙业丷寸
䨵	󰀙氵覀早
䨶	󰀙厶目󰁈
䨷	󰀙木木又
䨸	󰀙阝爫心
䨹	󰀙亻丨灬
䨺	󰀙二厶厶
䨻	󰀙田󰀙田
䨼	月艹又
䨽	丨三丨己
䨾	广丨三三
䨿	一大丨三
䩀	丨三丨貝
䩁	丨三丨毛
䩂	丆囗〢乛
䩃	丆囗〢匕
䩄	丆囗〢󰁜
䩅	丆囗〢皮
䩆	丆囗〢二
䩇	丆囗〢口
䩈	丆囗〢母
䩉	丆囗〢甫
䩊	丆囗〢⺋
䩋	丆囗〢木
䩌	丆囗〢灬
䩍	丆囗〢小
䩎	丆囗〢人
䩏	丆囗〢人
䩐	廿󰀜𠂉乙
䩑	廿󰀜弓󰁀
䩒	廿󰀜一󰀛
䩓	廿󰀜勹厶
䩔	廿󰀜几又
䩕	廿󰀜󰁚卩
䩖	廿󰀜小丿
䩗	廿󰀜月󰀝
䩘	廿󰀜一幺
䩙	廿󰀜亠幺
䩚	廿󰀜󰁚丶
䩛	廿󰀜心丿
䩜	廿󰀜由󰀝
䩝	廿󰀜⺁󰂃
䩞	廿󰀜󰀥口
䩟	廿󰀜一人
䩠	廿󰀜丿廴
䩡	廿󰀜大人
䩢	廿󰀜扌斤
䩣	廿󰀜人朩
䩤	廿󰀜目儿
䩥	廿󰀜丿廴
䩦	亻丨攵󰀜
䩧	廿󰀜言󰀝
䩨	廿󰀜󰀍󰀖
䩩	廿󰀜宀⺋
䩪	廿󰀜宀󰃧
䩫	廿󰀜一丶
䩬	廿󰀜三󰀟
䩭	廿󰀜大口
䩮	廿󰀜󰁭氺
䩯	廿󰀜了一
䩰	廿󰀜口耳
䩱	廿󰀜人刂
䩲	廿󰀜广又
䩳	廿󰀜宀又
䩴	廿󰀜古月
䩵	廿󰀜冖車
䩶	廿󰀜凵虫
䩷	廿󰀜亠方
䩸	廿󰀜艹耳
䩹	廿󰀜一丨
䩺	廿󰀜八羽
䩻	廿󰀜󰀋灬
䩼	廿󰀜夂辶
䩽	廿󰀜匚口
䩾	廿󰀜广灬
䩿	廿󰀜十貝
䪀	廿󰀜宀心
䪁	廿󰀜业夫
䪂	廿󰀜木ㄇ
䪃	廿󰀜󰁸攵
䪄	廿󰀜󰁺八
䪅	廿󰀜罒虫
䪆	廿󰀜ㄇ䒑
䪇	廿󰀜艹寸
䪈	廿󰀜口辶
䪉	廿󰀜巛󰁒
䪊	廿󰀜立三
䪋	廿󰀜口辶
䪌	廿󰀜⺈丶
䪍	廿󰀜門󰀹
䪎	廿󰀜山口
䪏	󰁆口㐄人
䪐	󰁆口㐄丿
䪑	󰁆口㐄匕
䪒	󰁆口㐄王
䪓	󰁆口㐄口
䪔	󰁆口㐄甫
䪕	󰁆口㐄米
䪖	󰁆口㐄夂
䪗	󰁆口㐄又
䪘	󰁆口㐄󰁾
䪙	󰁆口㐄寸
䪚	󰁆口㐄羽
䪛	󰁆口㐄田
䪜	󰁆口㐄言
䪝	󰁆口㐄又
䪞	一大丨一
䪟	一冂丨一
䪠	丿ㄅ丨一
䪡	丿ㄅ丨一
䪢	丿ㄅ丨一
䪣	一冂丨一
䪤	丨三丨田
䪥	󰀥冖一一
䪦	立日工󰀝
䪧	立日也󰁀
䪨	立日勹丶
䪩	立日人乛
䪪	力口立日
䪫	立日一工
䪬	立日十子
䪭	立日立日
䪮	立日勹丿
䪯	火火冖日
䪰	立日立心
䪱	󰁁丆貝󰁶
䪲	一󰀯丆貝
䪳	󰁬丿丆貝
䪴	冖󰁜丆貝
䪵	󰀄亅丿貝
䪶	󰀐󰀞丆貝
䪷	勹口丆貝
䪸	󰁂󰀁丆貝
䪹	丆卜󰀞貝
䪺	土厶丆貝
䪻	厶廾丆貝
䪼	凵山丆貝
䪽	口一ㄅ貝
䪾	丆貝人彡
䪿	丿囗乂貝
䫀	󰁮丆貝󰁶
䫁	丿目丆貝
䫂	夕夕丆貝
䫃	厂二󰀖貝
䫄	丷口儿貝
䫅	宀木丆貝
䫆	戊𠃌丆貝
䫇	彡冂二貝
䫈	山人丶貝
䫉	豸丆貝󰁶
䫊	丆卜口貝
䫋	禾女丆貝
䫌	白丿十貝
䫍	丨三丨貝
䫎	又又又貝
䫏	󰀎八丆貝
䫐	木木丆貝
䫑	大丁口貝
䫒	󰁚󰀁日貝
䫓	立口丆貝
䫔	三丨刀貝
䫕	亠丷冖貝
䫖	󰀎八󰄃貝
䫗	󰁃丨二貝
䫘	日勹人貝
䫙	十艹木貝
䫚	ㄇ󰁈冂貝
䫛	亻ユ𠂉貝
䫜	山幺幺貝
䫝	禾日丆貝
䫞	丷王灬貝
䫟	口貝丆貝
䫠	彡丆卜貝
䫡	䒑󰁬〢貝
䫢	⺁虍几貝
䫣	爫幺大貝
䫤	冖日六貝
䫥	白󰁜厶貝
䫦	土厶皿貝
䫧	白大十貝
䫨	󰁡攵貝
䫩	厶厶厶貝
䫪	大乂乂貝
䫫	󰀻女丆貝
䫬	󰀄󰁜󰀄貝
䫭	口丨一貝
䫮	彐工口貝
䫯	方大丁貝
䫰	丆貝米㐄
䫱	丆冂〢貝
䫲	戊一口貝
䫳	罒勹虫貝
䫴	木木二貝
䫵	丿目宀貝
䫶	木乂乂貝
䫷	王口口貝
䫸	几丿虫刀
䫹	几丿虫工
䫺	丆厶几虫
䫻	几丿虫日
䫼	几丿虫人
䫽	几丿虫毛
䫾	几丿虫丿
䫿	几丿虫口
䬀	几丿虫力
䬁	几丿虫匕
䬂	几丿虫󰁐
䬃	几丿虫立
䬄	几丿虫一
䬅	几丿虫力
䬆	几丿虫刂
䬇	丷口儿虫
䬈	几丿虫儿
䬉	几丿虫󰁖
䬊	几丿虫人
䬋	几丿虫夂
䬌	虍几几虫
䬍	几丿虫心
䬎	几丿虫󰀞
䬏	几丿虫口
䬐	几丿虫女
䬑	几丿虫月
䬒	几丿虫又
䬓	几丿虫日
䬔	几丿虫刂
䬕	几丿虫虫
䬖	几丿虫王
䬗	日一勹虫
䬘	几丿虫口
䬙	几丿虫凵
䬚	几丿虫灬
䬛	几丿虫󰀟
䬜	几丿虫厶
䬝	几丿虫八
䬞	几丿虫寸
䬟	几丿虫刂
䬠	󰀙⺄〈丨
䬡	土丿日丨
䬢	人良刀󰁥
䬣	人良𠂉乙
䬤	尸人丶艮
䬥	󰀁丶人艮
䬦	人良几又
䬧	人良二儿
䬨	人良勹九
䬩	丆卜人艮
䬪	人良丆卜
䬫	人良󰁚丶
䬬	人良ㄇ大
䬭	口刀人艮
䬮	人良󰁐人
䬯	人良󰀥口
䬰	人良刀口
䬱	人良木一
䬲	人良勹口
䬳	人良丷󰀟
䬴	人良一木
䬵	人良亠人
䬶	人良艮󰁶
䬷	人良夕夕
䬸	一夕又艮
䬹	人良一土
䬺	人良羊󰀢
䬻	人良二戈
䬼	人良口月
䬽	人良丷儿
䬾	人良丷丿
䬿	人良尸毛
䭀	人良⺄辶
䭁	扌斤人艮
䭂	人良口巴
䭃	人良人心
䭄	人良一亅
䭅	人良囗古
䭆	匚丨󰁃艮
䭇	人良勹口
䭈	人良󰁬廴
䭉	人良月
䭊	人良艹大
䭋	人良亻木
䭌	古月人艮
䭍	人良皿
䭎	人良廿木
䭏	人良丶艹
䭐	人良丷心
䭑	人良䒑八
䭒	人良丿心
䭓	人良山䒑
䭔	人良丿辶
䭕	車斤人艮
䭖	人良广灬
䭗	人良立儿
䭘	人良日小
䭙	人良󰀄日
䭚	人良立土
䭛	人良乛攵
䭜	人良大小
䭝	人良人日
䭞	人良罒十
䭟	人良艹木
䭠	人良广八
䭡	人良爫心
䭢	人良宀丁
䭣	人良󰀴󰀳
䭤	人良口辶
䭥	人良丷艮
䭦	人良艹寸
䭧	人良广小
䭨	人良山口
䭩	人良广三
䭪	⺈󰁐日土
䭫	匕日䒑目
䭬	匕日巛目
䭭	䒑丿目貝
䭮	󰂞彡䒑目
䭯	禾日凵山
䭰	禾日三󰀟
䭱	禾日㡀󰁶
䭲	禾日大口
䭳	禾女白日
䭴	󰀋灬十󰀬
䭵	󰀋灬几丶
䭶	󰀋灬一󰀯
䭷	󰀋灬毛󰁀
䭸	󰀋灬八乂
䭹	󰀋灬󰁚卩
䭺	󰀋灬亠几
䭻	󰀋灬八刀
䭼	󰀋灬二󰀯
䭽	󰀋灬丿󰀟
䭾	󰀋灬犬󰁶
䭿	󰀋灬丿夫
䮀	󰀋灬勹巳
䮁	󰀋灬厶廾
䮂	󰀋灬丶
䮃	󰀋灬土厶
䮄	󰀋灬亠幺
䮅	󰀋灬戈󰁐
䮆	󰀋灬丆十
䮇	󰀋灬󰁬󰀟
䮈	󰀋灬夕夕
䮉	󰀋灬𠂉󰀕
䮊	󰀋灬一人
䮋	󰀋灬一刂
䮌	󰀋灬亻木
䮍	󰀋灬亠󰀔
䮎	󰀋灬乂丨
䮏	󰀋灬五口
䮐	󰀋灬冂口
䮑	󰀋灬爫寸
䮒	󰀋灬甫󰁶
䮓	󰀋灬󰀥早
䮔	󰀋灬丿󰁺
䮕	󰀋灬又又
䮖	󰀋灬日日
䮗	󰀋灬山干
䮘	󰀋灬臼儿
䮙	󰀋灬戈󰀞
䮚	󰀋灬土夂
䮛	󰀋灬阝寸
䮜	󰀋灬廿木
䮝	󰀋灬冖車
䮞	󰀋灬三日
䮟	󰀋灬宀又
䮠	󰀋灬一田
䮡	󰀋灬𠂉夂
䮢	󰀋灬丿臼
䮣	󰀋灬又木
䮤	󰀋灬冖󰁷
䮥	󰀋灬一丨
䮦	󰀋灬󰁸口
䮧	十早人灬
䮨	󰀋灬宀辛
䮩	󰀋灬󰀾月
䮪	󰀋灬夕木
䮫	󰀋灬󰀻女
䮬	󰀋灬艹大
䮭	󰀋灬爫儿
䮮	󰀋灬木夕
䮯	󰀋灬攵
䮰	󰀋灬亠古
䮱	󰀋灬一辶
䮲	󰀋灬󰁺八
䮳	󰀋灬丿田
䮴	󰀋灬癶䒑
䮵	󰀋灬立土
䮶	󰀋灬亻木
䮷	󰀋灬罒虫
䮸	󰀗乂乂灬
䮹	󰀋灬止󰀤
䮺	󰀋灬󰀴󰀳
䮻	󰀋灬士寸
䮼	󰀋灬火㐄
䮽	󰀋灬󰁙灬
䮾	󰀋灬立三
䮿	󰀋灬宀󰁾
䯀	󰀋灬耳耳
䯁	󰀋灬󰄹丶
䯂	󰀋灬󰀋木
䯃	󰀊󰀞宀女
䯄	󰀊󰀞口人
䯅	󰀊󰀞耳又
䯆	󰀾月乚󰁀
䯇	󰀾月力󰁥
䯈	󰀾月二儿
䯉	󰀾月⺈人
䯊	󰀾月丁口
䯋	󰀾月丶
䯌	󰀾月尸九
䯍	󰀾月人󰁻
䯎	󰀾月人干
䯏	󰀾月丿古
䯐	󰀾月冂人
䯑	󰀾月⺌儿
䯒	󰀾月彳丁
䯓	󰀾月土土
䯔	󰀾月宀七
䯕	󰀾月丿廴
䯖	󰀾月丶艮
䯗	󰀾月󰁴土
䯘	󰀾月宀儿
䯙	󰀾月甫󰁶
䯚	󰀾月幺月
䯛	󰀾月宀⺋
䯜	󰀾月日󰁤
䯝	󰀾月月
䯞	󰀾月ㄇ口
䯟	󰀾月䒑󰀓
䯠	󰀾月日皿
䯡	󰀾月䒑八
䯢	广木木月
䯣	󰀾月口貝
䯤	󰀾月人日
䯥	󰀾月日灬
䯦	󰀾月艹人
䯧	󰁸冖冂口
䯨	󰁸冂口大
䯩	󰁸冂口巴
䯪	󰁸冂口貝
䯫	日󰁸小口
䯬	󰁸囗口十
䯭	󰂞彡又󰁧
䯮	󰂞彡乃󰁣
䯯	󰂞彡小丿
䯰	󰂞彡人󰀯
䯱	󰂞彡丆卜
䯲	󰂞彡巴󰀅
䯳	󰂞彡八厶
䯴	󰂞彡几又
䯵	󰂞彡十廾
䯶	󰂞彡󰀐一
䯷	󰂞彡戈
䯸	󰂞彡冫人
䯹	󰂞彡彐又
䯺	󰂞彡󰁚口
䯻	󰂞彡丿口
䯼	󰂞彡犭火
䯽	󰂞彡立口
䯾	󰂞彡󰀼口
䯿	󰂞彡亠十
䰀	󰂞彡禾女
䰁	󰂞彡󰁭氺
䰂	󰂞彡爫木
䰃	󰂞彡䒑业
䰄	󰂞彡田心
䰅	󰂞彡丆貝
䰆	󰂞彡󰁻木
䰇	󰂞彡土日
䰈	󰂞彡⺶工
䰉	󰂞彡丿又
䰊	󰂞彡甫寸
䰋	󰂞彡日女
䰌	󰂞彡彳󰁾
䰍	󰂞彡木氺
䰎	󰂞彡口貝
䰏	󰂞彡十󰁷
䰐	󰂞彡匚皿
䰑	󰂞彡󰀙〢
䰒	󰂞彡艹󰀓
䰓	󰂞彡丿方
䰔	󰂞彡丿皿
䰕	󰂞彡虍皿
䰖	󰂞彡丿貝
䰗	丨王王乚
䰘	丨王王彡
䰙	一口冂又
䰚	一口冂文
䰛	一口冂丶
䰜	弓一口弓
䰝	一口冂日
䰞	弓土丿丨
䰟	二厶丿厶
䰠	白󰁜厶丨
䰡	白󰁜厶夫
䰢	白󰁜厶丁
䰣	丿田儿乂
䰤	木日白厶
䰥	戈口󰀞厶
䰦	白󰁜厶十
䰧	白󰁜厶几
䰨	丿田儿目
䰩	土丿日厶
䰪	󰀪人月厶
䰫	白󰁜厶儿
䰬	白󰁜厶口
䰭	丆冂〢厶
䰮	白󰁜厶丶
䰯	白󰁜厶󰁾
䰰	󰀙丆冂厶
䰱	󰀙口口厶
䰲	󰁢灬乚󰁀
䰳	󰁢灬丁󰀢
䰴	󰁢灬𠂉乙
䰵	󰁢灬子󰀝
䰶	󰁢灬亠󰄃
䰷	󰁢灬三丨
䰸	󰁢灬八厶
䰹	󰁢灬戈󰁶
䰺	󰁢灬斤󰀢
䰻	󰁢灬攵󰁶
䰼	󰁢灬人乛
䰽	󰁢灬一丨
䰾	󰁢灬巴󰁀
䰿	󰁢灬𠂉也
䱀	󰁢灬ㄇ大
䱁	󰁢灬木一
䱂	󰁢灬幺力
䱃	󰁢灬丿夫
䱄	󰁢灬⺁󰂃
䱅	󰁢灬一木
䱆	󰁢灬乃子
䱇	󰁢灬日一
䱈	󰁢灬二小
䱉	󰁢灬󰀐一
䱊	󰁢灬米󰁶
䱋	󰁢灬󰁺八
䱌	󰁢灬匚丨
䱍	󰁢灬一一
䱎	󰁢灬一一
䱏	󰁢灬一䒑
䱐	󰁢灬爫子
䱑	󰁢灬扌斤
䱒	󰁢灬口巴
䱓	󰁢灬丿廴
䱔	󰁢灬亻攵
䱕	󰁢灬𠂉母
䱖	󰁢灬一󰁃
䱗	󰀥夕又灬
䱘	禾刂󰁢灬
䱙	󰁢灬上又
䱚	󰁢灬󰁭氺
䱛	󰁢灬戈󰀞
䱜	󰁢灬󰁺日
䱝	󰁢灬白十
䱞	󰁢灬大小
䱟	󰁢灬尸古
䱠	󰁢灬戈戈
䱡	󰁢灬勹米
䱢	󰁢灬⺈亅
䱣	󰁢灬亠十
䱤	󰁢灬⺈臼
䱥	𠂉一冂灬
䱦	󰁢灬亻󰁷
䱧	󰁢灬丷⺋
䱨	󰁢灬木刂
䱩	󰁢灬冂󰄃
䱪	󰁢灬󰀔
䱫	木口刂灬
䱬	󰁢灬乛月
䱭	󰁢灬忄一
䱮	󰁢灬三大
䱯	󰁻乛亅灬
䱰	󰁢灬丿土
䱱	󰁢灬亠丨
䱲	󰁢灬彑󰀓
䱳	󰁢灬厂土
䱴	󰁢灬忄一
䱵	󰁢灬八羽
䱶	󰁢灬丶阝
䱷	虍󰁢灬攵
䱸	󰁢灬臼又
䱹	󰁢灬⺶工
䱺	󰁢灬山䒑
䱻	󰁢灬󰀾月
䱼	󰁢灬尸󰀖
䱽	󰁢灬人口
䱾	󰁢灬󰀻女
䱿	󰁢灬車斤
䲀	土䒑十灬
䲁	󰁢灬尸寸
䲂	󰁢灬方󰁾
䲃	󰁢灬巛木
䲄	󰁢灬𠂉攵
䲅	󰁢灬夫儿
䲆	󰁢灬󰁢灬
䲇	󰁢灬木辶
䲈	󰁢灬广木
䲉	󰁢灬󰀎斤
䲊	󰁢灬阝月
䲋	󰁢灬夫日
䲌	󰁢灬士人
䲍	丿󰁪丷灬
䲎	󰁢灬乛攵
䲏	󰁢灬火力
䲐	󰁢灬虍力
䲑	󰁢灬丷丶
䲒	󰁢灬⺈󰀟
䲓	󰁢灬人人
䲔	󰁢灬一一
䲕	󰁢灬䒑日
䲖	󰁢灬士寸
䲗	󰁢灬彳丁
䲘	󰁢灬⺮󰃧
䲙	󰁢灬⺮卩
䲚	󰁢灬木貝
䲛	󰁢灬艹目
䲜	󰁢灬󰁢灬
䲝	󰁢󰀞人⺋
䲞	󰁢󰀞立󰀝
䲟	󰁢󰀞󰁚卩
䲠	󰁢󰀞三日
䲡	󰁢󰀞丷一
䲢	月丷夫一
䲣	虍󰁢一攵
䲤	󰁢󰀞氵一
䲥	九󰁟灬󰁧
䲦	󰁟灬大󰁶
䲧	土󰁟灬󰁶
䲨	工󰁟灬󰁶
䲩	尸󰁟灬󰀦
䲪	大󰁟灬󰁶
䲫	一儿󰁟灬
䲬	󰁟灬󰁚󰀁
䲭	󰁚󰀁󰁟灬
䲮	二儿󰁟灬
䲯	乃丶󰁟灬
䲰	二厶󰁟灬
䲱	󰁟灬方󰁥
䲲	八厶󰁟灬
䲳	亠几󰁟灬
䲴	火󰁟灬󰁶
䲵	小丿󰁟灬
䲶	二儿󰁟灬
䲷	󰁟灬木󰁧
䲸	人󰀯󰁟灬
䲹	丆卜󰀞灬
䲺	甘󰁟灬󰁶
䲻	亠幺󰁟灬
䲼	丿󰁟灬
䲽	石󰁟灬󰁶
䲾	工一ㄅ灬
䲿	尸󰁴󰁟灬
䳀	󰁟灬丿夫
䳁	󰁟灬丶
䳂	刀口󰁟灬
䳃	󰁟灬夕⺋
䳄	止󰁴󰁟灬
䳅	󰁟灬口八
䳆	白󰁟灬󰁶
䳇	母󰁟灬󰁶
䳈	󰁟灬勹巳
䳉	夂󰁦󰁟灬
䳊	又丶灬
䳋	虫󰁟灬󰁶
䳌	厶月󰁟灬
䳍	󰁺八󰁟灬
䳎	臼󰁟灬󰁶
䳏	土土󰁟灬
䳐	冫⺈人灬
䳑	月󰁟灬
䳒	十戈󰁟灬
䳓	土丿󰁴灬
䳔	臼󰁟灬󰁧
䳕	爫孑󰁟灬
䳖	󰁟灬耳乚
䳗	󰁟灬丿丶
䳘	󰁟灬丿丶
䳙	由一ㄅ灬
䳚	日干󰁟灬
䳛	日女󰁟灬
䳜	人一朩灬
䳝	立口󰁟灬
䳞	三人󰀟灬
䳟	日月󰁟灬
䳠	丿士󰁺灬
䳡	亻󰁷󰁟灬
䳢	󰀎八󰁟灬
䳣	十戈󰁡灬
䳤	㡀󰁟灬󰁶
䳥	山人丶灬
䳦	宀一日灬
䳧	󰁟灬亻大
䳨	白王󰁟灬
䳩	西女󰁟灬
䳪	山丆冂灬
䳫	癶一大灬
䳬	廿󰀜󰁟灬
䳭	󰁮卩󰁟灬
䳮	月丶𠃌灬
䳯	丿一日灬
䳰	亻口木灬
䳱	󰁻乛亅灬
䳲	扌厂二灬
䳳	凵山二灬
䳴	罒󰀫󰁟灬
䳵	木人人灬
䳶	󰁟灬爫大
䳷	彳人人灬
䳸	广木木灬
䳹	󰁟灬宀又
䳺	人丶乛灬
䳻	車斤󰁟灬
䳼	󰁟灬匚口
䳽	山亻󰁷灬
䳾	癶一口灬
䳿	󰁝犬灬灬
䴀	立日土灬
䴁	宀日冂灬
䴂	⺈口󰀓灬
䴃	土土土灬
䴄	爫冖夕灬
䴅	十艹貝灬
䴆	业䒑夫灬
䴇	󰀙人丶灬
䴈	丿ㄇ米灬
䴉	罒一口灬
䴊	丷王丿灬
䴋	󰁟灬罒󰀔
䴌	󰁟灬艹󰀓
䴍	貝貝󰁟灬
䴎	田田田灬
䴏	廿口丬灬
䴐	宀王𠂉灬
䴑	又又又灬
䴒	󰀙口口灬
䴓	一冂丨一
䴔	六乂󰁠一
䴕	一夕刂一
䴖	月󰁠一
䴗	目犬󰁠一
䴘	⺁虍几一
䴙	尸口辛一
䴚	󰀥囗󰁘几
䴛	󰀥囗󰁘月
䴜	󰀥囗󰁘厶
䴝	󰀥囗󰁘又
䴞	󰀥囗󰁘󰁷
䴟	󰁙󰁴匕丶
䴠	󰁙󰁴匕大
䴡	一业丿匕
䴢	󰁙󰁴匕木
䴣	󰁙󰁴󰁴󰀛
䴤	󰁙󰁴匕
䴥	󰁙󰁴匕口
䴦	󰁙󰁴匕言
䴧	󰁙󰁴󰁴女
䴨	󰁙󰁴󰁴小
䴩	󰁙󰁴匕小
䴪	󰁙󰁴匕氺
䴫	󰁙󰁴󰁴󰁻
䴬	木人人丶
䴭	木人人丿
䴮	木人人山
䴯	木人人󰁤
䴰	木人人戈
䴱	木人人匕
䴲	木人人木
䴳	木人人八
䴴	木人人口
䴵	木人人廾
䴶	木人人丨
䴷	木人人儿
䴸	木人人子
䴹	木人人木
䴺	木人人口
䴻	禾勹丿夕
䴼	木人人戈
䴽	木人人十
䴾	木人人工
䴿	木人人󰀓
䵀	木人人貝
䵁	木人人寸
䵂	木人人古
䵃	木人人八
䵄	木人人䒑
䵅	󰁡攵夕
䵆	木人人󰀓
䵇	广木木攵
䵈	彳幺夂木
䵉	广木木刂
䵊	󰀼亠󰁺八
䵋	󰁺由八月
䵌	󰁺由八人
䵍	󰁺由八子
䵎	󰁺由八〢
䵏	󰁺由八彡
䵐	󰁺由八十
䵑	禾人氺丶
䵒	禾人氺日
䵓	禾人氺󰀟
䵔	禾人氺日
䵕	禾人氺古
䵖	匚丨󰁃氺
䵗	禾人氺田
䵘	禾人氺󰁤
䵙	禾人氺夕
䵚	禾人氺臼
䵛	禾人氺土
䵜	禾人氺󰀖
䵝	󰀹土灬乚
䵞	󰀹土灬刂
䵟	󰀹土灬干
䵠	󰀹土灬丶
䵡	一大󰀹灬
䵢	󰀹土灬未
䵣	󰀹土灬一
䵤	一廾󰀹灬
䵥	󰀹土灬巴
䵦	󰀹土灬󰀛
䵧	十戈󰀹灬
䵨	󰀹土灬丶
䵩	禾刂󰀹灬
䵪	󰀹土灬匕
䵫	宀夕⺋灬
䵬	󰀹土灬日
䵭	󰀹土灬日
䵮	󰀹土灬󰁤
䵯	󰀹土灬土
䵰	󰀹土灬󰁤
䵱	󰀹土灬口
䵲	󰀹土灬木
䵳	󰀹土灬日
䵴	󰀹土灬黽
䵵	⺮目大灬
䵶	勹口黽󰀝
䵷	土土黽󰀝
䵸	禾火黽󰀘
䵹	𠂉大口黽
䵺	土目󰁕󰁈
䵻	目󰁕丆彐
䵼	爿󰁝寸󰁈
䵽	士口䒑厶
䵾	亻寸土又
䵿	士口䒑口
䶀	士口䒑口
䶁	士口䒑日
䶂	臼󰁐󰁦丶
䶃	臼󰁐󰁦乛
䶄	臼󰁐󰁦十
䶅	臼󰁐󰁦口
䶆	臼󰁐󰁦󰁷
䶇	臼󰁐󰁦月
䶈	臼󰁐󰁦寸
䶉	臼󰁐󰁦田
䶊	丿目田一
䶋	丿目田󰂃
䶌	丿目田巳
䶍	一厶土󰀯
䶎	丿目田口
䶏	丷弓丨󰀯
䶐	丿目田日
䶑	丿目田󰁾
䶒	󰀴󰀳女󰀘
䶓	冂丨󰀴󰀳
䶔	止󰀆也󰁀
䶕	止󰀆巴󰁀
䶖	止󰀆人乛
䶗	止󰀆丁口
䶘	止󰀆立󰀝
䶙	止󰀆匚󰁃
䶚	止󰀆虫󰁶
䶛	一夕刂󰀆
䶜	止󰀆丿口
䶝	止󰀆大人
䶞	止󰀆󰀎八
䶟	止󰀆⺈臼
䶠	戊一口󰀆
䶡	止󰀆貝刂
䶢	止󰀆戊口
䶣	止󰀆山䒑
䶤	止󰀆󰀾月
䶥	止󰀆虍一
䶦	止󰀆貝
䶧	止󰀆土儿
䶨	止󰀆人人
䶩	止󰀆󰀴󰀳
䶪	止󰀆十󰁷
䶫	止󰀆口攵
䶬	干干立三
䶭	ヒ丶王
䶮	匕丶大
䶯	女丿󰁵󰀝
䶰	丿󰁵毛󰁀
䶱	夂󰁦丿󰁵
䶲	冂土丿󰁵
䶳	人一口几
䶴	火⺈人艹
䶵	人一口几
一	一一〇〇
丁	丁一亅
丂	一ㄅ󰁫
七	七一乚
丄	丨一󰀌
丅	一丨󰀵
丆	丆一丿
万	一󰁡󰀏
丈	󰂃󰀦
三	三一一一
上	上丨一一
下	一卜󰀦
丌	一󰀯󰀵
不	丆卜󰀦
与	一ㄅ一󰀌
丏	一丨󰄃𠃌
丐	一󰀥ㄅ󰁫
丑	󰁈丨一一
丒	刀丶一󰀘
专	二󰁓丶󰀦
且	󰀐一󰀌
丕	丆卜一󰀌
世	廿󰄃󰁫
丗	一〣一󰀌
丘	丘丿丨一
丙	一冂人󰀦
业	业丨丨一
丛	人人一󰀘
东	󰀂小󰀦
丝	󰁲󰁲一󰀘
丞	了󰀩一󰀘
丟	王厶󰁧
丠	丬匕一󰀘
両	一冂山󰀵
丢	丿土厶󰁧
丣	一󰀯匚󰁃
两	一冂人人
严	一业丿󰀏
並	䒑业󰀘
丧	十䒑󰀖󰁧
丨	丨丨〇〇
丩	󰁐丨󰀵
个	人丨󰀬
丫	丷丨󰀵
丬	丬丶󰀞丨
中	口丨󰀵
丮	⺄󰀟󰀵
丯	彡丨󰀵
丰	三丨󰀵
丱	󰀯󰁐丨一
串	口口丨󰀵
丳	口口󰀯󰀵
临	〢𠂉丶󰀱
丵	业䒑十󰀬
丶	丶丶〇〇
丷	丷丶丿
丸	九丶󰀦
丹	󰀼亠󰀌
为	丶力丶󰀦
主	丶王󰀌
丼	二󰀯丶󰀦
丽	一冂丶丶
举	󰀧一八󰀟
丿	丿丿〇〇
乀	丿󰂃󰀦
乁	一󰂃󰀦
乂	乂丿󰂃
乃	乃ㄋ丿
乄	󰁇丶󰀦
久	ク󰂃󰀦
乆	ㄥ人󰀦
乇	丿七󰁫
么	丿厶󰁧
义	丶乂󰀦
乊	丿丷󰀏
之	之之之之
乌	丿𠃌ㄅ一
乍	𠂉丨二󰀘
乎	丿丷󰀛󰀵
乏	丿之󰁧
乐	丿󰄃小󰀦
乑	乑丿丨󰂃
乒	丘丿󰁣
乓	丘丶󰁧
乔	丿大󰀯󰀬
乕	⺁二冂丨
乖	丿十丬匕
乗	禾󰁺󰀌
乘	禾丬匕󰁫
乙	乙乙〇〇
乚	乚乚〇〇
乛	乛乛〇〇
乜	󰂄乚󰁫
九	九丿󰁊
乞	𠂉乙󰀅
也	也󰂄丨乚
习	𠃌冫󰀌
乡	󰁲丿󰀏
乢	山乚󰁀
乣	幺乚󰁀
乤	一卜乙󰀅
乥	丿丷乙󰀅
书	󰁈𠃌丨丶
乧	󰁦十乙󰀅
乨	厶口乚󰁀
乩	󰀥口乚󰁀
乪	乙田󰀌
乫	力口乙󰀅
乬	匚󰁃乙󰀅
乭	石乙󰀅
乮	󰁚丿卩乙
乯	丿丷󰀛乙
买	乛󰁦大󰁧
乱	丿古乚󰁀
乲	冫⺈人乙
乳	爫孑乚󰁀
乴	扌斤乙󰀅
乵	辛乚󰁀
乶	甫乙󰀅
乷	氵小丿乙
乸	也母󰀦
乹	十早乚󰁀
乺	⺁󰁃斤乙
乻	方人󰁦乙
乼	氵丶王乙
乽	土丿日乙
乾	十早𠂉乙
乿	爫幺小乚
亀	⺈曰曰乚
亁	十曰干乙
亂	爫󰁻冂乚
亃	米夕㐄乚
亄	士冖一乚
亅	亅亅〇〇
了	了乛亅
亇	⺈亅󰀬
予	󰁻乛亅󰀬
争	⺈󰁬亅󰀬
亊	一丷󰁬亅
事	一口󰁬亅
二	二一一
亍	一丁󰀬
于	一󰀛󰀵
亏	二ㄅ󰀅
亐	二ㄅ󰁫
云	二厶󰁧
互	一彑󰀌
亓	二󰀯󰀬
五	五一丨一
井	二󰀯󰀵
亖	二二󰀘
亗	山二󰀘
亘	一曰一󰀘
亙	一丨󰁈一
亚	一业󰀌
些	止匕二󰀘
亜	一口〢一
亝	厶厶厶二
亞	一󰀚一󰀌
亟	了口又一
亠	亠丶一
亡	亠󰄃󰁫
亢	亠几󰀅
亣	亠󰀯󰀬
交	六乂󰁧
亥	亠ㄥ丿人
亦	亠󰁖󰁧
产	立丿󰀏
亨	󰁸了󰀬
亩	亠田󰀘
亪	亠󰁖一󰂃
享	󰁸子󰀘
京	󰁸小󰁧
亭	󰁸冖丁󰀬
亮	󰁸冖几󰀅
亯	󰁸曰󰀘
亰	亠曰小󰁧
亱	亠亻曰一
亲	立朩󰁧
亳	󰁸冖丿七
亴	󰁸冖土九
亵	亠扌九󰀔
亶	亠囗口一
亷	立丿󰁬八
亸	󰁸孑丷十
亹	亠󰀗ㄇ一
人	人人人人
亻	亻丿丨
亼	人一󰀘
亽	人丶󰁧
亾	人󰄃󰁫
亿	亻乙󰁀
什	亻十󰀢
仁	亻二󰀝
仂	亻力󰁥
仃	亻丁󰀢
仄	厂人󰀦
仅	亻又󰁶
仆	亻卜󰁶
仇	亻九󰁀
仈	亻八󰁶
仉	亻几󰁀
今	人丶乛󰀅
介	人󰀯󰀬
仌	人人󰁧
仍	亻乃󰁥
从	人人󰁶
仏	亻厶󰁶
仐	人十󰀬
仑	人匕󰀅
仒	人󰁦󰁧
仓	人⺋󰀅
仔	亻子󰀝
仕	亻士󰀝
他	亻也󰁀
仗	亻󰂃󰁶
付	亻寸󰁶
仙	亻山󰀢
仚	人山󰀬
仛	亻丿七󰁀
仜	亻工󰀝
仝	人工󰀘
仞	亻刀丶󰁶
仟	亻丿十󰀢
仠	亻干󰀢
仡	亻𠂉乙󰁀
仢	亻勹丶󰁶
代	亻󰀁丶󰁶
令	人丶󰁻󰁧
以	󰁐丶人󰁶
仦	亻小󰁶
仧	上人󰁧
仨	亻三󰀝
仩	亻上󰀝
仪	亻丶乂󰁶
仫	亻丿厶󰁶
们	亻门󰁀
仭	亻刀󰂃󰁶
仮	亻⺁又󰁶
仯	亻小丿󰁥
仰	亻󰁚卩󰀢
仱	亻人丶乛
仲	亻口丨󰀢
仳	亻󰁴匕󰁀
仴	亻月󰀝
仵	亻𠂉十󰀢
件	亻丿󰀟󰀢
价	亻人󰀯󰀢
仸	亻丿大󰁶
仹	亻三丨󰀢
仺	人匚一󰀘
任	亻丿士󰀝
仼	亻王󰀝
份	亻八刀󰁥
仾	亻一彑󰀝
仿	亻方󰁥
伀	亻八厶󰁶
企	人止󰀘
伂	亻一冂丨
伃	亻󰁻乛亅
伄	亻弓丨󰀢
伅	亻一凵乚
伆	亻勹󰁤󰁥
伇	亻几又󰁶
伈	亻心󰁶
伉	亻亠几󰁀
伊	亻󰁬丿󰁥
伋	亻乃󰂃󰁶
伌	亻厂⺋󰁀
伍	亻五󰀝
伎	亻十又󰁶
伏	亻犬󰁶
伐	亻戈󰁶
休	亻木󰁶
伒	亻斤󰀢
伓	亻丆卜󰁶
伔	亻冖几󰁀
伕	亻夫󰁶
伖	亻又󰁶
众	人人人󰁧
优	亻乚丶
伙	亻火󰁶
会	人二厶󰁧
伛	亻匚乂󰁶
伜	亻九十󰀢
伝	亻二厶󰁶
伞	人丷十󰀬
伟	亻二𠃌丨
传	亻二󰁓丶
伡	亻车󰀢
伢	亻󰀄亅丿
伣	亻ㄇ󰁜󰁀
伤	亻𠂉力󰁥
伥	亻丿七󰂃
伦	亻人匕󰁀
伧	亻人⺋󰁀
伨	亻勹冫󰀝
伩	亻文󰁶
伪	亻丶力丶
伫	亻宀一󰀝
伬	亻尸󰂃󰁶
伭	亻亠幺󰁶
伮	亻女又󰁶
伯	亻白󰀝
估	亻古󰀝
伱	亻人小󰁶
伲	亻尸匕󰁀
伳	亻廿󰄃󰁀
伴	亻丷󰀟󰀢
伵	亻四󰀝
伶	亻人丶󰁻
伷	亻由󰀝
伸	亻曰丨󰀢
伹	亻󰀐一󰀝
伺	亻𠃌一口
伻	亻一丷十
似	亻󰁐丶人
伽	亻力口󰀝
伾	亻丆卜一
伿	亻口八󰁶
佀	亻󰃧󰀝
佁	亻厶口󰀝
佂	亻一止󰀝
佃	亻田󰀝
佄	亻甘󰀝
佅	亻未󰁶
但	亻曰一󰀝
佇	亻宀丁󰀢
佈	亻冂丨
佉	亻土厶󰁶
佊	亻皮󰁶
佋	亻刀口󰀝
佌	亻止匕󰁀
位	亻立󰀝
低	亻󰁚󰀁丶
住	亻丶王󰀝
佐	亻工󰀝
佑	亻口󰀝
佒	亻ㄇ大󰁶
体	亻木一󰀝
佔	亻󰀥口󰀝
何	亻丁口󰀝
佖	亻心丿󰁥
佗	亻宀匕󰁀
佘	人二小󰁧
余	人一朩󰁧
佚	亻丿夫󰁶
佛	亻弓󰀯󰀢
作	亻𠂉丨二
佝	亻勹口󰀝
佞	亻二女󰀝
佟	亻夂󰁦󰁶
你	亻⺈小󰁶
佡	亻人山󰀢
佢	亻匚󰁃󰀝
佣	亻用󰀢
佤	亻一󰁐丶
佥	人一󰀧一
佦	亻石󰀝
佧	亻上卜󰁶
佨	亻勹巳󰁀
佩	亻几一丨
佪	亻囗口󰀝
佫	亻夂口󰀝
佬	亻土丿匕
佭	亻夂㐄󰀢
佮	亻人一口
佯	亻羊󰀢
佰	亻丆曰󰀝
佱	人二止󰀘
佲	亻夕口󰀝
佳	亻土土󰀝
佴	亻耳󰀝
併	亻䒑廾󰀢
佶	亻士口󰀝
佷	亻艮󰁶
佸	亻丿古󰀝
佹	亻⺈厂⺋
佺	亻人王󰀝
佻	亻儿󰀪󰁶
佼	亻六乂󰁶
佽	亻冫⺈人
佾	亻八月󰀝
使	亻一口乂
侀	亻一廾刂
侁	亻丿土儿
侂	亻广丿七
侃	亻口󰀸󰁀
侄	亻一厶土
侅	亻亠ㄥ人
來	木人人󰀦
侇	亻一弓人
侈	亻夕夕󰁶
侉	亻大二ㄅ
侊	亻⺌一儿
例	亻一夕刂
侌	人丶乛厶
侍	亻土寸󰁶
侎	亻米󰁶
侏	亻丿未󰁶
侐	亻丿皿󰀝
侑	亻月󰀝
侒	亻宀女󰀝
侓	亻󰁬󰀟󰀢
侔	亻厶丿󰀟
侕	亻丆冂〢
侖	人一冂艹
侗	亻冂一口
侘	亻宀丿七
侙	亻󰀁工丶
侚	亻勹日󰀝
供	亻󰁺八󰁶
侜	亻丿󰁪󰁶
依	亻亠󰀔󰁶
侞	亻女口󰀝
侟	亻丨子
侠	亻一丷大
価	亻覀󰀝
侢	亻一冂土
侣	亻口口󰀝
侤	亻土丿ㄅ
侥	亻󰀁丿儿
侦	亻󰀥贝󰁶
侧	亻贝刂󰀢
侨	亻丿大󰀯
侩	亻人二厶
侪	亻文󰀯󰀢
侫	亻亠󰄃女
侬	亻冖󰀔󰁶
侭	亻尸󰂃󰁦
侮	亻𠂉母󰁶
侯	亻ユ𠂉大
侰	亻󰁬丿口
侱	亻口王󰀝
侲	亻厂二󰀖
侳	亻人人土
侴	人一󰁈刂
侵	亻彐冖又
侶	亻口丿口
侷	亻尸𠃌口
侸	亻一口䒑
侹	亻丿士廴
侺	亻山人乛
侻	亻丷口儿
侼	亻十冖子
侽	亻田力󰁥
侾	亻土丿子
便	亻一曰乂
俀	亻爫女󰀝
俁	亻口󰁕大
係	亻丿幺小
促	亻口󰁾󰁶
俄	亻丿扌丶
俅	亻一氺丶
俆	亻人一朩
俇	亻犭󰁥王
俈	亻丿土口
俉	亻五口󰀝
俊	亻厶八夂
俋	亻口巴󰁀
俌	亻甫󰁶
俍	亻丶艮󰁶
俎	人人󰀐一
俏	亻⺌月󰀝
俐	亻禾刂󰀢
俑	亻󰁻用󰀢
俒	亻宀二儿
俓	亻一巛工
俔	亻目儿󰁀
俕	亻宀木󰁶
俖	亻丆卜口
俗	亻八人口
俘	亻爫子󰀝
俙	亻乂丨
俚	亻曰土󰀝
俛	亻⺈口󰁜
俜	亻由一ㄅ
保	亻口木󰁶
俞	人一月刂
俟	亻厶𠂉大
俠	亻大人人
信	亻言󰀝
俢	亻夂彡󰁥
俣	亻口一大
俤	亻丷弓丿
俥	亻車󰀢
俦	亻三丿寸
俧	亻士心󰁶
俨	亻一业丿
俩	亻一冂人
俪	亻一冂丶
俫	亻一丷木
俬	亻禾厶󰁶
俭	亻人一一
修	亻丨夂彡
俯	亻广亻寸
俰	亻禾口󰀝
俱	亻󰀣八󰁶
俲	亻六乂力
俳	亻丨三三
俴	亻戈戈󰁶
俵	亻󰀔󰁶
俶	亻上小又
俷	亻月巴󰁀
俸	亻三人󰀟
俹	亻一󰀚一
俺	亻大曰乚
俻	亻夂田󰀝
俼	亻亠厶月
俽	亻斤⺈人
俾	亻白丿十
俿	亻虍几󰁀
倀	亻󰀍󰀖󰁶
倁	亻𠂉大口
倂	亻丿一干
倃	亻夂卜口
倄	亻乂月
倅	亻亠人十
倆	亻一冂丶
倇	亻宀夕⺋
倈	亻木人人
倉	人丶彐口
倊	亻八厶心
個	亻囗古󰀝
倌	亻宀󰃧󰀝
倍	亻立口󰀝
倎	亻ㄇ󰁺八
倏	亻丨夂犬
倐	亻丨夂火
們	亻門󰀝
倒	亻一厶刂
倓	亻火火󰁶
倔	亻尸凵山
倕	亻丿士󰁺
倖	亻土䒑十
倗	亻月月󰀝
倘	亻⺌冂口
候	亻丨ユ大
倚	亻大丁口
倛	亻󰀎八󰁶
倜	亻󰀼土口
倝	十早人󰁶
倞	亻󰁸小󰁶
借	亻󰁺日󰀝
倠	亻亻󰁷󰀝
倡	亻曰曰󰀝
倢	亻一󰁬󰁾
倣	亻方攵󰁶
値	亻十目󰄃
倥	亻宀八工
倦	亻丷夫⺋
倧	亻宀二小
倨	亻尸古󰀝
倩	亻月󰀝
倪	亻臼儿󰁀
倫	亻人一艹
倬	亻󰀥早󰀢
倭	亻禾女󰀝
倮	亻曰木󰁶
倯	亻木八厶
倰	亻土八夂
倱	亻曰󰁴匕
倲	亻木曰󰀝
倳	亻一口亅
倴	亻大十廾
倵	亻一󰀁丶
倶	亻目一八
倷	亻大二小
倸	亻爫木󰁶
倹	亻人一人
债	亻贝󰁶
倻	亻耳阝󰀢
值	亻十󰀣󰀝
倽	亻人干口
倾	亻󰁴丆贝
倿	亻立女󰀝
偀	亻艹ㄇ大
偁	亻爫冂土
偂	亻䒑月刂
偃	亻匚曰女
偄	亻丆冂大
偅	亻丿一土
偆	亻三人日
假	亻󰁃丨又
偈	亻曰勹󰄃
偉	亻󰁆口㐄
偊	亻丿口丶
偋	亻尸䒑廾
偌	亻艹口
偍	亻日一󰁾
偎	亻田一󰀖
偏	亻丶尸艹
偐	亻立丿彡
偑	亻几丿虫
偒	亻曰一󰁤
偓	亻尸一土
偔	亻口口ㄅ
偕	亻󰁴匕白
偖	亻土丿日
偗	亻小丿目
偘	亻口口口
偙	亻亠丷丨
做	亻古攵󰁶
偛	亻丿十臼
停	亻󰁸冖丁
偝	亻丬匕月
偞	亻廿󰄃木
偟	亻白王󰀝
偠	亻覀女󰀝
偡	亻󰀎八󰄃
偢	亻禾火󰁶
偣	亻立日󰀝
偤	亻丷西一
健	亻󰁬󰀟廴
偦	亻乛󰁾月
偧	亻大夕夕
偨	亻止匕木
偩	亻⺈貝󰁶
偪	亻一口田
偫	亻彳土寸
偬	亻勹󰁤心
偭	亻丆囗二
偮	亻口耳󰀝
偯	亻󰁸󰀔󰁶
偰	亻三丨大
偱	亻⺁十目
偲	亻田心󰁶
偳	亻山丆〢
側	亻貝刂󰀢
偵	亻󰀥貝󰁶
偶	亻曰冂丶
偷	亻人一刂
偸	亻人一巜
偹	亻丨夂田
偺	亻夂卜日
偻	亻米女󰀝
偼	亻󰀥󰁬󰁾
偽	亻丶丿灬
偾	亻十艹贝
偿	亻⺌冖厶
傀	亻白儿厶
傁	亻臼丨又
傂	亻⺁虍几
傃	亻幺小
傄	亻大丷目
傅	亻甫寸󰁶
傆	亻厂白小
傇	亻艹耳󰀝
傈	亻覀木󰁶
傉	亻厂二寸
傊	亻口貝󰁶
傋	亻󰀀冂土
傌	亻󰀋灬󰁶
傍	亻亠丷方
傎	亻十󰀣八
傏	亻广󰁬口
傐	亻󰁸冂口
傑	亻夕㐄木
傒	亻爫幺大
傓	亻丶尸羽
傔	亻䒑󰁬八
傕	亻冖亻󰁷
傖	亻人丶口
傗	亻亠幺田
傘	人人人十
備	亻󰁺丿用
傚	亻六乂攵
傛	亻宀八口
傜	亻爫𠂉凵
傝	亻曰羽󰀝
傞	亻⺶工󰀝
傟	亻八厶羽
傠	亻言寸󰁶
傡	亻立立󰀝
傢	亻宀一󰀓
傣	亻三人氺
傤	亻十戈车
傥	亻⺌冖儿
傦	亻󰀾月󰀝
傧	亻宀丘八
储	亻讠土曰
傩	亻又亻󰁷
傪	亻厶厶彡
傫	亻田幺小
催	亻山亻󰁷
傭	亻广󰁬丨
傮	亻一ㄇ日
傯	亻丿囗心
傰	亻山月月
傱	亻彳人󰁾
傲	亻󰁡攵
傳	亻一曰寸
傴	亻匚口口
債	亻貝󰁶
傶	亻戊上小
傷	亻𠂉日󰁤
傸	亻大乂乂
傹	亻立曰儿
傺	亻󰁯二小
傻	亻丿囗夂
傼	亻廿口夫
傽	亻立早󰀢
傾	亻󰁴丆貝
傿	亻一止灬
僀	亻廿儿丨
僁	亻丿米心
僂	亻󰀻女󰀝
僃	亻艹勹用
僄	亻覀二小
僅	亻廿口
僆	亻車辶󰁶
僇	亻羽人彡
僈	亻曰罒又
僉	人一口人
僊	亻覀大巳
僋	亻人丶貝
僌	亻車攵󰁶
働	亻丿一力
僎	亻巳巳八
像	亻⺈口󰀓
僐	亻羊䒑口
僑	亻丿大口
僒	亻宀八口
僓	亻口丨貝
僔	亻丷西寸
僕	亻业䒑夫
僖	亻士口口
僗	亻火火力
僘	亻⺌冂攵
僙	亻󰁺由八
僚	亻大丷小
僛	亻󰀎八人
僜	亻癶一䒑
僝	亻尸子子
僞	亻爫丿灬
僟	亻幺幺人
僠	亻丿米田
僡	亻一曰心
僢	亻爫冖㐄
僣	亻夫夫日
僤	亻口口十
僥	亻土土儿
僦	亻󰁸小丶
僧	亻丷󰀺曰
僨	亻十艹貝
僩	亻門月󰀝
僪	亻󰁻乛口
僫	亻一󰀚心
僬	亻亻󰁷灬
僭	亻󰀄󰁜日
僮	亻立曰土
僯	亻米夕㐄
僰	木冂木人
僱	亻丶尸󰁷
僲	亻覀夕㐄
僳	亻覀米󰁶
僴	亻門日󰀝
僵	亻一田一
僶	亻黽󰀝
僷	亻艹廿木
僸	亻木木小
價	亻覀貝󰁶
僺	亻口口木
僻	亻尸口辛
僼	亻ㄇ󰁺䒑
僽	亻禾火心
僾	亻爫冖夂
僿	亻宀󰀀土
儀	亻丷王丶
儁	亻亻󰁷𠃌
儂	亻ㄇ󰁺󰀖
儃	亻亠囗一
億	亻立日心
儅	亻⺌冖田
儆	亻艹勹攵
儇	亻罒一󰀔
儈	亻人一日
儉	亻人一人
儊	亻木木󰁾
儋	亻⺈厂言
儌	亻白方攵
儍	亻󰁘凵夂
儎	亻十戈車
儏	亻󰀥夕米
儐	亻宀一貝
儑	亻日幺灬
儒	亻󰀙丆〢
儓	亻士口土
儔	亻士乛寸
儕	亻󰀴󰀳󰀝
儖	亻匚丨皿
儗	亻匕𠂉󰁾
儘	亻󰁬丨皿
儙	亻口丨辶
儚	亻艹罒夕
儛	亻𠂉一㐄
儜	亻宀心丁
儝	亻火火木
儞	亻一八乂
償	亻⺌冖貝
儠	亻巛囗󰁒
儡	亻田田田
儢	亻虍田心
儣	亻广󰁺八
儤	亻曰󰁺氺
儥	亻士罒貝
儦	亻󰁙󰁴灬
儧	亻夫夫貝
儨	亻斤斤貝
儩	亻貝日󰁤
優	亻丆󰀐夂
儫	亻󰁸冖󰀓
儬	亻月儿
儭	亻立朩儿
儮	亻厂禾止
儯	亻丷夫灬
儰	亻艹爫灬
儱	亻立月三
儲	亻言土日
儳	亻⺈口丶
儴	亻亠口󰀔
儵	亻丨夂灬
儶	亻山亻口
儷	亻一ㄇ匕
儸	亻罒糹󰁷
儹	亻丿土貝
儺	亻廿口󰁷
儻	亻⺌冖灬
儼	亻口口攵
儽	亻田田小
儾	亻一口󰀔
儿	儿丿乚
兀	一儿󰁫
允	厶儿󰀅
兂	󰀄󰁜󰁫
元	二儿󰀅
兄	口儿󰀅
充	亠厶儿󰀅
兆	儿󰀪󰀦
兇	乂凵儿󰀅
先	丿土儿󰀅
光	⺌一儿󰀅
兊	八厶儿󰀅
克	古儿󰀅
兌	八口儿󰀅
免	⺈口󰁜󰀅
兎	丿口󰁜丶
兏	厂上儿󰁫
児	丨日儿󰀅
兑	丷口儿󰀅
兒	臼儿󰀅
兓	󰀄󰁜󰀄󰁜
兔	⺈口󰁜丶
兕	丨󰁎丨儿
兖	六厶儿󰀅
兗	六口儿󰀅
兘	二儿厶口
兙	古儿十󰀵
党	⺌冖口儿
兛	古儿丿十
兜	白󰁚󰁃儿
兝	古儿八刀
兞	古儿毛󰁫
兟	丿土󰁜儿
兠	白丬匕儿
兡	古儿丆日
兢	古儿古儿
兣	古儿厂土
兤	⺌一儿八
入	丿󰂃󰀦
兦	丿󰂃󰄃󰁫
內	冂丿󰂃󰀦
全	人王󰀘
兩	一冂丨丶
兪	人一月巜
八	八丿󰂃
公	八厶󰁧
六	六丶一丶
兮	八一ㄅ󰀅
兯	丷卩󰀬
兰	丷三󰀘
共	󰁺八󰁧
兲	王八󰁧
关	䒑大󰁧
兴	󰀧一八󰁧
兵	丘八󰁧
其	󰀎八󰁧
具	󰀣八󰁧
典	ㄇ󰁺八󰁧
兹	䒑幺幺󰁧
兺	八刀口匕
养	䒑夫󰀯󰀬
兼	䒑󰁬〢八
兽	丷田一口
兾	丷田󰁺八
兿	䒑扌九厶
冀	丬匕田八
冁	丷曰十󰀖
冂	冂丨𠃌
冃	冂二󰀌
冄	冂二󰀌
内	冂人󰀦
円	冂丨一󰀌
冇	冂󰀅
冈	冂乂󰀦
冉	冂土󰀌
冊	冂艹󰀵
冋	冂口󰀌
册	󰀼󰀼一󰀌
再	一冂土󰀌
冎	ㄇ󰁈冂󰀅
冏	冂八口󰀌
冐	󰀰月󰀘
冑	由月󰀘
冒	󰀰目󰀘
冓	󰀀冂土󰀘
冔	󰀰口一󰀛
冕	󰀰⺈口󰁜
冖	冖丶乛
冗	冖几󰀅
冘	冖󰁜󰁫
写	冖一ㄅ一
冚	冖山󰀬
军	冖车󰀬
农	冖󰀔󰀦
冝	冖󰀐一󰀘
冞	冖米󰁧
冟	冖白匕󰀅
冠	冖二儿寸
冡	冖二󰀓󰁧
冢	冖一󰀓丶
冣	冖耳又󰁧
冤	冖⺈口丶
冥	冖曰六󰁧
冦	冖二儿又
冧	冖木木󰁧
冨	冖一口田
冩	冖臼勹灬
冪	冖艹曰丨
冫	冫丶󰀞
冬	夂󰁦󰁧
冭	大󰁦󰁧
冮	冫工󰀝
冯	冫󰀊一󰀝
冰	冫水󰁶
冱	冫一彑󰀝
冲	冫口丨󰀢
决	冫ユ人󰁶
冴	冫󰀄亅丿
况	冫口儿󰁀
冶	冫厶口󰀝
冷	冫人丶󰁻
冸	冫丷󰀟󰀢
冹	冫又丶
冺	冫󰁂󰀁󰁀
冻	冫󰀂小󰁶
冼	冫丿土儿
冽	冫一夕刂
冾	冫人一口
冿	冫󰁬󰀟󰀢
净	冫⺈󰁬亅
凁	冫木口󰀝
凂	冫⺈口󰁜
凃	冫人一朩
凄	冫一󰁬女
凅	冫囗古󰀝
准	冫亻󰁷󰀝
凇	冫木八厶
凈	冫爫󰁬亅
凉	冫󰁸小󰁶
凊	冫月󰀝
凋	冫󰀼土口
凌	冫土八夂
凍	冫木曰󰀝
凎	冫金󰀝
减	冫戊一口
凐	冫覀土󰀝
凑	冫三人大
凒	冫山一䒑
凓	冫覀木󰁶
凔	冫人丶口
凕	冫冖曰六
凖	冫亻󰁷十
凗	冫山亻󰁷
凘	冫󰀎八斤
凙	冫罒土十
凚	冫木木小
凛	冫亠囗小
凜	冫亠囗禾
凝	冫匕𠂉󰁾
凞	冫丿匚灬
凟	冫士罒貝
几	几丿󰁊
凡	几丶󰀦
凢	丿几󰁫
凣	丨几󰁫
凤	几又󰀦
凥	尸几󰁫
処	夂几󰁫
凧	几冂丨󰀵
凨	几二厶󰀦
凩	几木󰀦
凪	几止󰀌
凫	󰁠几󰀅
凬	几一日󰀌
凭	亻丿士几
凮	几丆日󰀌
凯	山󰁁几󰁀
凰	几白王󰀌
凱	山一口几
凲	几䒑󰁬八
凳	癶一口几
凴	冫󰀋灬几
凵	凵󰄃丨
凶	乂凵󰀵
凷	土凵󰀵
凸	丨一丨一
凹	丨󰁎丨一
出	凵山󰀵
击	󰀟凵󰀵
凼	水凵󰀵
函	了󰀪凵󰀵
凾	了口又凵
凿	业䒑十凵
刀	刀𠃌丿
刁	𠃌󰀞󰀌
刂	刂丨亅
刃	刀丶󰀦
刄	刀󰂃󰀦
刅	刀八󰀦
分	八刀󰁣
切	七刀󰁥
刈	乂刂󰀢
刉	𠂉乙刂󰀢
刊	干刂󰀢
刋	丿刂󰀢
刌	寸刂󰀢
刍	⺈彐󰀘
刎	勹󰁤刂󰀢
刏	气刂󰀢
刐	󰀼亠刂󰀢
刑	一廾刂󰀢
划	戈刂󰀢
刓	二儿刂󰀢
刔	ユ人刂󰀢
刕	刀刀刀󰁣
刖	月刂󰀢
列	一夕刂󰀢
刘	文刂󰀢
则	贝刂󰀢
刚	冂乂刂󰀢
创	人⺋刂󰀢
刜	弓󰀯刂󰀢
初	衤󰁧刀󰁥
刞	󰀐󰀞刂󰀢
刟	刀口刂󰀢
删	󰀼󰀼一刂
刡	󰁂󰀁刂󰀢
刢	人丶󰁻刂
刣	厶口刂󰀢
判	丷󰀠刂󰀢
別	口󰁡刂󰀢
刦	土厶刂󰀢
刧	土厶刀󰁥
刨	勹巳刂󰀢
利	禾刂󰀢
刪	冂艹刂󰀢
别	口力刂󰀢
刬	一戈刂󰀢
刭	ス工刂󰀢
刮	丿古刂󰀢
刯	一曰󰀞刂
到	一厶土刂
刱	二󰀯刀八
刲	土土刂󰀢
刳	大二ㄅ刂
刴	乃木刂󰀢
刵	耳刂󰀢
制	𠂉一冂刂
刷	尸冂丨刂
券	丷夫刀󰁣
刹	乂朩刂󰀢
刺	木冂刂󰀢
刻	亠ㄥ丿刂
刼	土厶刀丶
刽	人二厶刂
刾	一丷大刂
刿	山夕刂󰀢
剀	山󰁁刂󰀢
剁	几木刂󰀢
剂	文󰀯刂󰀢
剃	丷弓丨刂
剄	一巛工刂
剅	一口䒑刂
剆	丶󰁮刂󰀢
則	貝刂󰀢
剈	口月刂󰀢
剉	人人土刂
削	⺌月刂󰀢
剋	古儿刂󰀵
剌	木口刂󰀢
前	䒑月刂󰀬
剎	乂木丶刂
剏	䒑廾刀丶
剐	口冂人刂
剑	人一󰀧刂
剒	󰁺日刂󰀢
剓	禾勹丿刀
剔	曰勹󰁤刂
剕	丨三丨刂
剖	立口刂󰀢
剗	戈戈刂󰀢
剘	󰀎八刂󰀢
剙	䒑廾刀八
剚	一口󰁬刂
剛	冂䒑山刂
剜	宀夕⺋刂
剝	彑氺刂󰀢
剞	大丁口刂
剟	又又又刂
剠	󰁸小刂󰀢
剡	火火刂󰀢
剢	一󰀓丶刂
剣	人一口刂
剤	文󰀳刂󰀢
剥	󰁭氺刂󰀢
剦	大曰乚刂
剧	尸古刂󰀢
剨	三丨石刂
剩	禾丬匕刂
剪	䒑月刂刀
剫	广廿又刂
剬	山丆冂刂
剭	尸一厶刂
剮	ㄇ󰁈冂刂
副	一口田刂
剰	禾󰁺刂󰀢
剱	人一口丶
割	宀三丨刂
剳	艹人一刂
剴	山一口刂
創	人丶彐刂
剶	彑󰀓刂󰀢
剷	立丿丿刂
剸	一曰丨刂
剹	羽人彡刂
剺	未攵厂刀
剻	山月月刂
剼	厶厶厶刂
剽	覀二小刂
剾	匚口口刂
剿	巛曰木刂
劀	󰁻乛亅刂
劁	亻󰁷灬刂
劂	厂䒑凵刂
劃	󰁬土田刂
劄	⺮人一刂
劅	罒勹虫刂
劆	广䒑󰁬〢
劇	虍一󰀓刂
劈	尸口辛刀
劉	󰁚丶刀刂
劊	人一󰀺刂
劋	口口口刂
劌	止戊一刂
劍	人一口刂
劎	人一口刀
劏	⺌冖口刂
劐	艹亻󰁷刂
劑	󰀴󰀳刂󰀢
劒	人一口丶
劓	丿目田刂
劔	人一口󰂃
劕	斤斤貝刂
劖	⺈口󰁴刂
劗	丿土󰁜刂
劘	广木木刂
劙	彑󰀓虫刂
劚	尸氺罒刂
力	力𠃌丿
劜	力乚󰁀
劝	又力󰁥
办	力八󰀦
功	工力󰁥
加	力口󰀝
务	夂力󰁣
劢	一󰁡力󰁥
劣	小丿力󰁣
劤	斤力󰁥
劥	亠几力󰁥
劦	力力力󰁣
劧	手力󰁥
动	二厶力󰁥
助	󰀐󰀞力󰁥
努	女又力󰁣
劫	土厶力󰁥
劬	勹口力󰁥
劭	刀口力󰁥
劮	丿夫力󰁥
劯	石力󰁥
劰	白力󰁥
励	厂一󰁡力
劲	ス工力󰁥
劳	艹冖力󰁣
労	󰀧冖力󰁣
劵	丷夫力󰁣
劶	⺁一口力
劷	⺶力󰁥
劸	土土力󰁥
効	六乂力󰁥
劺	厶丿󰀟力
劻	匚王力󰁥
劼	士口力󰁥
劽	一夕刂力
劾	亠ㄥ丿力
势	扌九丶力
勀	古儿力󰁥
勁	一巛工力
勂	丿土口力
勃	十冖孑力
勄	𠂉母力󰁥
勅	木口力󰁥
勆	丶󰁮力󰁥
勇	󰁻用力󰁣
勈	󰁻用力󰁥
勉	⺈口󰁜力
勊	古儿力󰀏
勋	口贝力󰁥
勌	丷夫⺋力
勍	󰁸小力󰁥
勎	土八土力
勏	立口力󰁥
勐	子皿力󰁥
勑	木人人力
勒	廿󰀜力󰁥
勓	󰁴匕白力
勔	丆囗〢力
動	丿一曰力
勖	󰀰目力󰁥
勗	曰󰀐󰀞力
勘	󰀎八󰄃力
務	󰁻乛亅力
勚	廿󰄃贝力
勛	口貝力󰁥
勜	八厶羽力
勝	月丷夫力
勞	火火冖力
募	艹曰大力
勠	羽人彡力
勡	覀二小力
勢	土八土力
勣	貝力󰁥
勤	廿口力
勥	弓口虫力
勦	巛曰木力
勧	𠂉一亻力
勨	⺈口󰀓力
勩	廿󰄃貝力
勪	丿大口力
勫	丿米田力
勬	丷夫幺力
勭	立曰土力
勮	虍一󰀓力
勯	亠囗口力
勰	力力力心
勱	艹曰冂力
勲	丿一曰灬
勳	丿一󰀹力
勴	虍田心力
勵	厂艹曰力
勶	彳亠厶月
勷	亠口口力
勸	艹口口力
勹	勹丿𠃌
勺	勹丶󰀦
勻	勹二󰀌
勼	勹九󰁫
勽	勹人󰀦
勾	勹厶󰀦
勿	勹󰁤󰀏
匀	勹冫󰀌
匁	勹乂󰀦
匂	勹匕󰁫
匃	勹人󰄃󰁫
匄	勹亠󰄃󰁫
包	勹巳󰁫
匆	勹󰁤丶󰀦
匇	勹夕󰀦
匈	勹乂凵󰀵
匉	勹一丷十
匊	勹米󰀦
匋	勹𠂉十凵
匌	勹人一口
匍	勹甫󰀦
匎	勹大曰乚
匏	大二ㄅ巳
匐	勹一口田
匑	勹丿󰀽弓
匒	勹艹人口
匓	勹󰁮几又
匔	勹丿󰀽口
匕	匕丿乚
化	亻ヒ󰁀
北	丬匕󰁀
匘	匕巛丿乂
匙	曰一󰁾匕
匚	匚一󰄃
匛	匚ク󰂃󰀦
匜	匚也󰁫
匝	匚冂丨󰀵
匞	匚工󰀌
匟	匚亠几󰁫
匠	匚斤󰀵
匡	匚王󰀌
匢	匚勹󰁤󰀏
匣	匚甲󰀵
匤	匚王丶󰀦
匥	匚厶廾󰀵
匦	匚车九󰁫
匧	匚大人人
匨	匚爿士󰀌
匩	匚凵丨王
匪	匚丨三三
匫	匚勹󰁤曰
匬	匚人一刂
匭	匚車九󰁫
匮	匚口丨贝
匯	匚氵亻󰁷
匰	匚口口十
匱	匚口丨貝
匲	匚大口口
匳	匚人一人
匴	匚⺮目廾
匵	匚士罒貝
匶	匚艹亻臼
匷	匚目目󰁷
匸	匚一󰄃
匹	匚儿󰁫
区	匚乂󰀦
医	匚𠂉大󰀦
匼	匚人一口
匽	匚曰女󰀌
匾	匚丶尸艹
匿	匚艹口
區	匚口口口
十	十一丨
卂	⺄十󰀵
千	丿十󰀵
卄	艹一丨丨
卅	一川󰀵
卆	九十󰀬
升	丿廾󰀵
午	𠂉十󰀬
卉	十廾󰀬
半	丷󰀟󰀵
卋	十廿󰀘
卌	一󰀷󰀵
卍	󰁎丨一丨
华	亻ヒ十󰀬
协	十力八󰁶
卐	󰁕一丨一
卑	白丿十󰀬
卒	亠人人十
卓	󰀥早󰀬
協	十力力力
单	丷曰十󰀬
卖	十乛󰁦大
南	十冂䒑十
単	󰀧曰十󰀬
卙	󰀎八󰄃十
博	十甫寸󰁶
卛	言糹糹十
卜	卜丨丶
卝	丨一󰀥󰀝
卞	亠卜󰁧
卟	口卜󰁶
占	󰀥口󰀘
卡	上卜󰁧
卢	󰀥尸󰁣
卣	󰀥囗󰁃󰀘
卤	󰀥囗乂󰁧
卥	󰀥囗󰁤󰂃
卦	土土卜󰁶
卧	匚丨󰁃卜
卨	󰀥ㄇ󰁈口
卩	卩𠃌丨
卪	卩丶󰀦
卫	ㄗ一󰀌
卬	󰁚卩󰀢
卭	工卩󰀢
卮	⺁一⺋󰁫
卯	󰁚丿卩󰀢
印	󰁚一卩󰀢
危	⺈厂⺋󰀅
卲	刀口卩󰀢
即	󰁮卩󰀢
却	土厶卩󰀢
卵	󰁚丶丿丶
卶	夕夕卩󰀢
卷	丷夫⺋󰀅
卸	𠂉一止卩
卹	丿皿卩󰀢
卺	了󰀩一⺋
卻	八人口卩
卼	一儿⺈⺋
卽	白匕卩󰀢
卾	口口二卩
卿	󰁚丿󰁮卩
厀	木人氺卩
厁	人一朩卩
厂	厂一丿
厃	⺈厂󰁣
厄	厂⺋󰁫
厅	厂丁󰀵
历	厂力󰀏
厇	厂丿七󰁫
厈	厂干󰀵
厉	厂一󰁡󰀏
厊	厂󰀄亅丿
压	厂土丶󰀦
厌	厂犬󰀦
厍	厂车󰀵
厎	厂󰁚󰀁丶
厏	厂𠂉丨二
厐	厂ヒ丶
厑	厂口匕󰁫
厒	厂𠂉十凵
厓	厂土土󰀌
厔	厂一厶土
厕	厂贝刂󰀵
厖	厂乚丶
厗	厂辛󰀵
厘	厂曰土󰀌
厙	厂車󰀵
厚	厂曰子󰀌
厛	厂口斤󰀵
厜	厂丿士󰁺
厝	厂󰁺曰󰀌
厞	厂丨三三
原	厂白小󰀦
厠	厂貝刂󰀵
厡	厂白水󰀦
厢	厂木目󰀌
厣	厂犬甲󰀵
厤	厂禾禾󰀦
厥	厂䒑凵人
厦	厂丆目夂
厧	厂十󰀣八
厨	厂一口寸
厩	厂󰁮󰀄󰁜
厪	厂廿口
厫	厂󰁡攵
厬	厂曰夂口
厭	厂日月犬
厮	厂󰀎八斤
厯	厂木木丶
厰	厂⺌冂攵
厱	厂人一人
厲	厂艹曰丶
厳	󰀧厂乛攵
厴	厂曰月甲
厵	厂白小小
厶	厶ㄥ丶
厷	厶󰁧
厸	厶厶󰁶
厹	九厶󰁧
厺	大厶󰁧
去	土厶󰁧
厼	厶小󰁧
厽	厶厶厶󰁧
厾	⺄土厶󰀦
县	󰀐一厶󰁧
叀	一由厶󰁧
叁	厶大三󰀘
参	厶大彡󰁣
參	厶厶厶彡
叄	厶厶厶三
叅	厶厶厶⺗
叆	二厶爫又
叇	二厶󰁬辶
又	又又又又
叉	又丶󰀦
及	乃󰂃󰀦
友	又󰁧
双	又又󰁶
反	⺁又󰀦
収	󰁐丨又󰁶
叏	ユ丨又󰁧
叐	丿又󰀦
发	ㄥ丿又丶
叒	又又又󰁧
叓	一口丨又
叔	上小又󰁶
叕	又又又又
取	耳又󰁶
受	爫冖又󰁧
变	亠󰁗又󰁧
叙	人一朩又
叚	󰁃丨二又
叛	丷󰀠⺁又
叜	宀火又󰁧
叝	土厶卩又
叞	尸二小又
叟	臼丨又󰁧
叠	又又又一
叡	󰀥冖一又
叢	业䒑十又
口	口口口口
古	古一丨一
句	勹口󰀌
另	口力󰁣
叧	口刀󰁣
叨	口刀󰁥
叩	口卩󰀢
只	口八󰁧
叫	口󰁐丨󰀢
召	刀口󰀘
叭	口八󰁶
叮	口丁󰀢
可	丁口󰀌
台	厶口󰀘
叱	口ヒ󰁀
史	口乂󰀦
右	口󰀘
叴	九口󰀘
叵	匚口󰀌
叶	口十󰀢
号	口一ㄅ󰀅
司	𠃌一口󰀌
叹	口又󰁶
叺	口丿󰂃󰁶
叻	口力󰁥
叼	口𠃌󰀞󰀝
叽	口几󰁀
叾	了口󰀘
叿	口工󰀝
吀	口丿十󰀢
吁	口一󰀛󰀢
吂	󰄹丶一一
吃	口𠂉乙󰁀
各	夂口󰀘
吅	口口󰀝
吆	口幺󰁶
吇	口子󰀝
合	人一口󰀘
吉	士口󰀘
吊	口冂丨󰀬
吋	口寸󰁶
同	冂一口󰀌
名	夕口󰀘
后	⺁一口󰀌
吏	一口乂󰀦
吐	口土󰀝
向	丿冂口󰀌
吒	口丿七󰁀
吓	口一卜󰁶
吔	口也󰁀
吕	口口󰀘
吖	口丷丨󰀢
吗	口󰀊一󰀝
吘	口𠂉十󰀢
吙	口火󰁶
吚	口󰁬丿󰁥
君	󰁬丿口󰀘
吜	口󰁈丨一
吝	文口󰀘
吞	一大口󰀘
吟	口人丶乛
吠	口犬󰁶
吡	口󰁴匕󰁀
吢	心口󰀘
吣	口心󰁶
吤	口人󰀯󰀢
吥	口丆卜󰁶
否	丆卜口󰀘
吧	口巴󰁀
吨	口一凵乚
吩	口八刀󰁥
吪	口亻ヒ󰁀
含	人丶乛口
听	口斤󰀢
吭	口亠几󰁀
吮	口厶儿󰁀
启	丶尸口󰀌
吰	口厶󰁶
吱	口十又󰁶
吲	口弓丨󰀢
吳	口󰁕大󰁧
吴	口一大󰁧
吵	口小丿󰁥
吶	口冂丿󰂃
吷	口ユ人󰁶
吸	口乃󰂃󰁶
吹	口⺈人󰁶
吺	口几又󰁶
吻	口勹󰁤󰁥
吼	口孑乚󰁀
吽	口丿󰀟󰀢
吾	五口󰀘
吿	丿󰀟口󰀘
呀	口󰀄亅丿
呁	口勹冫󰀝
呂	口丿口󰀘
呃	口厂⺋󰁀
呄	乃古󰀘
呅	口文󰁶
呆	口木󰁧
呇	水口󰀘
呈	口王󰀘
呉	口󰁕一八
告	丿土口󰀘
呋	口夫󰁶
呌	口󰁦十󰀢
呍	口二厶󰁶
呎	口尸󰂃󰁶
呏	口丿廾󰀢
呐	口冂人󰁶
呑	丿大口󰀘
呒	口二󰁜󰁀
呓	口艹乙󰁀
呔	口大丶󰁶
呕	口匚乂󰁶
呖	口厂力󰁥
呗	口贝󰁶
员	口贝󰁧
呙	口冂人󰁧
呚	口攵󰁶
呛	口人⺋󰁀
呜	口丿𠃌一
呝	口丶尸乙
呞	口𠃌一口
呟	口亠幺󰁶
呠	口木一󰀝
呡	口󰁂󰀁󰁀
呢	口尸匕󰁀
呣	口母󰁶
呤	口人丶󰁻
呥	口冂土󰀝
呦	口幺力󰁥
呧	口󰁚󰀁丶
周	󰀼土口󰀌
呩	口二小󰁶
呪	口口儿󰁀
呫	口󰀥口󰀝
呬	口四󰀝
呭	口廿󰄃󰁀
呮	口口八󰁶
呯	口一丷十
呰	止匕口󰀘
呱	口⺁厶󰂃
呲	口止匕󰁀
味	口未󰁶
呴	口勹口󰀝
呵	口丁口󰀝
呶	口女又󰁶
呷	口甲󰀢
呸	口丆卜一
呹	口丿夫󰁶
呺	口口一ㄅ
呻	口曰丨󰀢
呼	口丿丷󰀛
命	人一口卩
呾	口曰一󰀝
呿	口土厶󰁶
咀	口󰀐一󰀝
咁	口甘󰀝
咂	口匚冂丨
咃	口亻也󰁀
咄	口凵山󰀢
咅	立口󰀘
咆	口勹巳󰁀
咇	口心丿󰁥
咈	口弓󰀯󰀢
咉	口ㄇ大󰁶
咊	口禾󰁶
咋	口𠂉丨二
和	禾口󰀝
咍	口厶口󰀝
咎	夂卜口󰀘
咏	口丶𠃌󰀩
咐	口亻寸󰁶
咑	口扌丁󰀢
咒	口口几󰀅
咓	口一󰁐丶
咔	口上卜󰁶
咕	口古󰀝
咖	口力口󰀝
咗	口工󰀝
咘	口冂丨
咙	口ヒ丶
咚	口夂󰁦󰁶
咛	口宀丁󰀢
咜	口宀匕󰁀
咝	口󰁲󰁲一
咞	口一廾󰀢
咟	口丆日󰀝
咠	口耳󰀘
咡	口耳󰀝
咢	口口二ㄅ
咣	口⺌一儿
咤	口宀丿七
咥	口一厶土
咦	口一弓人
咧	口一夕刂
咨	冫⺈人口
咩	口羊󰀢
咪	口米󰁶
咫	尸󰂃口八
咬	口六乂󰁶
咭	口士口󰀝
咮	口丿未󰁶
咯	口夂口󰀝
咰	口勹日󰀝
咱	口丿目󰀝
咲	口䒑大󰁶
咳	口亠ㄥ人
咴	口火󰁶
咵	口大二ㄅ
咶	口丿古󰀝
咷	口儿󰀪󰁶
咸	戊一口󰀌
咹	口宀女󰀝
咺	口一日一
咻	口亻木󰁶
咼	冂󰁈冂口
咽	口囗大󰁶
咾	口土丿匕
咿	口亻󰁬丿
哀	󰁸󰀔󰁧
品	口口口󰀘
哂	口西󰀝
哃	口冂一口
哄	口󰁺八󰁶
哅	口勹乂凵
哆	口夕夕󰁶
哇	口土土󰀝
哈	口人一口
哉	十戈口󰀌
哊	口月󰀝
哋	口土也󰁀
哌	口⺁󰀕󰁶
响	口丿冂口
哎	口艹乂󰁶
哏	口艮󰁶
哐	口匚王󰀝
哑	口一业󰀝
哒	口大辶󰁶
哓	口󰀁丿儿
哔	口󰁴匕十
哕	口山夕󰁶
哖	口𠂉㐄󰀢
哗	口亻ヒ十
哘	口彳一丁
哙	口人二厶
哚	口几木󰁶
哛	口匕八刀
哜	口文󰀯󰀢
哝	口冖󰀔󰁶
哞	口厶丿󰀟
哟	口纟勹丶
哠	口丿土口
員	口貝󰁧
哢	口王廾󰀢
哣	口一口䒑
哤	口乚丶
哥	丁口丁口
哦	口丿扌丶
哧	口土󰁖󰁶
哨	口⺌月󰀝
哩	口曰土󰀝
哪	口𠃌󰀠阝
哫	口口󰁾󰁶
哬	口亻丁口
哭	口口犬󰁧
哮	口土丿子
哯	口目儿󰁀
哰	口宀丿󰀟
哱	口十冖子
哲	扌斤口󰀘
哳	口扌斤󰀢
哴	口丶艮󰁶
哵	口口力刂
哶	口丨一干
哷	口爫寸󰁶
哸	口爫女󰀝
哹	口爫子󰀝
哺	口甫󰁶
哻	口曰干󰀢
哼	口󰁸了󰀢
哽	口一曰乂
哾	口丷口儿
哿	力口丁口
唀	口禾乃󰁥
唁	口言󰀝
唂	口八人口
唃	口⺈用󰀢
唄	口貝󰁶
唅	口人丶口
唆	口厶八夂
唇	厂二󰀖口
唈	口口巴󰁀
唉	口厶𠂉大
唊	口大人人
唋	口人一朩
唌	口丿󰀥廴
唍	口宀二儿
唎	口禾刂󰀢
唏	口乂丨
唐	广󰁬丨口
唑	口人人土
唒	口西一󰀝
唓	口車󰀢
唔	口五口󰀝
唕	口白十󰀢
唖	口一口一
唗	口土󰁾󰁶
唘	石又口󰀘
唙	口犭󰁥火
唚	口彐冖又
唛	口夂󰁶
唜	一木口匕
唝	口工贝󰁶
唞	口扌󰁦十
唟	土厶口匕
唠	口艹冖力
唡	口一冂人
唢	口⺌贝󰁶
唣	口白七󰁀
唤	口⺈ㄇ大
唥	口冫人󰁻
唦	口氵小丿
唧	口󰁮卩󰀢
唨	口阝󰀐一
唩	口禾女󰀝
唪	口三人󰀟
唫	口金󰀝
唬	口虍几󰁀
唭	口󰀎八󰁶
售	亻󰁷口󰀘
唯	口亻󰁷󰀝
唰	口尸冂刂
唱	口曰曰󰀝
唲	口臼儿󰁀
唳	口丶尸犬
唴	口⺶乚󰁀
唵	口大曰乚
唶	口󰁺日󰀝
唷	口亠厶月
唸	口人丶心
唹	口方人󰁦
唺	口ㄇ󰁺八
唻	口木人人
唼	口立女󰀝
唽	口木斤󰀢
唾	口丿士󰁺
唿	口勹󰁤心
啀	口厂土土
啁	口󰀼土口
啂	口爫孑乚
啃	口止月󰀝
啄	口一󰀓丶
啅	口󰀥早󰀢
商	亠丷冂口
啇	亠丷冂古
啈	口土䒑十
啉	口木木󰁶
啊	口阝丁口
啋	口爫木󰁶
啌	口宀八工
啍	口󰁸子󰀝
啎	𠂉十五口
問	門口󰀌
啐	口亠人十
啑	口一󰁬󰁾
啒	口尸凵山
啓	丶尸攵口
啔	丶尸戈口
啕	口勹𠂉凵
啖	口火火󰁶
啗	口⺈臼󰀝
啘	口宀夕⺋
啙	止匕口口
啚	口十囗口
啛	口一󰁬女
啜	口又又又
啝	口禾口󰀝
啞	口一󰀚一
啟	丶尸口攵
啠	斤斤口󰀘
啡	口丨三三
啢	口一冂丶
啣	口𠂉一卩
啤	口白丿十
啥	口人干口
啦	口扌立󰀝
啧	口贝󰁶
啨	口月󰀝
啩	口土土卜
啪	口扌白󰀝
啫	口土丿日
啬	十䒑囗口
啭	口车二丶
啮	口止人凵
啯	口囗王丶
啰	口罒夕󰁶
啱	口山石󰀝
啲	口白勹丶
啳	口丷夫⺋
啴	口丷曰十
啵	口氵皮󰁶
啶	口宀一󰁾
啷	口丶艮阝
啸	口󰁬丨八
啹	口尸古󰀝
啺	口曰一󰁤
啻	亠丷冖口
啼	口亠丷丨
啽	口人一廾
啾	口禾火󰁶
啿	口󰀎八󰄃
喀	口宀夂口
喁	口曰冂丶
喂	口田一󰀖
喃	口十冂十
善	羊䒑口󰀘
喅	口曰立󰀝
喆	士口士口
喇	口木口刂
喈	口󰁴匕白
喉	口亻ユ大
喊	口戊一口
喋	口廿󰄃木
喌	口口丶丨
喍	口止匕木
喎	口ㄇ󰁈口
喏	口艹口
喐	口月阝
喑	口立曰󰀝
喒	口夂卜日
喓	口覀女󰀝
喔	口尸一土
喕	口丆囗二
喖	口木古󰀝
喗	口冖車󰀢
喘	口山丆〢
喙	口彑󰀓󰁶
喚	口⺈ㄇ大
喛	口爫一又
喜	士口䒑口
喝	口曰勹󰄃
喞	口白匕卩
喟	口田月󰀝
喠	口丿一土
喡	口󰁆口㐄
喢	口丿十臼
喣	口勹口灬
喤	口白王󰀝
喥	口广廿又
喦	口口口山
喧	口宀一一
喨	口󰁸冖几
喩	口人一巜
喪	土口口󰀖
喫	口三丨大
喬	丿大口口
喭	口立丿彡
單	口口曰十
喯	口大十廾
喰	口人丶艮
喱	口厂曰土
喲	口糹勹丶
喳	口木曰一
喴	口戊一女
喵	口艹田󰀝
営	󰀧冖口口
喷	口十艹贝
喸	甫口匕󰀅
喹	口大土土
喺	口亻丿小
喻	口人一刂
喼	口⺈彐心
喽	口米女󰀝
喾	⺌冖丿口
喿	口口口木
嗀	士冖一又
嗁	口⺁虍几
嗂	口爫𠂉凵
嗃	口󰁸冂口
嗄	口丆目夂
嗅	口丿目犬
嗆	口人丶口
嗇	土人人口
嗈	口巛口巴
嗉	口幺小
嗊	口工貝󰁶
嗋	口力力月
嗌	口䒑八皿
嗍	口䒑凵月
嗎	口󰀋灬󰁶
嗏	口艹人朩
嗐	口宀三口
嗑	口土厶皿
嗒	口艹人口
嗓	口又又木
嗔	口十󰀣八
嗕	口厂二寸
嗖	口臼丨又
嗗	口󰀾月󰀝
嗘	口爫幺大
嗙	口亠丷方
嗚	口󰁞灬󰁶
嗛	口䒑󰁬八
嗜	口土丿曰
嗝	口一口丨
嗞	口䒑幺幺
嗟	口⺶工󰀝
嗠	爫孑夂口
嗡	口八厶羽
嗢	口曰皿󰀝
嗣	口冂艹口
嗤	口凵丨虫
嗥	口白大十
嗦	口十冖小
嗧	力口人艹
嗨	口氵𠂉母
嗩	口⺌貝󰁶
嗪	口三人禾
嗫	口耳又又
嗬	口艹亻口
嗭	十󰀣口匕
嗮	口日西󰀝
嗯	口囗大心
嗰	口亻囗古
嗱	口人一手
嗲	口八乂夕
嗳	口爫冖又
嗴	口⺶乚厶
嗵	口󰁻用辶
嗶	口曰艹󰀟
嗷	口󰁡攵
嗸	󰁡攵口
嗹	口車辶󰁶
嗺	口山亻󰁷
嗻	口广廿灬
嗼	口艹曰大
嗽	口木口人
嗾	口方𠂉大
嗿	口人丶貝
嘀	口亠丷古
嘁	口戊上小
嘂	口口󰁐口
嘃	口广󰁬丨
嘄	口󰁟木󰁶
嘅	口󰁮󰀄󰁜
嘆	口廿口夫
嘇	口厶厶彡
嘈	口一ㄇ日
嘉	士口䒑口
嘊	口山厂土
嘋	口土丿攵
嘌	口覀二小
嘍	口󰀻女󰀝
嘎	口丆目戈
嘏	古󰁃丨又
嘐	口羽人彡
嘑	口虍丿󰀛
嘒	口三丨彐
嘓	口囗戈󰀞
嘔	口匚口口
嘕	口一止灬
嘖	口貝󰁶
嘗	⺌冖口日
嘘	口虍业󰀝
嘙	口氵皮女
嘚	口彳曰寸
嘛	口广木木
嘜	口木人夕
嘝	口⺈用十
嘞	口廿󰀜力
嘟	口土丿阝
嘠	口丆󰀐戈
嘡	口⺌冖土
嘢	口曰土亅
嘣	口山月月
嘤	口贝贝女
嘥	口彳止󰁾
嘦	口八覀女
嘧	口宀心山
嘨	口󰁬米󰀯
嘩	口艹一󰀟
嘪	口罒貝󰁶
嘫	口󰁝犬灬
嘬	口曰耳又
嘭	口士口彡
嘮	口火火力
嘯	口󰁬十󰀲
嘰	口幺幺人
嘱	口尸丿丶
嘲	口十早月
嘳	口口丨貝
嘴	口止匕用
嘵	口土土儿
嘶	口󰀎八斤
嘷	口丿目十
嘸	口𠂉一灬
嘹	口大丷小
嘺	口丿大口
嘻	口士口口
嘼	口口田口
嘽	口口口十
嘾	口覀早󰀢
嘿	口󰀹土灬
噀	口巳巳八
噁	口一󰀚心
噂	口丷西寸
噃	口丿米田
噄	口三丨小
噅	口爫丿灬
噆	口󰀄󰁜日
噇	口立曰土
噈	口󰁸小丶
噉	口乛耳攵
噊	口󰁻乛口
噋	口󰁸孑攵
噌	口丷󰀺日
噍	口亻󰁷灬
噎	口士冖䒑
噏	口人一羽
噐	口口工口
噑	口白󰀪十
噒	口米夕㐄
噓	口虍〢一
噔	口癶一䒑
噕	爫丿󰁈口
噖	口王王乛
噗	口业䒑夫
噘	口厂䒑人
噙	口人亠厶
噚	口彐工寸
噛	口止米凵
噜	口󰁢一日
噝	口糹幺小
噞	口人一人
噟	广亻亻口
噠	口土羊辶
噡	口⺈厂言
噢	口丿ㄇ大
噣	口罒勹虫
噤	口木木小
噥	口ㄇ󰁺󰀖
噦	口止戊󰀤
噧	口艹曰丶
器	口口犬口
噩	王口口口
噪	口口口木
噫	口立曰心
噬	口⺮工人
噭	口白方攵
噮	口罒一󰀔
噯	口爫冖夂
噰	口亠󰁲󰁷
噱	口虍一󰀓
噲	口人一日
噳	口虍口大
噴	口十艹貝
噵	䒑丿目口
噶	口艹曰󰄃
噷	口立日人
噸	口一凵貝
噹	口⺌冖田
噺	口立朩斤
噻	口宀󰀀土
噼	口尸口辛
噽	士口䒑一
噾	口宀八日
噿	口羽亠十
嚀	口宀心丁
嚁	口羽亻󰁷
嚂	口匚丨皿
嚃	口罒󰀫辶
嚄	口艹亻又
嚅	口󰀙丆〢
嚆	口艹󰁸口
嚇	口土󰁖󰁖
嚈	口厂日犬
嚉	口业丷寸
嚊	口丿目󰀯
嚋	口士乛寸
嚌	口󰀴󰀳󰀝
嚍	口󰁬丨皿
嚎	口󰁸冖󰀓
嚏	口十冖󰁾
嚐	口⺌冖日
嚑	口丿一灬
嚒	口广木幺
嚓	口宀󰁯小
嚔	口十冖󰁾
嚕	口󰁢灬日
嚖	口三丨心
嚗	口曰󰁺氺
嚘	口丆󰀐夂
嚙	口止󰀆󰀢
嚚	口口匚口
嚛	口白幺木
嚜	口󰀹土土
嚝	口广󰁺八
嚞	士口士口
嚟	口禾勹氺
嚠	口󰁚丶刂
嚡	口廿󰀜土
嚢	一口丨󰀔
嚣	口口丆口
嚤	口广木手
嚥	口廿口灬
嚦	口厂禾止
嚧	口虍田皿
嚨	口立月三
嚩	口糹甫寸
嚪	口門⺈臼
嚫	口立朩儿
嚬	口止󰀤貝
嚭	士口䒑口
嚮	󰁲丿丶口
嚯	口󰀙亻󰁷
嚰	口广木石
嚱	口虍一戈
嚲	󰁸孑口十
嚳	󰀗乂乂口
嚴	口口厂攵
嚵	口⺈口丶
嚶	口貝貝女
嚷	口亠口󰀔
嚸	口󰀹土口
嚹	口𠂉十󰀛
嚺	口罒䒑辶
嚻	口口丆口
嚼	口爫罒寸
嚽	口󰁡貝
嚾	口艹口󰁷
嚿	口艹亻臼
囀	口車一寸
囁	口耳耳耳
囂	口口丆口
囃	口亠人󰁷
囄	口亠乂󰁷
囅	口口曰󰀖
囆	口艹曰虫
囇	口一冂匕
囈	口艹土厶
囉	口罒糹󰁷
囊	一口丨󰀔
囋	口丿土貝
囌	口艹󰁢禾
囍	士口䒑口
囎	口貝丷日
囏	廿口夫口
囐	口虍一犬
囑	口尸氺虫
囒	口艹門󰀹
囓	口三丨󰀆
囔	口一口󰀔
囕	口匚丨儿
囖	口⺮罒󰁷
囗	囗丨󰁈一
囘	冂巳󰁫
囙	囗󰁃󰀌
囚	囗人󰀦
四	四丨󰁈一
囜	囗厶󰀦
囝	囗子󰀌
回	囗口󰀌
囟	丿囗乂󰀦
因	囗大󰀦
囡	囗女󰀌
团	囗󰀛丿󰀏
団	囗寸󰀦
囤	囗一凵乚
囥	囗亠几󰁫
囦	囗水󰀦
囧	囗八ㄇ󰁫
囨	囗丆卜󰀦
囩	囗二厶󰀦
囪	丿囗󰁤󰂃
囫	囗勹󰁤󰀏
囬	囗〢二󰀌
园	囗二儿󰁫
囮	囗亻ヒ󰁫
囯	囗王󰀌
困	囗木󰀦
囱	丿囗夕󰀦
囲	囗二󰀯󰀵
図	囗󰁦乂󰀦
围	囗二𠃌丨
囵	囗人匕󰁫
囶	囗八土󰀌
囷	囗禾󰀦
囸	囗一止󰀌
囹	囗人丶󰁻
固	囗古󰀌
囻	囗󰁂󰀁󰁫
囼	囗厶口󰀌
国	囗王丶󰀦
图	囗夂󰁦󰀦
囿	囗月󰀌
圀	囗八方󰀏
圁	囗言󰀌
圂	囗一󰀓󰀦
圃	囗甫󰀦
圄	囗五口󰀌
圅	󰁻囗䒑十
圆	囗口贝󰀦
圇	囗人一艹
圈	囗丷夫⺋
圉	囗土䒑十
圊	囗月󰀌
國	囗戈口󰀞
圌	囗山丆〢
圍	囗󰁆口㐄
圎	囗厶貝󰀦
圏	囗丷夫己
圐	囗罒方󰀏
圑	囗甫寸󰀦
園	囗土口󰀔
圓	囗口貝󰀦
圔	囗土厶皿
圕	囗󰁬土日
圖	囗口十口
圗	囗厶十二
團	囗一曰寸
圙	囗八丆二
圚	囗口丨貝
圛	囗罒土十
圜	囗罒一󰀔
圝	囗言糹糹
圞	囗言糹木
土	土土土土
圠	土乚󰁀
圡	土丶󰀦
圢	土丁󰀢
圣	又土󰀘
圤	土卜󰁶
圥	土儿󰀅
圦	土丿󰂃󰁶
圧	厂土󰀌
在	丨土󰀌
圩	土一󰀛󰀢
圪	土𠂉乙󰁀
圫	土丿七󰁀
圬	土二ㄅ󰁀
圭	土土󰀘
圮	土己󰁀
圯	土巳󰁀
地	土也󰁀
圱	丿土󰀝
圲	土丿十󰀢
圳	土川󰀢
圴	土勹丶󰁶
圵	土上󰀝
圶	大土󰀘
圷	土一卜󰁶
圸	土山󰀢
圹	土广󰁥
场	土ㄋ󰁤󰁥
圻	土斤󰀢
圼	曰土󰀘
圽	土勹󰁤󰁥
圾	土乃󰂃󰁶
圿	土人󰀯󰀢
址	土止󰀝
坁	土󰁚󰀁󰁀
坂	土⺁又󰁶
坃	土二儿󰁀
坄	土几又󰁶
坅	土人丶乛
坆	土攵󰁶
均	土勹冫󰀝
坈	土冖几󰁀
坉	土一凵乚
坊	土方󰁥
坋	土八刀󰁥
坌	八刀土󰀘
坍	土󰀼亠󰀝
坎	土⺈人󰁶
坏	土丆卜󰁶
坐	人人土󰀌
坑	土亠几󰁀
坒	󰁴匕土󰀘
坓	二󰀯土󰀘
坔	水土󰀘
坕	⺁丨󰂃土
坖	二儿土󰀘
块	土ユ人󰁶
坘	土一彑󰀝
坙	一巛土󰀘
坚	〢又土󰀘
坛	土二厶󰁶
坜	土厂力󰁥
坝	土贝󰁶
坞	土丿𠃌一
坟	土文󰁶
坠	阝人土󰀘
坡	土皮󰁶
坢	土丷󰀟󰀢
坣	⺌冖土󰀘
坤	土曰丨󰀢
坥	土󰀐一󰀝
坦	土曰一󰀝
坧	土石󰀝
坨	土宀匕󰁀
坩	土甘󰀝
坪	土一丷十
坫	土󰀥口󰀝
坬	土⺁厶󰂃
坭	土尸匕󰁀
坮	土厶口󰀝
坯	土丆卜一
坰	土冂口󰀝
坱	土ㄇ大󰁶
坲	土弓󰀯󰀢
坳	土幺力󰁥
坴	土八土󰀘
坵	土丘󰀝
坶	土母󰁶
坷	土丁口󰀝
坸	土勹口󰀝
坹	土宀八󰁶
坺	土又丶
坻	土󰁚󰀁丶
坼	土斤丶󰁶
坽	土人丶󰁻
坾	土宀丁󰀢
坿	土亻寸󰁶
垀	土丿丷󰀛
垁	土𠂉大󰁶
垂	丿士󰁺󰀌
垃	土立󰀝
垄	ヒ丶土
垅	土ヒ丶
垆	土󰀥尸󰁥
垇	土丨󰁎一
垈	亻󰀁丶土
垉	土勹巳󰁀
垊	土󰁂󰀁󰁀
型	一廾刂土
垌	土冂一口
垍	土丿目󰀝
垎	土夂口󰀝
垏	土󰁬󰀟󰀢
垐	冫⺈人土
垑	土夕夕󰁶
垒	厶厶厶土
垓	土亠ㄥ人
垔	覀土󰀘
垕	⺁一口土
垖	土丿󰃧󰀝
垗	土儿󰀪󰁶
垘	土亻犬󰁶
垙	土⺌一儿
垚	土土土󰀘
垛	土几木󰁶
垜	土乃木󰁶
垝	土⺈厂⺋
垞	土宀丿七
垟	土羊󰀢
垠	土艮󰁶
垡	亻戈土󰀘
垢	土⺁一口
垣	土一曰一
垤	土一厶土
垥	土人一口
垦	艮土󰀘
垧	土丿冂口
垨	土宀寸󰁶
垩	一业土󰀘
垪	土䒑廾󰀢
垫	扌九丶土
垬	土󰁺八󰁶
垭	土一业󰀝
垮	土大二ㄅ
垯	土大辶󰁶
垰	土上一卜
垱	土⺌彐󰀝
垲	土山己󰁀
垳	土彳一丁
垴	土亠乂凵
垵	土宀女󰀝
垶	土辛󰀢
垷	土目儿󰁀
垸	土宀二儿
垹	土三丿阝
垺	土爫子󰀝
垻	土貝󰁶
垼	彳几又土
垽	氵斤土󰀘
垾	土曰干󰀢
垿	土广󰁻亅
埀	丿一丬土
埁	土山人乛
埂	土一曰乂
埃	土厶𠂉大
埄	土夂三丨
埅	阝方土󰀘
埆	土⺈用󰀢
埇	土󰁻用󰀢
埈	土厶八夂
埉	土大人人
埊	山水土󰀘
埋	土曰土󰀝
埌	土丶艮󰁶
埍	土口月󰀝
城	土戊𠃌󰁀
埏	土丿󰀥廴
埐	土彐冖又
埑	扌斤土󰀘
埒	土爫寸󰁶
埓	土爫寸󰁶
埔	土甫󰁶
埕	土口王󰀝
埖	土艹亻ヒ
埗	土止󰀤󰁥
埘	土日寸󰁶
埙	土口贝󰁶
埚	土口冂人
埛	土冂八口
埜	木木土󰀘
埝	土人丶心
埞	土宀一󰁾
域	土戈口󰀞
埠	土丿󰃧十
埡	土一󰀚一
埢	土丷夫⺋
埣	土亠人十
埤	土白丿十
埥	土月󰀝
埦	土宀夕⺋
埧	土󰀣八󰁶
埨	土人一艹
埩	土⺈󰁬亅
埪	土宀八工
埫	土⺌冂口
埬	土木曰󰀝
埭	土󰁬氺󰁶
埮	土火火󰁶
埯	土大曰乚
埰	土爫木󰁶
埱	土上小又
埲	土三人󰀟
埳	土⺈臼󰀝
埴	土十󰀣󰀝
埵	土丿士󰁺
埶	土八土丶
執	土䒑十丶
埸	土曰勹󰁤
培	土立口󰀝
基	󰀎八土󰀘
埻	土󰁸子󰀝
埼	土大丁口
埽	土彐冖丨
埾	耳又土󰀘
埿	氵尸匕土
堀	土尸凵山
堁	土曰木󰁶
堂	⺌冖口土
堃	方方土󰀘
堄	土臼儿󰁀
堅	匚丨󰁃土
堆	土亻󰁷󰀝
堇	廿口󰀘
堈	土冂䒑山
堉	土亠厶月
堊	一󰀚一土
堋	土月月󰀝
堌	土囗古󰀝
堍	土⺈口丶
堎	土土八夂
堏	木方土󰀘
堐	土厂土土
堑	车斤土󰀘
堒	土曰󰁴匕
堓	土山厂干
堔	土冖八木
堕	阝月土
堖	土巛丿乂
堗	土宀八犬
堘	土丷夫土
堙	土覀土󰀝
堚	土冖車󰀢
堛	土一口田
堜	土木󰀹󰀝
堝	土ㄇ󰁈口
堞	土廿󰄃木
堟	土彑󰀓󰁶
堠	土亻ユ大
堡	亻口木土
堢	土亻口木
堣	土曰冂丶
堤	土曰一󰁾
堥	󰁻乛亅土
堦	土󰁴匕白
堧	土丆冂大
堨	土曰勹󰄃
堩	土忄一一
堪	土󰀎八󰄃
堫	土乂凵夂
堬	土人一刂
堭	土白王󰀝
堮	土口口ㄅ
堯	土土土儿
堰	土匚曰女
報	土䒑十又
堲	󰁮卩土󰀘
堳	土󰁅目󰀝
場	土曰一󰁤
堵	土土丿日
堶	土工月
堷	土立日󰀝
堸	土几丿虫
堹	土丿一土
堺	土田八󰀯
堻	氵󰁬󰀟土
堼	土土寸土
堽	土罒一止
堾	土三人日
堿	土戊一口
塀	土尸䒑廾
塁	田󰀪土󰀘
塂	土󰁺八巳
塃	土艹亠󰀸
塄	土罒方󰁥
塅	土丿丨又
塆	土亠󰁗弓
塇	土宀一一
塈	󰁮󰀄󰁜土
塉	土󰀪人月
塊	土白󰁜厶
塋	火火冖土
塌	土曰羽󰀝
塍	月丷夫土
塎	土宀八口
塏	土山一䒑
塐	土幺小
塑	䒑凵丿土
塒	土日土寸
塓	土冖曰六
塔	土艹人口
塕	土八厶羽
塖	土禾丬匕
塗	氵人一土
塘	土广󰁬口
塙	土󰁸冂口
塚	土冖一丶
塛	土覀木󰁶
塜	土冖二󰀓
塝	土亠丷方
塞	宀󰀀八土
塟	艹一夕土
塠	土丿󰃧辶
塡	土匕目八
塢	土󰁞灬󰁶
塣	氵口王土
塤	土口貝󰁶
塥	土一口丨
塦	阝車土󰀘
塧	土䒑八皿
塨	土󰁺八⺗
塩	土𠂉口皿
塪	土爫臼󰀝
填	土十󰀣八
塬	土厂白小
塭	土曰皿󰀝
塮	土丿󰀽寸
塯	土󰁚丶田
塰	氵𠂉母土
塱	丶󰁮月土
塲	土𠂉曰󰁤
塳	土夂三辶
塴	土山月月
塵	󰁙󰁴匕土
塶	土󰁙󰁴匕
塷	土󰀥囗󰁘
塸	土匚口口
塹	車斤土󰀘
塺	广木木土
塻	土艹曰大
塼	土一曰寸
塽	土大乂乂
塾	󰁸孑九土
塿	土󰀻女󰀝
墀	土尸氺󰀟
墁	土曰罒又
墂	土覀二小
境	土立曰儿
墄	土戊上小
墅	曰土󰁻土
墆	土廿儿丨
墇	土立早󰀢
墈	土󰀎八力
墉	土广󰁬丨
墊	土䒑十土
墋	土厶厶彡
墌	土广廿灬
墍	白匕󰀄土
墎	土󰁸孑阝
墏	爿󰁝寸土
墐	土廿口
墑	土亠丷古
墒	土亠丷口
墓	艹曰大土
墔	土山亻󰁷
墕	土一止灬
墖	土人一田
増	土丷田日
墘	土十早乙
墙	土十䒑口
墚	土氵刀木
墛	土尸二寸
墜	阝䒑󰀓土
墝	土土土儿
增	土丷󰀺日
墟	土虍业󰀝
墠	土口口十
墡	土羊䒑口
墢	土癶弓又
墣	土业䒑夫
墤	土口丨貝
墥	土立曰土
墦	土丿米田
墧	土丿大口
墨	󰀹土灬土
墩	土󰁸孑攵
墪	󰁸孑攵土
墫	土丷西寸
墬	阝彑󰀓土
墭	土戊𠃌皿
墮	阝工土
墯	忄工土
墰	土覀早󰀢
墱	土癶一䒑
墲	土𠂉一灬
墳	土十艹貝
墴	土󰁺由八
墵	土󰀙二厶
墶	土土羊辶
墷	土艹一󰀟
墸	土艹土日
墹	土門日󰀝
墺	土丿ㄇ大
墻	土土人口
墼	車凵几土
墽	土白方攵
墾	豸艮土󰀘
墿	土罒土十
壀	土尸口辛
壁	尸口辛土
壂	尸󰁺八土
壃	土一田一
壄	木󰁻乛土
壅	亠󰁲丿土
壆	󰀗乂乂土
壇	土亠囗一
壈	土亠囗禾
壉	土虍一󰀓
壊	土十罒󰀔
壋	土⺌冖田
壌	土六󰀀󰀔
壍	氵車斤土
壎	土丿一灬
壏	土匚丨皿
壐	一八冂土
壑	󰀥冖一土
壒	土艹土皿
壓	厂曰月土
壔	土士乛寸
壕	土󰁸冖󰀓
壖	土󰀙丆〢
壗	土󰁬丨皿
壘	田田田土
壙	土广󰁺八
壚	土虍田皿
壛	土門⺈臼
壜	土曰󰀙厶
壝	土口丨辶
壞	土亠罒󰀔
壟	立月一土
壠	土立月三
壡	󰀥冖一土
壢	土厂禾止
壣	土耳幺一
壤	土亠口󰀔
壥	土厂󰀹土
壦	土艹口󰁷
壧	土口口攵
壨	田田田土
壩	土󰀙廿月
壪	土言糹糹
士	士一丨一
壬	丿士󰀌
壭	士卩󰀬
壮	丬士󰀝
壯	爿士󰀝
声	士󰁅󰁣
壱	士冖匕󰀅
売	士冖儿󰀅
壳	士冖几󰀅
壴	土口䒑󰀘
壵	士士士󰀘
壶	士冖业󰀘
壷	士冖口一
壸	士冖一业
壹	士冖一䒑
壺	士冖󰀚一
壻	土乛󰁾月
壼	士冖一一
壽	士乛工寸
壾	士口䒑󰁃
壿	士丷西寸
夀	二乛口寸
夁	士罒囗古
夂	夂丿乛󰂃
夃	乃又󰀦
处	夂卜󰀦
夅	夂㐄󰀬
夆	夂三丨󰀬
备	夂田󰀘
夈	夂米󰁧
変	亠󰁖夂󰁧
夊	ク󰂃󰀦
夋	厶八夂󰁧
夌	土八夂󰁧
复	𠂉曰夂󰁧
夎	人人土夂
夏	丆目夂󰁧
夐	⺈ㄇ人夂
夑	言火火夂
夒	丆目止夂
夓	󰀗丆目夂
夔	䒑丿目夂
夕	夕丿乛丶
外	夕卜󰁶
夗	夕⺋󰁀
夘	夕卩󰀢
夙	几一夕󰀦
多	夕夕󰁧
夛	󰁭夕󰁧
夜	亠亻夂丶
夝	夕丿󰀝
夞	夕卜口匕
够	勹口夕夕
夠	夕夕勹口
夡	夕夕士口
夢	艹罒冖夕
夣	亠厶罒夕
夤	夕宀一八
夥	曰木夕夕
夦	󰀎八󰄃夕
大	大大大大
夨	󰁕一󰂃󰀦
天	一大󰀦
太	大丶󰀦
夫	夫一一󰂃
夬	ユ人󰀦
夭	丿大󰀦
央	ㄇ大󰀦
夯	大力󰁣
夰	大󰀯󰀬
失	丿夫󰀦
夲	大十󰀬
夳	大二󰀘
头	󰁦大󰀦
夵	大小󰁧
夶	大大󰁶
夷	一弓人󰀦
夸	大二ㄅ󰀅
夹	一丷大󰀦
夺	大寸󰁧
夻	大口󰀘
夼	大川󰀬
夽	大二厶󰁧
夾	大人人󰀦
夿	大巴󰀅
奀	丆卜大󰁧
奁	大匚乂󰁧
奂	⺈ㄇ大󰁧
奃	大󰁚󰀁丶
奄	大曰乚󰀅
奅	大󰁚丿卩
奆	大匚󰁃󰀘
奇	大丁口󰀘
奈	大二小󰁧
奉	三人󰀟󰀬
奊	土土󰁕󰂃
奋	大田󰀘
奌	󰀥口大󰁧
奍	丷夫󰀯󰀬
奎	大土土󰀘
奏	三人一大
奐	⺈ㄇ八大
契	三丨刀大
奒	大亠ㄥ人
奓	大夕夕󰁧
奔	大十廾󰀬
奕	亠󰁖大󰁧
奖	丬夕大󰁧
套	大󰂞󰁧
奘	爿士大󰁧
奙	厶大曰乚
奚	爫幺大󰁧
奛	大日月󰀘
奜	丨三丨大
奝	大󰀼土口
奞	大亻󰁷󰀘
奟	大月月󰀘
奠	丷西一大
奡	丆目大󰀯
奢	大土丿日
奣	一大日月
奤	大丆囗二
奥	丿ㄇ米大
奦	󰁻乛亅大
奧	丿ㄇ丿大
奨	丬爫寸大
奩	大匚口口
奪	大亻󰁷寸
奫	大氵󰀲一
奬	爿󰁝寸大
奭	大丆日日
奮	大亻󰁷田
奯	大止戊󰀤
奰	罒罒罒大
奱	言糹糹大
奲	大土丿十
女	女女女女
奴	女又󰁶
奵	女丁󰀢
奶	女乃󰁥
奷	女丿十󰀢
奸	女干󰀢
她	女也󰁀
奺	女ク󰂃󰁶
奻	女女󰀝
奼	女丿七󰁀
好	女子󰀝
奾	女山󰀢
奿	九丶女󰀌
妀	󰁁女󰀝
妁	女勹丶󰁶
如	女口󰀝
妃	女己󰁀
妄	亠󰄃女󰀘
妅	女工󰀝
妆	丬女󰀝
妇	女彐󰀝
妈	女󰀊一󰀝
妉	女冖󰁜󰁀
妊	女丿士󰀝
妋	女夫󰁶
妌	女二󰀯󰀢
妍	女一廾󰀢
妎	女人󰀯󰀢
妏	女文󰁶
妐	女八厶󰁶
妑	女巴󰁀
妒	女丶尸󰁥
妓	女十又󰁶
妔	女亠几󰁀
妕	女口丨󰀢
妖	女丿大󰁶
妗	女人丶乛
妘	女二厶󰁶
妙	女小丿󰁥
妚	女丆卜󰁶
妛	凵丨一女
妜	女ユ人󰁶
妝	爿女󰀝
妞	女󰁈丨一
妟	曰女󰀘
妠	女冂人󰁶
妡	女斤󰀢
妢	女八刀󰁥
妣	女󰁴匕󰁀
妤	女󰁻乛亅
妥	爫女󰀘
妦	女三丨󰀢
妧	女二儿󰁀
妨	女方󰁥
妩	女二󰁜󰁀
妪	女匚乂󰁶
妫	女丶力丶
妬	女石󰀝
妭	女又丶
妮	女尸匕󰁀
妯	女由󰀝
妰	女𠂉丨二
妱	女刀口󰀝
妲	女曰一󰀝
妳	女⺈小󰁶
妴	夕⺋女󰀘
妵	女丶王󰀝
妶	女亠幺󰁶
妷	女丿夫󰁶
妸	女丁口󰀝
妹	女未󰁶
妺	女一木󰁶
妻	一󰁬丨女
妼	女心丿󰁥
妽	女曰丨󰀢
妾	立女󰀘
妿	力口女󰀘
姀	女禾󰁶
姁	女勹口󰀝
姂	女丿之󰁶
姃	女一止󰀝
姄	女󰁂󰀁󰁀
姅	女丷󰀟󰀢
姆	女母󰁶
姇	亻寸女󰀘
姈	女人丶󰁻
姉	女一冂丨
姊	女丿ㄅ丿
始	女厶口󰀝
姌	女冂土󰀝
姍	女冂艹󰀢
姎	女ㄇ大󰁶
姏	女甘󰀝
姐	女󰀐一󰀝
姑	女古󰀝
姒	女󰁐丶人
姓	女丿󰀝
委	禾女󰀘
姕	止匕女󰀘
姖	女匚󰁃󰀝
姗	女󰀼󰀼一
姘	女䒑廾󰀢
姙	女亻丿士
姚	女儿󰀪󰁶
姛	女冂一口
姜	丷王女󰀘
姝	女丿未󰁶
姞	女士口󰀝
姟	女亠ㄥ人
姠	女丿冂口
姡	女丿古󰀝
姢	女厶月󰀝
姣	女六乂󰁶
姤	女⺁一口
姥	女土丿匕
姦	女女女󰀘
姧	女女干󰀢
姨	女一弓人
姩	女𠂉㐄󰀢
姪	女一厶土
姫	女匚丨丨
姬	女匚丨丨
姭	力力力女
姮	女一日一
姯	女⺌一儿
姰	女勹日󰀝
姱	女大二ㄅ
姲	女宀女󰀝
姳	女夕口󰀝
姴	一夕刂女
姵	女几一丨
姶	女人一口
姷	女月󰀝
姸	女一干
姹	女宀丿七
姺	女丿土儿
姻	女囗大󰁶
姼	女夕夕󰁶
姽	女⺈厂⺋
姾	女人王󰀝
姿	冫⺈人女
娀	女戈󰁥
威	戊一女󰀌
娂	女󰁺八󰁶
娃	女土土󰀝
娄	米女󰀘
娅	女一业󰀝
娆	女󰀁丿儿
娇	女丿大󰀯
娈	亠󰁗女󰀘
娉	女由一ㄅ
娊	女目儿󰁀
娋	女⺌月󰀝
娌	女曰土󰀝
娍	女戊𠃌󰁀
娎	扌斤女󰀘
娏	女乚丶
娐	女爫子󰀝
娑	氵小丿女
娒	女𠂉母󰁶
娓	女尸毛󰁀
娔	女古儿󰁀
娕	女木口󰀝
娖	女口󰁾󰁶
娗	女丿士廴
娘	女丶艮󰁶
娙	女一巛工
娚	女田力󰁥
娛	女口󰁕大
娜	女𠃌󰀠阝
娝	女丆卜口
娞	女爫女󰀝
娟	女口月󰀝
娠	女厂二󰀖
娡	女士心󰁶
娢	女人丶口
娣	女丷弓丿
娤	爿士女󰀘
娥	女丿扌丶
娦	女丘八󰁶
娧	女丷口儿
娨	女曰干󰀢
娩	女⺈口󰁜
娪	女五口󰀝
娫	女丿󰀥廴
娬	女一󰀁丶
娭	女厶𠂉大
娮	女言󰀝
娯	女口󰁕八
娰	女亻󰁐人
娱	女口一大
娲	女口冂人
娳	女禾刂󰀢
娴	女门木󰁶
娵	女耳又󰁶
娶	耳又女󰀘
娷	女丿士󰁺
娸	女󰀎八󰁶
娹	女弓亠幺
娺	女又又又
娻	女木曰󰀝
娼	女曰曰󰀝
娽	女󰁭氺󰁶
娾	女厂土土
娿	阝丁口女
婀	女阝丁口
婁	󰀻女󰀘
婂	女白冂丨
婃	女宀二小
婄	女立口󰀝
婅	女勹米󰁶
婆	氵皮女󰀘
婇	女爫木󰁶
婈	女土八夂
婉	女宀夕⺋
婊	女󰀔󰁶
婋	女虍几󰁀
婌	女上小又
婍	女大丁口
婎	女亻󰁷󰀝
婏	女⺈口丶
婐	女曰木󰁶
婑	女禾女󰀝
婒	女火火󰁶
婓	丨三丨女
婔	女丨三三
婕	女一󰁬󰁾
婖	女一大⺗
婗	女臼儿󰁀
婘	女丷夫⺋
婙	女⺈󰁬亅
婚	女󰁚󰀁日
婛	女󰁸小󰁶
婜	匚丨󰁃女
婝	女宀一󰁾
婞	女土䒑十
婟	女囗古󰀝
婠	女宀󰃧󰀝
婡	女木人人
婢	女白丿十
婣	女󰀲一󰀝
婤	女󰀼土口
婥	女󰀥早󰀢
婦	女彐冖丨
婧	女月󰀝
婨	女人一艹
婩	女山厂干
婪	木木女󰀘
婫	女曰󰁴匕
婬	女爫丿士
婭	女一󰀚一
婮	女尸古󰀝
婯	一ㄇ丶女
婰	女ㄇ󰁺八
婱	弓亠幺女
婲	女艹亻匕
婳	女一田凵
婴	贝贝女󰀘
婵	女丷曰十
婶	女宀曰丨
婷	女󰁸冖丁
婸	女曰一󰁤
婹	女覀女󰀝
婺	󰁻乛亅女
婻	女十冂十
婼	女艹口
婽	女󰁃丨又
婾	女人一巜
婿	女乛󰁾月
媀	女曰冂丶
媁	女󰁆口㐄
媂	女亠丷丨
媃	女󰁻乛木
媄	女丷王大
媅	女󰀎八󰄃
媆	女丆冂大
媇	女立朩󰁶
媈	女冖車󰀢
媉	女尸一土
媊	女䒑月刂
媋	女三人日
媌	女艹田󰀝
媍	女⺈貝󰁶
媎	女土丿日
媏	女山丆〢
媐	匚丨口女
媑	女丿一土
媒	女甘木󰁶
媓	女白王󰀝
媔	女丆囗二
媕	女人一廾
媖	女艹ㄇ大
媗	女宀一一
媘	女󰁴匕白
媙	女戊一女
媚	女󰁅目󰀝
媛	女爫一又
媜	女󰀥貝󰁶
媝	禾火女󰀘
媞	女曰一󰁾
媟	女廿󰄃木
媠	女工月
媡	女木󰀹󰀝
媢	女󰀰目󰀝
媣	女氵九木
媤	女田心󰁶
媥	女丶尸艹
媦	女田月󰀝
媧	女ㄇ󰁈口
媨	女丷西一
媩	女古月󰀝
媪	女曰皿󰀝
媫	女󰀥󰁬󰁾
媬	女亻口木
媭	彡丆贝女
媮	女人一刂
媯	女丶丿灬
媰	女勹凵丿
媱	女爫𠂉凵
媲	女丿囗匕
媳	女丿目心
媴	女土口󰀔
媵	月丷夫女
媶	女艹耳󰀝
媷	女厂二寸
媸	女凵丨虫
媹	女󰁚丶田
媺	女山一攵
媻	丿󰁪几女
媼	女囗人皿
媽	女󰀋灬󰁶
媾	女󰀀冂土
媿	女白󰁜厶
嫀	女三人禾
嫁	女宀一󰀓
嫂	女臼丨又
嫃	女十󰀣八
嫄	女厂白小
嫅	女⺶工󰀝
嫆	女宀八口
嫇	女冖曰六
嫈	火火冖女
嫉	女疒𠂉大
嫊	女幺小
嫋	女弓冫冫
嫌	女䒑󰁬八
嫍	女爫臼󰀝
嫎	女亠丷方
嫏	女丶󰁮阝
嫐	女田力女
嫑	丆卜覀女
嫒	女爫冖又
嫓	女⺈ㄇ匕
嫔	女宀丘八
嫕	女匚𠂉心
嫖	女覀二小
嫗	女匚口口
嫘	女田幺小
嫙	女方𠂉󰁾
嫚	女曰罒又
嫛	匚𠂉大女
嫜	女立早󰀢
嫝	女广󰁬氺
嫞	女广󰁬丨
嫟	女匚艹口
嫠	未攵厂女
嫡	女亠丷古
嫢	夫目儿女
嫣	女一止灬
嫤	女廿口
嫥	女一曰寸
嫦	女⺌冖丨
嫧	女貝󰁶
嫨	女廿口夫
嫩	女木口攵
嫪	女羽人彡
嫫	女艹曰大
嫬	女广廿灬
嫭	女虍丿󰀛
嫮	女󰀙二ㄅ
嫯	󰁡攵女
嫰	女木口人
嫱	女十䒑口
嫲	女广木木
嫳	㡀攵女󰀘
嫴	女古辛󰀢
嫵	女𠂉一灬
嫶	女亻󰁷灬
嫷	女阝月
嫸	女羊䒑口
嫹	女󰁺由八
嫺	女門月󰀝
嫻	女門木󰁶
嫼	女󰀹土灬
嫽	女大丷小
嫾	女米夕㐄
嫿	女󰁬土一
嬀	女爫丿灬
嬁	女癶一䒑
嬂	女亠丷日
嬃	彡丆貝女
嬄	女士冖䒑
嬅	女艹一󰀟
嬆	女人一羽
嬇	女口丨貝
嬈	女土土儿
嬉	女士口口
嬊	廿口丬女
嬋	女口口十
嬌	女丿大口
嬍	女山一攵
嬎	女⺈口
嬏	女丿米田
嬐	女人一人
嬑	女立曰心
嬒	女人一日
嬓	女白方攵
嬔	女⺈口
嬕	女罒土十
嬖	尸口辛女
嬗	女亠囗一
嬘	女䒑󰀓辶
嬙	女土人口
嬚	女广䒑八
嬛	女罒一󰀔
嬜	立日⺈女
嬝	女󰁟亠󰀔
嬞	女艹丿土
嬟	女丷王丶
嬠	女口口木
嬡	女爫冖夂
嬢	女六󰀀󰀔
嬣	女宀心丁
嬤	女广木幺
嬥	女羽亻󰁷
嬦	女士乛寸
嬧	女󰁬丨皿
嬨	女䒑幺心
嬩	女󰀗一八
嬪	女宀一貝
嬫	女火火木
嬬	女󰀙丆〢
嬭	女一八乂
嬮	厂曰月女
嬯	女士口土
嬰	貝貝女󰀘
嬱	氵車斤女
嬲	田力女力
嬳	女艹亻又
嬴	󰄹月女丶
嬵	女糹白丨
嬶	女丿目󰀯
嬷	女广木厶
嬸	女宀丿田
嬹	女󰀗ㄇ八
嬺	女匚艹心
嬻	女士罒貝
嬼	女󰁚丶刂
嬽	女罒丨大
嬾	女木口貝
嬿	女廿口灬
孀	女󰀙木目
孁	󰀙口口女
孂	女⺮艮皿
孃	女亠口󰀔
孄	女門木󰀹
孅	女人人󰀞
孆	女貝貝女
孇	女亻󰁷又
孈	女山亻口
孉	女艹口󰁷
孊	女广木三
孋	女一ㄇ匕
孌	言糹糹女
孍	女口口攵
孎	女尸氺虫
孏	女艹門󰀹
子	子子子子
孑	孑乛亅󰀞
孒	了一󰀌
孓	了󰂃󰀦
孔	孑乚󰁀
孕	乃子󰀘
孖	孑子󰀝
字	宀子󰀘
存	丨子󰀌
孙	孑小󰁶
孚	爫子󰀘
孛	十冖子󰀘
孜	孑攵󰁶
孝	土丿子󰀘
孞	子心󰁧
孟	子皿󰀘
孠	𠃌一口子
孡	孑厶口󰀝
孢	孑勹巳󰁀
季	禾子󰀘
孤	孑⺁厶󰂃
孥	女又子󰀘
学	󰀧冖子󰀘
孧	幺力子󰀘
孨	子孑子󰀘
孩	孑亠ㄥ人
孪	亠󰁗子󰀘
孫	孑丿幺小
孬	丆卜女子
孭	孑貝󰁶
孮	孑宀二小
孯	匚丨󰁃子
孰	󰁸孑九丶
孱	尸子孑子
孲	孑一󰀚一
孳	䒑幺幺子
孴	子孑子日
孵	󰁚丶丿子
孶	亠幺亠子
孷	未攵厂子
學	󰀗乂乂子
孹	尸口辛子
孺	孑󰀙丆〢
孻	孑󰁬丨皿
孼	凵丿丿子
孽	艹丿󰃧子
孾	孑貝貝女
孿	言糹糹子
宀	宀丶丶乛
宁	宀丁󰀬
宂	宀几󰀅
它	宀匕󰀅
宄	宀九󰀅
宅	宀丿七󰀅
宆	宀弓󰀅
宇	宀一󰀛󰀬
守	宀寸󰁧
安	宀女󰀘
宊	宀犬󰁧
宋	宀木󰁧
完	宀二儿󰀅
宍	宀六󰁧
宎	宀丿大󰁧
宏	宀厶󰁧
宐	宀丨乛一
宑	宀二󰀯󰀬
宒	宀毛󰀅
宓	宀心丿󰁣
宔	宀丶王󰀘
宕	宀石󰀘
宖	宀弓厶󰁧
宗	宀二小󰁧
官	宀󰃧󰀘
宙	宀由󰀘
定	宀一󰁾󰁧
宛	宀夕⺋󰀅
宜	宀󰀐一󰀘
宝	宀王丶󰁧
实	宀󰁦大󰁧
実	宀三人󰁧
宠	宀ヒ丶
审	宀曰丨󰀬
客	宀夂口󰀘
宣	宀一曰一
室	宀一厶土
宥	宀月󰀘
宦	宀匚丨丨
宧	宀匚丨丨
宨	宀儿󰀪󰁧
宩	宀米󰁧
宪	宀丿土儿
宫	宀口口󰀘
宬	宀戊𠃌󰀅
宭	宀󰁬丿口
宮	宀口丿口
宯	宀土丿子
宰	宀辛󰀬
宱	宀亻𠂉二
宲	宀口木󰁧
害	宀三丨口
宴	宀曰女󰀘
宵	宀⺌月󰀘
家	宀一󰀓󰁧
宷	宀丿米󰁧
宸	宀厂二󰀖
容	宀八人口
宺	宀口一󰀸
宻	宀又丷山
宼	宀二儿女
宽	宀艹ㄇ󰁜
宾	宀丘八󰁧
宿	宀亻丆曰
寀	宀爫木󰁧
寁	宀一󰁬󰁾
寂	宀上小又
寃	宀⺈口丶
寄	宀大丁口
寅	宀一由八
密	宀心丿山
寇	宀二儿又
寈	宀月󰀘
寉	宀亻󰁷󰀘
寊	宀󰀥貝󰁧
寋	宀󰀀八⺋
富	宀一口田
寍	宀心皿󰀘
寎	宀爿一人
寏	宀⺈ㄇ大
寐	宀爿未󰁧
寑	宀亻󰁬又
寒	宀󰀀八󰁦
寓	宀曰冂丶
寔	宀曰一󰁾
寕	宀丆罒丁
寖	宀氵彐又
寗	宀心丿土
寘	宀十󰀣八
寙	宀⺁厶󰂃
寚	宀王𠂉凵
寛	宀艹目儿
寜	宀心皿亅
寝	宀丬彐又
寞	宀艹曰大
察	宀󰁯二小
寠	宀󰀻女󰀘
寡	宀丆󰀐刀
寢	宀爿彐又
寣	宀爿言󰀘
寤	宀爿五口
寥	宀羽人彡
實	宀毌貝󰁧
寧	宀心皿丁
寨	宀󰀀八朩
審	宀丿米田
寪	宀爫丿灬
寫	宀臼勹灬
寬	宀艹目丶
寭	宀一曰心
寮	宀大丷小
寯	宀亻󰁷𠃌
寰	宀罒一󰀔
寱	宀爿丿木
寲	宀匕𠂉󰁾
寳	宀王⺈貝
寴	宀立朩儿
寵	宀立月三
寶	宀王𠂉貝
寷	宀山三䒑
寸	寸一亅丶
对	又寸󰁶
寺	土寸󰁧
寻	彐寸󰁧
导	巳寸󰁧
寽	爫寸󰁧
対	文寸󰁶
寿	三丿寸󰁧
尀	匚口寸󰁶
封	土土寸󰁶
専	一由寸󰁧
尃	甫寸󰁧
射	丿󰀽三寸
尅	古儿寸󰀦
将	丬夕寸󰁶
將	爿󰁝寸󰁶
專	一曰丨寸
尉	尸二小寸
尊	丷西一寸
尋	彐工口寸
尌	士口䒑寸
對	业丷王寸
導	䒑丿目寸
小	小亅丿丶
尐	小乙󰀅
少	小丿󰀏
尒	人小󰁧
尓	𠂉小󰁧
尔	⺈小󰁧
尕	乃小󰁧
尖	小大󰁧
尗	上小󰁧
尘	小土󰀘
尙	小冂口󰀘
尚	⺌冂口󰀘
尛	小小小󰁧
尜	小大小󰁧
尝	⺌冖二厶
尞	大丷曰小
尟	日一󰁾丿
尠	󰀎八󰄃丿
尡	⺌一儿匕
尢	乚󰁫
尣	八儿󰀅
尤	乚丶󰀦
尥	乚勹丶
尦	八儿勹丶
尧	󰀁丿一儿
尨	乚彡丶
尩	八儿王󰀌
尪	乚王󰀌
尫	一儿王󰀌
尬	乚人󰀯
尭	十艹一儿
尮	乚乃木
尯	乚⺈⺋
尰	乚丿土
就	󰁸小丶
尲	乚䒑八
尳	乚󰀾月
尴	乚〢皿
尵	乚口貝
尶	一儿匚皿
尷	乚匚皿
尸	尸󰁈一丿
尹	󰁬丿󰀏
尺	尸󰂃󰀦
尻	尸九󰁫
尼	尸匕󰁫
尽	尸󰂃󰁦󰁧
尾	尸毛󰁫
尿	尸水󰀦
局	尸𠃌口󰀌
屁	尸󰁴匕󰁫
层	尸二厶󰀦
屃	尸贝󰀦
屄	尸宀八󰀦
居	尸古󰀌
屆	尸士凵󰀵
屇	尸田󰀌
屈	尸凵山󰀵
屉	尸廿󰄃󰁫
届	尸由󰀌
屋	尸一厶土
屌	尸口冂丨
屍	尸一夕匕
屎	尸米󰀦
屏	尸䒑廾󰀵
屐	尸彳十又
屑	尸⺌月󰀌
屒	尸厂二󰀖
屓	尸貝󰀦
屔	丘尸匕󰁀
展	尸󰁺󰀖󰀦
屖	尸辛󰀵
屗	尸毛寸󰀦
屘	尸毛子󰀌
屙	尸阝丁口
屚	尸雨󰀦
屛	尸丿一干
屜	尸彳廿󰄃
屝	尸丨三三
属	尸丿口丶
屟	尸廿󰄃木
屠	尸土丿曰
屡	尸米女󰀌
屢	尸󰀻女󰀌
屣	尸彳止󰁾
層	尸丷󰀺日
履	尸彳𠂉夂
屦	尸彳米女
屧	尸彳廿木
屨	尸彳󰀻女
屩	尸彳丿口
屪	尸宀大小
屫	尸爿丿口
屬	尸氺罒虫
屭	尸貝貝貝
屮	凵丨󰀵
屯	一凵乚󰁫
屰	䒑凵丿󰁣
山	山山山山
屲	丿山󰀬
屳	丿󰂃山󰀬
屴	山力󰁣
屵	山厂󰁣
屶	山刀󰁣
屷	山乃󰁥
屸	山工󰀝
屹	山𠂉乙󰁀
屺	山己󰁀
屻	山刀丶󰁶
屼	山一儿󰁀
屽	山干󰀢
屾	山山󰀢
屿	山一ㄅ一
岀	山山󰀬
岁	山夕󰁧
岂	山己󰀅
岃	山刀丶󰁧
岄	山月󰀝
岅	山⺁又󰁶
岆	山丿大󰁶
岇	山󰁚卩󰀬
岈	山󰀄亅丿
岉	山勹󰁤󰁥
岊	巴山󰀬
岋	山乃󰂃󰁶
岌	山乃󰂃󰁧
岍	山一廾󰀢
岎	山八刀󰁥
岏	山二儿󰁀
岐	山十又󰁶
岑	山人丶乛
岒	山人丶乛
岓	山斤󰀢
岔	八刀山󰀬
岕	山人󰀯󰀬
岖	山匚乂󰁶
岗	山冂乂󰁧
岘	山ㄇ󰁜󰁀
岙	丿大山󰀬
岚	山几乂󰁧
岛	󰁠山󰀵
岜	山巴󰀅
岝	山𠂉丨二
岞	山𠂉丨二
岟	山ㄇ大󰁶
岠	山匚󰁃󰀝
岡	冂䒑山󰀵
岢	山丁口󰀘
岣	山勹口󰀝
岤	山宀八󰁶
岥	山皮󰁶
岦	山立󰀘
岧	山刀口󰀘
岨	山󰀐一󰀝
岩	山石󰀘
岪	山弓󰀯󰀬
岫	山由󰀝
岬	山甲󰀢
岭	山人丶󰁻
岮	山宀匕󰁀
岯	山丆卜一
岰	山幺力󰁥
岱	亻󰀁丶山
岲	山口儿󰁀
岳	丘山󰀬
岴	山丘󰀝
岵	山古󰀝
岶	山白󰀝
岷	山󰁂󰀁󰁀
岸	山厂干󰀬
岹	山刀口󰀝
岺	山人丶󰁻
岻	山󰁚󰀁丶
岼	山一丷十
岽	山󰀂小󰁧
岾	山󰀥口󰀝
岿	山リ彐󰀘
峀	山由󰀘
峁	山󰁚丿卩
峂	山夂󰁦󰁶
峃	󰀧冖山󰀬
峄	山又󰀟󰀢
峅	山厶廾󰀢
峆	山人一口
峇	山人一口
峈	山夂口󰀝
峉	山夂口󰀘
峊	丿󰃧山󰀬
峋	山勹日󰀝
峌	山一厶土
峍	山󰁬󰀟󰀢
峎	山艮󰁧
峏	山丆冂〢
峐	山亠ㄥ人
峑	山人王󰀘
峒	山冂一口
峓	山一弓人
峔	山土丿匕
峕	山亠曰󰀘
峖	山宀女󰀝
峗	山⺈厂⺋
峘	山一曰一
峙	山土寸󰁶
峚	山大土󰀘
峛	山一夕刂
峜	山人止󰀘
峝	山冂一口
峞	山⺈厂⺋
峟	山月󰀘
峠	山上一卜
峡	山一丷大
峢	山一夕刂
峣	山󰀁丿儿
峤	山丿大󰀯
峥	山⺈󰁬亅
峦	亠󰁗山󰀬
峧	山六乂󰁶
峨	山丿扌丶
峩	山丿扌丶
峪	山八人口
峫	山󰀄亅阝
峬	山甫󰁶
峭	山⺌月󰀝
峮	山󰁬丿口
峯	山夂三丨
峰	山夂三丨
峱	犭󰁥󰁈山
峲	山禾刂󰀬
峳	山亻丨攵
峴	山目儿󰁀
峵	山宀厶
島	󰁟山󰀵
峷	山辛󰀬
峸	山戊𠃌󰁀
峹	人一朩山
峺	山一曰乂
峻	山厶八夂
峼	山丿土口
峽	山大人人
峾	氵斤山󰀬
峿	山五口󰀝
崀	山丶艮󰁧
崁	山土⺈人
崂	山艹冖力
崃	山一丷木
崄	山人一一
崅	山⺈用󰀢
崆	山宀八工
崇	山宀二小
崈	宀二小山
崉	山水曰󰀝
崊	山木木󰁶
崋	山一艹󰀟
崌	山尸古󰀝
崍	山木人人
崎	山大丁口
崏	山󰁚󰀁日
崐	山曰󰁴匕
崑	山曰󰁴匕
崒	山亠人十
崓	山囗古󰀝
崔	山亻󰁷󰀘
崕	山厂土土
崖	山厂土土
崗	山冂䒑山
崘	山人一艹
崙	山人一艹
崚	山土八夂
崛	山尸凵山
崜	山丿士󰁺
崝	山月󰀝
崞	山󰁸子󰀝
崟	山金󰀘
崠	山木曰󰀝
崡	山了󰀪凵
崢	山爫󰁬亅
崣	山禾女󰀘
崤	山乂月
崥	山白丿十
崦	山大曰乚
崧	山木八厶
崨	山一󰁬󰁾
崩	山月月󰀘
崪	山亠人十
崫	山尸凵山
崬	山木曰󰀘
崭	山车斤󰀬
崮	山囗古󰀘
崯	山金󰀝
崰	山巛田󰀝
崱	山貝刂󰀬
崲	山白王󰀝
崳	山人一刂
崴	山戊一女
崵	山曰一󰁤
崶	山土土寸
崷	山丷西一
崸	山丆貝󰁶
崹	山亠丷丨
崺	山方𠂉也
崻	山彳土寸
崼	山曰一󰁾
崽	山田心󰁧
崾	山覀女󰀝
崿	山口口ㄅ
嵀	山木丶王
嵁	山󰀎八󰄃
嵂	山彳󰁬󰀟
嵃	山立丿彡
嵄	山丷王大
嵅	山戊一口
嵆	禾乚山
嵇	禾乚山
嵈	山爫一又
嵉	山󰁸冖丁
嵊	山禾丬匕
嵋	山󰁅目󰀝
嵌	山甘⺈人
嵍	󰁻乛亅山
嵎	山曰冂丶
嵏	山乂凵夂
嵐	山几丿虫
嵑	山曰勹󰄃
嵒	口口口山
嵓	山口口口
嵔	山田一󰀖
嵕	山乂凵夂
嵖	山木曰一
嵗	山戊一󰀤
嵘	山艹冖木
嵙	山禾󰁦十
嵚	山钅⺈人
嵛	山人一刂
嵜	山立口亅
嵝	山米女󰀝
嵞	人一朩山
嵟	山厂亻󰁷
嵠	山爫幺大
嵡	山八厶羽
嵢	山人丶口
嵣	山广󰁬口
嵤	火火冖山
嵥	山夕㐄木
嵦	山山一䒑
嵧	山󰁚丶田
嵨	山󰁞灬󰁶
嵩	山󰁸冂口
嵪	山󰁸冂口
嵫	山䒑幺幺
嵬	山白󰁜厶
嵭	山亠丷方
嵮	山十󰀣八
嵯	山⺶工󰀝
嵰	山䒑󰁬八
嵱	山宀八口
嵲	山丿目木
嵳	山⺶工󰀘
嵴	山󰀪人月
嵵	山日土寸
嵶	山弓冫冫
嵷	山彳人󰁾
嵸	山彳人󰁾
嵹	山弓口虫
嵺	山羽人彡
嵻	山广󰁬氺
嵼	山立丿
嵽	山廿儿丨
嵾	山厶厶彡
嵿	山丁丆貝
嶀	山󰀙二ㄅ
嶁	山󰀻女󰀝
嶂	山立早󰀢
嶃	山車斤󰀢
嶄	山車斤󰀬
嶅	󰁡攵山
嶆	山一ㄇ日
嶇	山匚口口
嶈	山爿󰁝寸
嶉	山口亻󰁷
嶊	山扌亻󰁷
嶋	山󰁟灬󰁶
嶌	山󰁟灬󰁧
嶍	山羽白󰀝
嶎	山尸二寸
嶏	山厂西己
嶐	山阝夂一
嶑	山⺈口󰀓
嶒	山丷󰀺日
嶓	山丿米田
嶔	山釒⺈人
嶕	山亻󰁷灬
嶖	山人一羽
嶗	山火火力
嶘	山木戈戈
嶙	山米夕㐄
嶚	山大丷小
嶛	山大丷小
嶜	山󰀄󰁜日
嶝	山癶一䒑
嶞	阝工山
嶟	山丷西寸
嶠	山丿大口
嶡	山厂䒑人
嶢	山土土儿
嶣	山亻󰁷灬
嶤	山土土儿
嶥	山厂䒑人
嶦	山⺈厂言
嶧	山罒土十
嶨	󰀗乂乂山
嶩	山ㄇ󰁺󰀖
嶪	山业䒑未
嶫	山业䒑未
嶬	山丷王丶
嶭	山丿󰃧辛
嶮	山人一人
嶯	山口耳丶
嶰	山⺈用󰀟
嶱	山艹曰󰄃
嶲	山亻󰁷𠃌
嶳	山一󰀓土
嶴	丿冂米山
嶵	山罒丨三
嶶	山彳山攵
嶷	山匕𠂉󰁾
嶸	山火火木
嶹	山士乛寸
嶺	山人丶貝
嶻	山十戈󰁷
嶼	山󰀗一八
嶽	山犭󰁥犬
嶾	山爫工心
嶿	山󰀙丆〢
巀	山小亻戈
巁	山厂艹丶
巂	山亻󰁷口
巃	山立月三
巄	山立月三
巅	山十󰀣贝
巆	山火火口
巇	山虍一戈
巈	山廿󰀜米
巉	山⺈口丶
巊	山貝貝女
巋	山丿󰃧丨
巌	山󰀧厂攵
巍	山禾女厶
巎	山丆目夂
巏	山艹口󰁷
巐	山󰁸冂廾
巑	山丿土貝
巒	言糹糹山
巓	山匕目貝
巔	山十󰀣貝
巕	山䒑丿女
巖	山口口攵
巗	山口口攵
巘	山虍一犬
巙	山䒑丿夂
巚	山虍一犬
巛	巛󰁑󰁑󰁑
巜	巜󰁑󰁑
川	川丿丨丨
州	丶丿丶丨
巟	亠󰄃󰀸󰀅
巠	一巛工󰀘
巡	巛辶󰁫
巢	巛曰木󰁧
巣	󰀧曰木󰁧
巤	巛囗乂󰁐
工	工工工工
左	工󰀘
巧	工一ㄅ󰁀
巨	匚󰁃󰀌
巩	工几丶󰁶
巪	匚󰁃󰁈󰀅
巫	工人人󰀦
巬	工几夫󰁧
巭	工力夫󰁧
差	⺶工󰀘
巯	ス工亠󰀸
巰	一巛工󰀸
己	己󰁈一乚
已	已已已已
巳	巳󰁈一乚
巴	巴󰁈丨乚
巵	⺁一巴󰁫
巶	刀口巳󰁀
巷	󰁺八巳󰀅
巸	匚丨口巳
巹	了󰀩一己
巺	巳巳一八
巻	丷夫己󰀅
巼	巴口匕󰀅
巽	巳巳󰁺八
巾	冂丨󰀵
巿	一冂丨󰀵
帀	一冂丨󰀵
币	丿冂丨󰀵
市	亠冂丨󰀬
布	冂丨󰀬
帄	冂丨丁󰀢
帅	リ冂丨󰀢
帆	冂丨几丶
帇	󰁬冂丨󰀵
师	リ一冂丨
帉	冂丨八刀
帊	冂丨巴󰁀
帋	󰁚󰀁冂丨
希	乂冂丨
帍	丶尸冂丨
帎	冂丨冖󰁜
帏	冂丨二丨
帐	冂丨丿󰂃
帑	女又冂丨
帒	亻󰀁丶丨
帓	冂丨一木
帔	冂丨皮󰁶
帕	冂丨白󰀝
帖	冂丨󰀥口
帗	冂丨丶
帘	宀八冂丨
帙	冂丨丿夫
帚	彐冖冂丨
帛	白冂丨󰀬
帜	冂丨口八
帝	亠丷冖丨
帞	冂丨丆日
帟	亠󰁖冂丨
帠	臼冂丨󰀬
帡	冂丨䒑廾
帢	冂丨人口
帣	丷夫冂丨
帤	女口冂丨
帥	丿󰃧冂丨
带	一〣冖丨
帧	冂丨󰀥贝
帨	冂丨丷儿
帩	冂丨⺌月
帪	冂丨厂󰀖
師	丿󰃧一丨
帬	󰁬丿口丨
席	广廿冂丨
帮	三丿阝丨
帯	一〣一丨
帰	丶丿彐丨
帱	冂丨三寸
帲	冂丨丿干
帳	冂丨󰀍󰀖
帴	冂丨戈戈
帵	冂丨宀⺋
帶	廿儿冖丨
帷	冂丨亻󰁷
常	⺌冖口丨
帹	冂丨立女
帺	冂丨󰀎八
帻	冂丨贝
帼	冂丨囗丶
帽	冂丨󰀰目
帾	冂丨土日
帿	冂丨亻大
幀	冂丨󰀥貝
幁	冂丨丆貝
幂	冖曰大丨
幃	冂丨󰁆㐄
幄	冂丨尸土
幅	冂丨一田
幆	冂丨曰󰄃
幇	土土寸丨
幈	冂丨尸廾
幉	冂丨廿木
幊	冂丨工貝
幋	丿󰁪几丨
幌	冂丨曰儿
幍	冂丨爫臼
幎	冂丨冖六
幏	冂丨宀󰀓
幐	月丷夫丨
幑	彳山丿攵
幒	冂丨丿心
幓	冂丨厶彡
幔	冂丨曰又
幕	艹曰大丨
幖	冂丨覀小
幗	冂丨囗󰀞
幘	冂丨貝
幙	冂丨艹大
幚	三丿阝丨
幛	冂丨立早
幜	冂丨日小
幝	冂丨口十
幞	冂丨业夫
幟	冂丨亠日
幠	冂丨𠂉灬
幡	冂丨丿田
幢	冂丨立土
幣	㡀攵冂丨
幤	⺌冂口丨
幥	冂丨⺌手
幦	尸口辛丨
幧	冂丨口木
幨	冂丨⺈言
幩	冂丨十貝
幪	冂丨艹󰀓
幫	土土寸丨
幬	冂丨士寸
幭	冂丨艹人
幮	冂丨广寸
幯	冂丨⺮卩
幰	冂丨宀心
幱	冂丨門󰀹
干	干一一丨
平	一丷十󰀵
年	𠂉㐄󰀬
幵	一干󰀢
并	䒑廾󰀬
幷	丿一干
幸	土䒑十󰀬
幹	十早人干
幺	幺幺幺幺
幻	幺𠃌󰁀
幼	幺力󰁥
幽	山幺幺󰀦
幾	幺幺戈人
广	广丶一丿
庀	广匕󰁫
庁	广丁󰀵
庂	广人󰀦
広	广厶󰀦
庄	广土󰀌
庅	广丿厶󰀦
庆	广大󰀦
庇	广󰁴匕󰁫
庈	广人丶乛
庉	广一凵乚
床	广木󰀦
庋	广十又󰀦
庌	广󰀄亅丿
庍	广斤󰀵
庎	广人󰀯󰀵
序	广󰁻乛亅
庐	广丶尸󰀏
庑	广二󰁜󰁫
庒	广土丶󰀦
库	广车󰀵
应	广󰀧一󰀌
底	广󰁚󰀁丶
庖	广勹巳󰁫
店	广󰀥口󰀌
庘	广甲󰀵
庙	广由󰀌
庚	广󰁬人󰀦
庛	广止匕󰁫
府	广亻寸󰀦
庝	广夂󰁦󰀦
庞	广ヒ丶
废	广ㄥ丿丶
庠	广羊󰀵
庡	广亠󰀔󰀦
庢	广一厶土
庣	广儿󰀪󰀦
庤	广土寸󰀦
庥	广亻木󰀦
度	广廿又󰀦
座	广人人土
庨	广土丿子
庩	广人一朩
庪	广扌十又
庫	广車󰀵
庬	广乚丶
庭	广丿土廴
庮	广西一󰀌
庯	广甫󰀦
庰	广䒑廾󰀵
庱	广土八夂
庲	广木人人
庳	广白丿十
庴	广󰁺日󰀌
庵	广大曰乚
庶	广廿灬󰀦
康	广󰁬氺󰀦
庸	广󰁬月丨
庹	广廿尸󰂃
庺	广八厶木
庻	广廿人人
庼	广󰁴丆贝
庽	广曰冂丶
庾	广臼人󰀦
庿	广艹田󰀌
廀	广宀火又
廁	广貝刂󰀵
廂	广木目󰀌
廃	广癶二儿
廄	广󰁮几又
廅	广土厶皿
廆	广白󰁜厶
廇	广󰁚丶田
廈	广丆目夂
廉	广䒑󰁬八
廊	广丶󰁮阝
廋	广臼丨又
廌	󰁙一ㄅ灬
廍	广立口阝
廎	广󰁴丆貝
廏	广白匕又
廐	广白匕󰁜
廑	广廿口
廒	广󰁡攵
廓	广󰁸孑阝
廔	广󰀻女󰀌
廕	广阝人厶
廖	广羽人彡
廗	广廿儿丨
廘	广󰁙󰁴匕
廙	广田󰁺八
廚	广士口寸
廛	广曰土土
廜	广尸土日
廝	广󰀎八斤
廞	广釒⺈人
廟	广十早月
廠	广⺌冂攵
廡	广𠂉一灬
廢	广癶弓又
廣	广󰁺由八
廤	广車口匕
廥	广人一日
廦	广尸口辛
廧	广土人口
廨	广⺈用󰀟
廩	广亠囗禾
廪	广亠囗小
廫	广月羽彡
廬	广虍田皿
廭	广禾貝
廮	广貝貝女
廯	广󰁢灬羊
廰	广耳十心
廱	广巛口󰁷
廲	广一ㄇ匕
廳	广耳王心
廴	廴󰁌󰂃
廵	巛廴󰁫
延	丿󰀥󰄃廴
廷	丿士廴󰀌
廸	由廴󰀌
廹	白廴󰀌
建	󰁬󰀟廴󰀵
廻	囗口廴󰀌
廼	西廴󰀌
廽	囗〢二廴
廾	廾一丿丨
廿	廿一丨一
开	一廾󰀵
弁	厶廾󰀬
异	巳廾󰀬
弃	亠厶廾󰀬
弄	王廾󰀬
弅	八刀廾󰀬
弆	土厶廾󰀬
弇	人一口廾
弈	亠󰁖廾󰀬
弉	爿士廾󰀬
弊	㡀攵廾󰀬
弋	󰀁丶󰀦
弌	󰀁一丶󰀦
弍	󰀁二丶󰀦
弎	󰀁三丶󰀦
式	󰀁工丶󰀦
弐	一󰀁二丶
弑	乂朩󰀁丶
弒	乂木丶丶
弓	弓󰁈一ㄅ
弔	弓丨󰀵
引	弓丨󰀢
弖	弓一󰀘
弗	弓󰀯󰀵
弘	弓厶󰁶
弙	弓一󰀛󰀢
弚	丷弓丨󰀬
弛	弓也󰁀
弜	弓弓󰁀
弝	弓巴󰁀
弞	弓⺈人󰁶
弟	丷弓丨丿
张	弓丿七󰂃
弡	弓匚󰁃󰀝
弢	弓凵丨又
弣	弓亻寸󰁶
弤	弓󰁚󰀁丶
弥	弓⺈小󰁶
弦	弓亠幺󰁶
弧	弓⺁厶󰂃
弨	弓刀口󰀝
弩	女又弓󰀅
弪	弓ス工󰀝
弫	弓匚丨丨
弬	弓匚丨丨
弭	弓耳󰀝
弮	丷夫弓󰀅
弯	亠󰁗弓󰀅
弰	弓⺌月󰀝
弱	弓冫弓冫
弲	弓口月󰀝
弳	弓一巛工
弴	弓󰁸子󰀝
張	弓󰀍󰀖󰁶
弶	弓󰁸小󰁶
強	弓厶虫󰁶
弸	弓月月󰀝
弹	弓丷曰十
强	弓口虫󰁶
弻	弓一囗弓
弼	弓丆日弓
弽	弓廿󰄃木
弾	弓󰀧曰十
弿	宀󰀀八弓
彀	士冖一又
彁	弓丁口口
彂	业弓𠂉大
彃	弓曰艹󰀟
彄	弓匚口口
彅	弓䒑月刀
彆	㡀攵弓󰀅
彇	弓󰁬十󰀲
彈	弓口口十
彉	弓󰁺由八
彊	弓一田一
彋	弓罒一󰀔
彌	弓一八乂
彍	弓广󰁺八
彎	言糹糹弓
彏	弓目目又
彐	彐󰁈一一
彑	彑ㄥ乛一
归	リ彐󰀝
当	⺌彐󰀘
彔	彑氺󰁧
录	󰁭氺󰁧
彖	彑󰀓󰁧
彗	三丨三彐
彘	彑󰁴𠂉匕
彙	彑冖日木
彚	󰁭冖曰木
彛	󰁭米八廾
彜	彑米八廾
彝	彑米幺廾
彞	󰁭米幺廾
彟	彐寸艹又
彠	彐工口又
彡	彡丿丿丿
形	一廾彡󰁥
彣	文彡󰀏
彤	󰀼亠彡󰁥
彥	文厂彡󰁣
彦	立丿彡󰀏
彧	戈口󰀞󰁤
彨	一冂丶彡
彩	爫木彡󰁥
彪	虍几彡󰀏
彫	󰀼土口彡
彬	木木彡󰁥
彭	士口䒑彡
彮	宀八人彡
彯	覀二小彡
彰	立早彡󰁥
影	曰󰁸小彡
彲	一ㄇ丶彡
彳	彳丿丿丨
彴	彳勹丶󰁶
彵	彳也󰁀
彶	彳乃󰂃󰁶
彷	彳方󰁥
彸	彳八厶󰁶
役	彳几又󰁶
彺	彳王󰀝
彻	彳七刀󰁥
彼	彳皮󰁶
彽	彳󰁚󰀁丶
彾	彳人丶󰁻
彿	彳弓󰀯󰀢
往	彳丶王󰀝
征	彳一止󰀝
徂	彳󰀐一󰀝
徃	彳丿󰀝
径	彳ス工󰀝
待	彳土寸󰁶
徆	彳西󰀝
徇	彳勹日󰀝
很	彳艮󰁶
徉	彳羊󰀢
徊	彳囗口󰀝
律	彳󰁬󰀟󰀢
後	彳幺夂󰁶
徍	彳土土󰀝
徎	彳口王󰀝
徏	彳止󰀤󰁥
徐	彳人一朩
徑	彳一巛工
徒	彳土󰁾󰁶
従	彳䒑󰁾󰁶
徔	彳艹之󰁶
徕	彳一丷木
徖	彳宀二小
得	彳曰一寸
徘	彳丨三三
徙	彳止󰁾󰁶
徚	彳木󰀹󰀝
徛	彳大丁口
徜	彳⺌冂口
徝	彳十󰀣󰀝
從	彳人人󰁾
徟	彳󰀼土口
徠	彳木人人
御	彳𠂉一卩
徢	彳一󰁬󰁾
徣	彳󰁺日󰀝
徤	彳󰁬󰀟廴
徥	彳日一󰁾
徦	彳󰁃丨又
徧	彳丶尸艹
徨	彳白王󰀝
復	彳𠂉日夂
循	彳⺁十目
徫	彳󰁆口㐄
徬	彳亠丷方
徭	彳爫𠂉凵
微	彳山一攵
徯	彳爫幺大
徰	彳一止止
徱	彳覀二小
徲	彳尸氺󰀟
徳	彳十罒心
徴	彳山王攵
徵	彳山一攵
徶	彳㡀攵󰁶
德	彳十罒心
徸	彳立曰土
徹	彳亠厶攵
徺	彳土土儿
徻	彳人一日
徼	彳白方攵
徽	彳山一攵
徾	彳山言攵
徿	彳立月三
忀	彳亠口󰀔
忁	彳曰凵氺
忂	彳目目󰁷
心	心丶乚丶
忄	忄丶丨丶
必	心丿󰀏
忆	忄乙󰁀
忇	忄力󰁥
忈	二心󰁧
忉	忄刀󰁥
忊	忄丁󰀢
忋	忄己󰁀
忌	己心󰁧
忍	刀丶心󰁧
忎	丿十心󰁧
忏	忄丿十󰀢
忐	上心󰁧
忑	一卜心󰁧
忒	󰀁心丶󰀦
忓	忄干󰀢
忔	忄𠂉乙󰁀
忕	忄大󰁶
忖	忄寸󰁶
志	士心󰁧
忘	亠󰄃心󰁧
忙	忄亠󰄃󰁀
忚	忄也󰁀
忛	忄几丶󰁶
応	广心󰀦
忝	一大⺗󰁧
忞	文心󰁧
忟	忄文󰁶
忠	口丨心󰁧
忡	忄口丨󰀢
忢	五心󰁧
忣	忄乃󰂃󰁶
忤	忄𠂉十󰀢
忥	气心󰀦
忦	忄人󰀯󰀢
忧	忄乚丶
忨	忄二儿󰁀
忩	八厶心󰁧
忪	忄八厶󰁶
快	忄ユ人󰁶
忬	忄󰁻乛亅
忭	忄亠卜󰁶
忮	忄十又󰁶
忯	忄󰁚󰀁󰁀
忰	忄九十󰀢
忱	忄冖󰁜󰁀
忲	忄大丶󰁶
忳	忄一凵乚
忴	忄人丶乛
念	人丶乛心
忶	忄二厶󰁶
忷	忄乂凵󰀢
忸	忄󰁈丨一
忹	忄王󰀝
忺	忄⺈人󰁶
忻	忄斤󰀢
忼	忄亠几󰁀
忽	勹󰁤心󰁧
忾	忄气󰁀
忿	八刀心󰁧
怀	忄丆卜󰁶
态	大丶心󰁧
怂	人人心󰁧
怃	忄二󰁜󰁀
怄	忄匚乂󰁶
怅	忄丿七󰂃
怆	忄人⺋󰁀
怇	忄匚󰁃󰀝
怈	忄廿󰄃󰁀
怉	忄勹巳󰁀
怊	忄刀口󰀝
怋	忄󰁂󰀁󰁀
怌	忄丆卜一
怍	忄𠂉丨二
怎	𠂉丨二心
怏	忄ㄇ大󰁶
怐	忄勹口󰀝
怑	忄丷󰀟󰀢
怒	女又心󰁧
怓	忄女又󰁶
怔	忄一止󰀝
怕	忄白󰀝
怖	忄冂丨
怗	忄󰀥口󰀝
怘	古心󰁧
怙	忄古󰀝
怚	忄󰀐一󰀝
怛	忄曰一󰀝
怜	忄人丶󰁻
思	田心󰁧
怞	忄由󰀝
怟	忄󰁚󰀁丶
怠	厶口心󰁧
怡	忄厶口󰀝
怢	忄丿夫󰁶
怣	丿夫心󰁧
怤	亻寸心󰁧
急	⺈彐心󰁧
怦	忄一丷十
性	忄丿󰀝
怨	夕⺋心󰁧
怩	忄尸匕󰁀
怪	忄又土󰀝
怫	忄弓󰀯󰀢
怬	忄四󰀝
怭	忄心丿󰁥
怮	忄幺力󰁥
怯	忄土厶󰁶
怰	忄亠幺󰁶
怱	勹󰁤󰂃心
怲	忄一冂人
怳	忄口儿󰁀
怴	忄戈󰁐󰁀
怵	忄木丶󰁶
怶	忄皮󰁶
怷	十儿丶心
怸	木丶心󰁧
怹	亻也心󰁧
怺	忄丶𠃌󰀩
总	丷口心󰁧
怼	又寸心󰁧
怽	忄未󰁶
怾	忄口八󰁶
怿	忄又󰀟󰀢
恀	忄夕夕󰁶
恁	亻丿士心
恂	忄勹日󰀝
恃	忄土寸󰁶
恄	忄士口󰀝
恅	忄土丿匕
恆	忄一丨一
恇	忄匚王󰀝
恈	忄厶丿󰀟
恉	忄匕日󰀝
恊	忄力力力
恋	亠󰁗心󰁧
恌	忄儿󰀪󰁶
恍	忄⺌一儿
恎	忄一厶土
恏	女子心󰁧
恐	工几丶心
恑	忄⺈厂⺋
恒	忄一曰一
恓	忄西󰀝
恔	忄六乂󰁶
恕	女口心󰁧
恖	丿囗乂心
恗	忄大二ㄅ
恘	忄亻木󰁶
恙	丷王心󰁧
恚	土土心󰁧
恛	忄囗口󰀝
恜	忄󰀁工丶
恝	三丨刀心
恞	忄一弓人
恟	忄勹乂凵
恠	忄丨土
恡	忄乂厶
恢	忄火󰁶
恣	冫⺈人心
恤	忄丿皿󰀝
恥	耳心󰁶
恦	忄丿冂口
恧	丆冂〢心
恨	忄艮󰁶
恩	囗大心󰁧
恪	忄夂口󰀝
恫	忄冂一口
恬	忄丿古󰀝
恭	󰁺八⺗󰁧
恮	忄人王󰀝
息	丿目心󰁧
恰	忄人一口
恱	忄八厶儿
恲	忄䒑廾󰀢
恳	艮心󰁧
恴	亠曰心󰁧
恵	一由心󰁧
恶	一业心󰁧
恷	亻木心󰁧
恸	忄二厶力
恹	忄厂犬󰁶
恺	忄山己󰁀
恻	忄贝刂󰀢
恼	忄亠乂凵
恽	忄冖车󰀢
恾	忄艹亠󰄃
恿	󰁻用心󰁧
悀	忄󰁻用󰀢
悁	忄口月󰀝
悂	忄󰁴匕土
悃	忄囗木󰁶
悄	忄⺌月󰀝
悅	忄八口儿
悆	人一朩心
悇	忄人一朩
悈	忄戈廾󰀢
悉	丿米心󰁧
悊	扌斤心󰁧
悋	忄文口󰀝
悌	忄丷弓丿
悍	忄曰干󰀢
悎	忄丿土口
悏	忄大人人
悐	犭󰁥火心
悑	忄甫󰁶
悒	忄口巴󰁀
悓	忄目儿󰁀
悔	忄𠂉母󰁶
悕	忄乂丨
悖	忄十冖子
悗	忄⺈口󰁜
悘	匚𠂉大心
悙	忄󰁸了󰀢
悚	忄木口󰀝
悛	忄厶八夂
悜	忄口王󰀝
悝	忄曰土󰀝
悞	忄口󰁕大
悟	忄五口󰀝
悠	亻丨攵心
悡	禾刂心󰁧
悢	忄丶艮󰁶
患	口口丨心
悤	丿囗夕心
悥	言心󰁧
悦	忄丷口儿
悧	忄禾刂󰀢
您	亻⺈小心
悩	忄󰀧乂凵
悪	一口〢心
悫	士冖几心
悬	󰀐一厶心
悭	忄〢又土
悮	忄口一大
悯	忄门文󰁶
悰	忄宀二小
悱	忄丨三三
悲	丨三丨心
悳	十目󰄃心
悴	忄亠人十
悵	忄󰀍󰀖󰁶
悶	門心󰀦
悷	忄丶尸犬
悸	忄禾子󰀝
悹	宀󰃧心󰁧
悺	忄宀󰃧󰀝
悻	忄土䒑十
悼	忄󰀥早󰀢
悽	忄一󰁬女
悾	忄宀八工
悿	忄一大⺗
惀	忄人一艹
惁	木斤心󰁧
惂	忄⺈臼󰀝
惃	忄日󰁴匕
惄	上小又心
情	忄月󰀝
惆	忄󰀼土口
惇	忄󰁸子󰀝
惈	忄曰木󰁶
惉	氵󰀥口心
惊	忄󰁸小󰁶
惋	忄宀夕⺋
惌	宀夕⺋心
惍	忄金󰀝
惎	󰀎八心󰁧
惏	忄木木󰁶
惐	忄戈口󰀞
惑	戈口󰀞心
惒	禾口心󰁧
惓	忄丷夫⺋
惔	忄火火󰁶
惕	忄曰勹󰁤
惖	曰勹󰁤心
惗	忄人丶乛
惘	忄冂䒑󰄃
惙	忄又又又
惚	忄勹󰁤心
惛	忄󰁚󰀁日
惜	忄󰁺曰󰀝
惝	忄⺌冂口
惞	忄斤⺈人
惟	忄亻󰁷󰀝
惠	一曰丨心
惡	一󰀚一心
惢	心心心󰁧
惣	牜勹󰁤心
惤	忄弓亠幺
惥	臼人心󰁧
惦	忄广󰀥口
惧	忄󰀣八󰁶
惨	忄厶大彡
惩	彳一止心
惪	十󰀣心󰁧
惫	夂田心󰁧
惬	忄匚一大
惭	忄车斤󰀢
惮	忄丷曰十
惯	忄毌贝󰁶
惰	忄工月
惱	忄巛丿乂
惲	忄冖車󰀢
想	木目心󰁧
惴	忄山丆〢
惵	忄廿󰄃木
惶	忄白王󰀝
惷	三人日心
惸	忄勹日子
惹	艹口心
惺	忄曰丿
惻	忄貝刂󰀢
惼	忄丶尸艹
惽	忄󰁂󰀁日
惾	忄乂凵夂
惿	忄日一󰁾
愀	忄禾火󰁶
愁	禾火心󰁧
愂	十冖孑心
愃	忄宀一一
愄	忄田一󰀖
愅	忄廿󰀜󰀢
愆	彳氵一心
愇	忄󰁆口㐄
愈	人一月心
愉	忄人一刂
愊	忄一口田
愋	忄爫一又
愌	忄⺈ㄇ大
愍	󰁂󰀁攵心
愎	忄𠂉曰夂
意	立曰心󰁧
愐	忄丆囗二
愑	忄󰁻用力
愒	忄日勹󰄃
愓	忄日一󰁤
愔	忄立日󰀝
愕	忄口口ㄅ
愖	忄󰀎八󰄃
愗	󰁻乛亅心
愘	忄宀夂口
愙	宀夂口心
愚	曰冂丨心
愛	爫冖心夂
愜	忄匚大人
愝	忄匚曰女
愞	忄丆冂大
感	戊一口心
愠	忄曰皿󰀝
愡	忄勹󰁤心
愢	忄田心󰁶
愣	忄罒方󰁥
愤	忄十艹贝
愥	忄艹ㄇ大
愦	忄口丨贝
愧	忄白󰁜厶
愨	士冖一心
愩	忄工貝󰁶
愪	忄口貝󰁶
愫	忄幺小
愬	䒑凵丿心
愭	忄土丿日
愮	忄爫𠂉凵
愯	忄亻󰁷又
愰	忄曰⺌儿
愱	忄疒𠂉大
愲	忄󰀾月󰀝
愳	目目心󰁧
愴	忄人丶口
愵	忄弓冫冫
愶	忄力力月
愷	忄山一䒑
愸	木人人心
愹	忄宀八口
愺	忄艹早󰀢
愻	孑丿幺心
愼	忄匕目八
愽	忄甫寸󰁶
愾	忄气米󰁶
愿	厂白小心
慀	忄爫幺大
慁	囗一󰀓心
慂	氵󰁻用心
慃	忄八厶羽
慄	忄覀木󰁶
慅	忄又丶虫
慆	忄爫臼󰀝
慇	⺁彐𠃌心
慈	䒑幺幺心
慉	忄亠幺田
慊	忄䒑󰁬八
態	厶月匕心
慌	忄艹亠󰀸
慍	忄囗人皿
慎	忄十󰀣八
慏	忄冖曰六
慐	工貝心󰁧
慑	忄耳又又
慒	忄一ㄇ日
慓	忄覀二小
慔	忄艹曰大
慕	艹曰大⺗
慖	忄囗戈󰀞
慗	木口攵心
慘	忄厶厶彡
慙	車斤心󰁧
慚	忄車斤󰀢
慛	忄山亻󰁷
慜	𠂉母攵心
慝	匚艹心
慞	忄立早󰀢
慟	忄丿一力
慠	忄󰁡攵
慡	忄大乂乂
慢	忄曰罒又
慣	忄毌貝󰁶
慤	士冖几心
慥	忄丿土辶
慦	一氺丶心
慧	三丨三心
慨	忄󰁮󰀄󰁜
慩	忄車辶󰁶
慪	忄匚口口
慫	彳人人心
慬	忄廿口
慭	一丷木心
慮	虍田心󰀦
慯	忄𠂉曰󰁤
慰	尸二小心
慱	忄一曰寸
慲	忄廿冂丶
慳	忄匚丨土
慴	忄羽白󰀝
慵	忄广󰁬丨
慶	󰁙乛心夂
慷	忄广󰁬氺
慸	廿儿冖心
慹	土䒑十心
慺	忄󰀻女󰀝
慻	忄丷夫目
慼	戊上小心
慽	忄戊上小
慾	八人口心
慿	冫󰀋廾心
憀	忄羽人彡
憁	忄丿囗心
憂	丆󰀐冖夂
憃	三人臼心
憄	彳十󰀣心
憅	丿一曰心
憆	忄⺌冖土
憇	丿古甘心
憈	忄虍业󰀝
憉	忄士口彡
憊	亻󰁺丿心
憋	㡀攵心󰁧
憌	釒勹冫心
憍	忄丿大口
憎	忄丷󰀺曰
憏	忄󰁯二小
憐	忄米夕㐄
憑	冫󰀋灬心
憒	忄口丨貝
憓	忄一曰心
憔	忄亻󰁷灬
憕	忄癶一䒑
憖	木人人心
憗	木人人心
憘	忄士口口
憙	士口䒑心
憚	忄口口十
憛	忄覀早󰀢
憜	忄阝月
憝	󰁸孑攵心
憞	忄󰁸孑攵
憟	忄覀米󰁶
憠	厂䒑凵心
憡	忄⺮木冂
憢	忄土土儿
憣	忄丿米田
憤	忄十艹貝
憥	火火冖心
憦	忄火火力
憧	忄立曰土
憨	乛耳攵心
憩	丿古丿心
憪	忄門月󰀝
憫	忄門文󰁶
憬	忄曰󰁸小
憭	忄大丷小
憮	忄𠂉一灬
憯	忄󰀄󰁜日
憰	忄󰁻乛口
憱	忄󰁸小丶
憲	宀三丨心
憳	忄彐工寸
憴	忄黽󰀝
憵	尸口辛心
憶	忄立日心
憷	忄木木󰁾
憸	忄人一人
憹	忄ㄇ󰁺󰀖
憺	忄⺈厂言
憻	忄亠囗一
憼	艹勹口心
憽	忄艹勹心
憾	忄戊一心
憿	忄白方攵
懀	忄人一日
懁	忄罒一󰀔
懂	忄艹丿土
懃	廿口心
懄	忄廿口力
懅	忄虍一󰀓
懆	忄口口木
懇	豸艮心󰁧
懈	忄⺈用󰀟
應	广亻亻心
懊	忄丿ㄇ大
懋	木󰁻乛心
懌	忄罒土十
懍	忄亠囗禾
懎	忄土人口
懏	忄亻󰁷𠃌
懐	忄亠罒󰀔
懑	氵艹一心
懒	忄木口贝
懓	忄爫冖夂
懔	忄亠囗小
懕	厂曰月心
懖	釒丿古心
懗	忄土󰁖󰁖
懘	氵廿儿心
懙	忄󰀗一八
懚	忄爫工心
懛	忄士口土
懜	忄艹罒夕
懝	忄匕𠂉󰁾
懞	忄艹冖󰀓
懟	业丷王心
懠	忄󰀴󰀳󰀝
懡	忄广木厶
懢	忄匚丨皿
懣	氵廿冂心
懤	忄士乛寸
懥	忄十冖󰁾
懦	忄󰀙丆〢
懧	忄宀心丁
懨	忄厂日犬
懩	忄䒑夫艮
懪	忄曰󰁺氺
懫	忄斤斤貝
懬	广󰁺由心
懭	忄广󰁺八
懮	忄丆󰀐夂
懯	甫方攵心
懰	忄󰁚丶刂
懱	忄艹罒人
懲	彳山一心
懳	忄三丨心
懴	忄十戈󰀞
懵	忄艹罒目
懶	忄木口貝
懷	忄亠罒󰀔
懸	󰀣小丿心
懹	忄亠口󰀔
懺	忄人人󰀞
懻	忄丬匕八
懼	忄目目󰁷
懽	忄艹口󰁷
懾	忄耳耳耳
懿	士冖一心
戀	言糹糹心
戁	廿口夫心
戂	忄广木三
戃	忄⺌冖灬
戄	忄目目又
戅	立早工心
戆	立早夂心
戇	立早夂心
戈	戈一󰁒丶
戉	戈󰁐󰁫
戊	戊一丿丶
戋	一戈󰀦
戌	戊一󰀌
戍	戈人󰀦
戎	戈󰀏
戏	又戈󰁶
成	戊𠃌󰁫
我	丿扌󰁒丶
戒	戈廾󰀵
戓	戈口󰀌
戔	戈戈󰁧
戕	爿戈󰁶
或	戈口󰀞󰀌
戗	人⺋戈󰁶
战	󰀥口戈󰁶
戙	冂一口戈
戚	戊上小󰀦
戛	丆目戈󰁧
戜	戈口王󰀌
戝	貝戈󰁶
戞	丆󰀐冖戈
戟	十早戈󰁶
戠	亠丷戈日
戡	󰀎八󰄃戈
戢	口耳󰁒丶
戣	癶一大戈
戤	乃又皿戈
戥	日丿戈
戦	󰀧曰十戈
戧	人丶彐戈
戨	丁口丁戈
戩	一厶厶戈
截	十戈亻󰁷
戫	月戈󰀞
戬	一业日戈
戭	宀一由戈
戮	羽人彡戈
戯	虍业戈󰁶
戰	口口曰戈
戱	虍〢󰄃戈
戲	虍一口戈
戳	羽亻󰁷戈
戴	十戈田八
戵	目目亻戈
戶	丿尸󰀏
户	丶尸󰀏
戸	一尸󰁣
戹	丶尸乙󰁫
戺	丶尸巳󰁀
戻	丶尸大󰀦
戼	乛匚一󰁃
戽	丶尸󰁦十
戾	丶尸犬󰀦
房	丶尸方󰀏
所	⺁󰁃斤󰀢
扁	丶尸冂艹
扂	丶尸󰀥口
扃	丶尸冂口
扄	丶尸丿口
扅	丶尸夕夕
扆	丶尸亠󰀔
扇	丶尸羽󰀌
扈	丶尸口巴
扉	丶尸丨三
扊	丶尸火火
手	手丿一亅
扌	扌一亅󰀞
才	󰀛丿󰀏
扎	扌乚󰁀
扏	扌九󰁀
扐	扌力󰁥
扑	扌卜󰁶
扒	扌八󰁶
打	扌丁󰀢
扔	扌乃󰁥
払	扌厶󰁶
扖	扌丿󰂃󰁶
扗	扌土󰀝
托	扌丿七󰁀
扙	扌󰂃󰁶
扚	扌勹丶󰁶
扛	扌工󰀝
扜	扌一󰀛󰀢
扝	扌二ㄅ󰁀
扞	扌干󰀢
扟	扌⺄十󰀢
扠	扌又丶󰁶
扡	扌也󰁀
扢	扌𠂉乙󰁀
扣	扌口󰀝
扤	扌一儿󰁀
扥	扌丿七󰁀
扦	扌丿十󰀢
执	扌九丶󰁶
扨	扌刀丶󰁶
扩	扌广󰁥
扪	扌门󰁀
扫	扌彐󰀝
扬	扌ㄋ󰁤󰁥
扭	扌󰁈丨一
扮	扌八刀󰁥
扯	扌止󰀝
扰	扌乚丶
扱	扌乃󰂃󰁶
扲	扌人丶乛
扳	扌⺁又󰁶
扴	扌人󰀯󰀢
扵	扌人󰁦󰁶
扶	扌夫󰁶
扷	扌丿大󰁶
扸	扌丿丨󰁈
批	扌󰁴匕󰁀
扺	扌󰁚󰀁󰁀
扻	扌⺈人󰁶
扼	扌厂⺋󰁀
扽	扌一凵乚
找	扌戈󰁶
承	了三󰀩󰀦
技	扌十又󰁶
抁	扌厶儿󰁀
抂	扌王󰀝
抃	扌亠卜󰁶
抄	扌小丿󰁥
抅	扌勹厶󰁶
抆	扌文󰁶
抇	扌日󰀝
抈	扌月󰀝
抉	扌ユ人󰁶
把	扌巴󰁀
抋	扌心󰁶
抌	扌冖󰁜󰁀
抍	扌丿廾󰀢
抎	扌二厶󰁶
抏	扌二儿󰁀
抐	扌冂人󰁶
抑	扌󰁚卩󰀢
抒	扌󰁻乛亅
抓	扌⺁丨󰂃
抔	扌丆卜󰁶
投	扌几又󰁶
抖	扌󰁦十󰀢
抗	扌亠几󰁀
折	扌斤󰀢
抙	扌手󰀢
抚	扌二󰁜󰁀
抛	扌九力󰁥
抜	扌又󰁶
抝	扌幺𠃌󰁀
択	扌尸󰂃󰁶
抟	扌二󰁓丶
抠	扌匚乂󰁶
抡	扌人匕󰁀
抢	扌人⺋󰁀
抣	扌勹冫󰀝
护	扌丶尸󰁥
报	扌卩又󰁶
抦	扌一冂人
抧	扌口八󰁶
抨	扌一丷十
抩	扌冂土󰀝
抪	扌冂丨
披	扌皮󰁶
抬	扌厶口󰀝
抭	扌宀几󰁀
抮	扌人彡󰁥
抯	扌󰀐一󰀝
抰	扌ㄇ大󰁶
抱	扌勹巳󰁀
抲	扌丁口󰀝
抳	扌尸匕󰁀
抴	扌廿󰄃󰁀
抵	扌󰁚󰀁丶
抶	扌丿夫󰁶
抷	扌丆卜一
抸	扌丿之󰁶
抹	扌一木󰁶
抺	扌未󰁶
抻	扌曰丨󰀢
押	扌甲󰀢
抽	扌由󰀝
抾	扌土厶󰁶
抿	扌󰁂󰀁󰁀
拀	扌口儿󰁀
拁	扌力口󰀝
拂	扌弓󰀯󰀢
拃	扌𠂉丨二
拄	扌丶王󰀝
担	扌曰一󰀝
拆	扌斤丶󰁶
拇	扌母󰁶
拈	扌󰀥口󰀝
拉	扌立󰀝
拊	扌亻寸󰁶
拋	扌乚力
拌	扌丷󰀟󰀢
拍	扌白󰀝
拎	扌人丶󰁻
拏	女又手󰀬
拐	扌口力󰁥
拑	扌甘󰀝
拒	扌匚󰁃󰀝
拓	扌石󰀝
拔	扌又丶
拕	扌宀匕󰁀
拖	扌𠂉也󰁀
拗	扌幺力󰁥
拘	扌勹口󰀝
拙	扌凵山󰀢
拚	扌厶廾󰀢
招	扌刀口󰀝
拜	三十󰀢
拝	扌三十󰀢
拞	扌丘󰀝
拟	扌󰁐丶人
拠	扌夂几󰁀
拡	扌广厶󰁶
拢	扌ヒ丶
拣	扌󰀂𠃌八
拤	扌上卜󰁶
拥	扌用󰀢
拦	扌丷三󰀝
拧	扌宀丁󰀢
拨	扌ㄥ丿丶
择	扌又󰀟󰀢
拪	扌西󰀝
拫	扌艮󰁶
括	扌丿古󰀝
拭	扌󰀁工丶
拮	扌士口󰀝
拯	扌了󰀩一
拰	扌亻丿士
拱	扌󰁺八󰁶
拲	󰁺八手󰀬
拳	丷夫手󰀬
拴	扌人王󰀝
拵	扌丨子
拶	扌巛夕󰁶
拷	扌土丿ㄅ
拸	扌夕夕󰁶
拹	扌力力力
拺	扌木冂󰁀
拻	扌火󰁶
拼	扌䒑廾󰀢
拽	扌曰󰁒丿
拾	扌人一口
拿	人一口手
挀	扌⺁󰀕󰁶
持	扌土寸󰁶
挂	扌土土󰀝
挃	扌一厶土
挄	扌⺌一儿
挅	扌乃木󰁶
挆	扌几木󰁶
指	扌匕日󰀝
挈	三丨刀手
按	扌宀女󰀝
挊	扌上一卜
挋	扌匚丨丨
挌	扌夂口󰀝
挍	扌六乂󰁶
挎	扌大二ㄅ
挏	扌冂一口
挐	女口手󰀬
挑	扌儿󰀪󰁶
挒	扌一夕刂
挓	扌宀丿七
挔	扌亠󰀔󰁶
挕	扌耳󰀝
挖	扌宀八乙
挗	扌一弓人
挘	扌小丿力
挙	󰀧一八手
挚	扌九丶手
挛	亠󰁗手󰀬
挜	扌一业󰀝
挝	扌寸辶󰁶
挞	扌大辶󰁶
挟	扌一丷大
挠	扌󰀁丿儿
挡	扌⺌彐󰀝
挢	扌丿大󰀯
挣	扌⺈󰁬亅
挤	扌文󰀯󰀢
挥	扌冖车󰀢
挦	扌彐寸󰁶
挧	扌羽󰀝
挨	扌厶𠂉大
挩	扌八口儿
挪	扌𠃌󰀠阝
挫	扌人人土
挬	扌十冖子
挭	扌一曰乂
挮	扌丷弓丿
振	扌厂二󰀖
挰	扌口王󰀝
挱	扌氵小丿
挲	氵小丿手
挳	扌一巛工
挴	扌𠂉母󰁶
挵	扌王廾󰀢
挶	扌尸𠃌口
挷	扌三丿阝
挸	扌目儿󰁀
挹	扌口巴󰁀
挺	扌丿士廴
挻	扌丿󰀥廴
挼	扌爫女󰀝
挽	扌⺈口󰁜
挾	扌大人人
挿	扌丿一丨
捀	扌夂三丨
捁	扌丿土口
捂	扌五口󰀝
捃	扌󰁬丿口
捄	扌一氺丶
捅	扌󰁻用󰀢
捆	扌囗木󰁶
捇	扌土󰁖󰁶
捈	扌人一朩
捉	扌口󰁾󰁶
捊	扌爫子󰀝
捋	扌爫寸󰁶
捌	扌口力刂
捍	扌曰干󰀢
捎	扌⺌月󰀝
捏	扌曰土󰀝
捐	扌口月󰀝
捑	扌日󰁕󰂃
捒	扌木口󰀝
捓	扌󰀄亅阝
捔	扌⺈用󰀢
捕	扌甫󰁶
捖	扌宀二儿
捗	扌止󰀤󰁥
捘	扌厶八夂
捙	扌車󰀢
捚	扌曰土󰀝
捛	扌口口󰀝
捜	扌曰丨又
捝	扌丷口儿
捞	扌艹冖力
损	扌口贝󰁶
捠	扌丘八󰁶
捡	扌人一一
换	扌⺈ㄇ大
捣	扌󰁠山󰀢
捤	扌尸毛󰁀
捥	扌宀夕⺋
捦	扌金󰀝
捧	扌三人󰀟
捨	扌人干口
捩	扌丶尸犬
捪	扌󰁚󰀁日
捫	扌門󰀝
捬	扌广亻寸
捭	扌白丿十
据	扌尸古󰀝
捯	扌一厶刂
捰	扌曰木󰁶
捱	扌厂土土
捲	扌丷夫⺋
捳	扌丘山󰀢
捴	扌八厶心
捵	扌ㄇ󰁺八
捶	扌丿士󰁺
捷	扌一󰁬󰁾
捸	扌󰁬氺󰁶
捹	扌大十廾
捺	扌大二小
捻	扌人丶心
捼	扌禾女󰀝
捽	扌亠人十
捾	扌宀󰃧󰀝
捿	扌一󰁬女
掀	扌斤⺈人
掁	扌󰀍󰀖󰁶
掂	扌广󰀥口
掃	扌彐冖丨
掄	扌人一艹
掅	扌月󰀝
掆	扌冂䒑山
掇	扌又又又
授	扌爫冖又
掉	扌󰀥早󰀢
掊	扌立口󰀝
掋	扌广󰁚丶
掌	⺌冖口手
掍	扌曰󰁴匕
掎	扌大丁口
掏	扌勹𠂉凵
掐	扌⺈臼󰀝
掑	扌󰀎八󰁶
排	扌丨三三
掓	扌上小又
掔	匚丨󰁃手
掕	扌土八夂
掖	扌亠亻丶
掗	扌一󰀚一
掘	扌尸凵山
掙	扌爫󰁬亅
掚	扌一冂丶
掛	扌土土卜
掜	扌臼儿󰁀
掝	扌戈口󰀞
掞	扌火火󰁶
掟	扌宀一󰁾
掠	扌󰁸小󰁶
採	扌爫木󰁶
探	扌冖八木
掣	𠂉一冂手
掤	扌月月󰀝
接	扌立女󰀝
掦	扌日勹󰁤
控	扌宀八工
推	扌亻󰁷󰀝
掩	扌大曰乚
措	扌󰁺曰󰀝
掫	扌耳又󰁶
掬	扌勹米󰁶
掭	扌一大⺗
掮	扌丶尸月
掯	扌止月󰀝
掰	八刀手
掱	手手手󰀬
掲	扌曰勹匕
掳	扌虍力󰁥
掴	扌囗王丶
掵	扌人一卩
掶	扌广󰁬人
掷	扌䒑大阝
掸	扌丷曰十
掹	扌子皿󰀝
掺	扌厶大彡
掻	扌又虫󰁶
掼	扌毌贝󰁶
掽	扌䒑业󰀝
掾	扌彑󰀓󰁶
掿	扌艹口
揀	扌木󰀹󰀝
揁	扌󰀥貝󰁶
揂	扌丷西一
揃	扌䒑月刂
揄	扌人一刂
揅	石一廾手
揆	扌癶一大
揇	扌十冂十
揈	扌勹言󰀝
揉	扌󰁻乛木
揊	扌一口田
揋	扌田一󰀖
揌	扌田心󰁶
揍	扌三人大
揎	扌宀一一
描	扌艹田󰀝
提	扌日一󰁾
揑	扌臼工󰀝
插	扌丿十臼
揓	扌方𠂉也
揔	扌勹󰁤心
揕	扌󰀎八󰄃
揖	扌口耳󰀝
揗	扌⺁十目
揘	扌白王󰀝
揙	扌丶尸艹
揚	扌曰一󰁤
換	扌⺈ㄇ大
揜	扌人一廾
揝	扌夂卜日
揞	扌立曰󰀝
揟	扌乛󰁾月
揠	扌匚曰女
握	扌尸一土
揢	扌宀夂口
揣	扌山丆〢
揤	扌󰁮卩󰀢
揥	扌亠丷丨
揦	扌木口刂
揧	木口刂手
揨	扌󰁸冖丁
揩	扌󰁴匕白
揪	扌禾火󰁶
揫	禾火手󰀬
揬	扌宀八犬
揭	扌曰勹󰄃
揮	扌冖車󰀢
揯	扌忄一一
揰	扌丿一土
揱	⺌月刂手
揲	扌廿󰄃木
揳	扌三丨大
援	扌爫一又
揵	扌󰁬󰀟廴
揶	扌耳阝󰀢
揷	扌丿一丨
揸	扌木曰一
揹	扌丬匕月
揺	扌爫干凵
揻	扌戊一女
揼	扌石水󰁶
揽	扌〢𠂉󰁜
揾	扌曰皿󰀝
揿	扌钅⺈人
搀	扌⺈口󰁦
搁	扌门夂口
搂	扌米女󰀝
搃	扌丷口心
搄	扌忄一一
搅	扌󰀧冖󰁜
搆	扌󰀀冂土
搇	扌人丶󰀔
搈	扌宀八口
搉	扌冖亻󰁷
搊	扌勹凵丿
搋	扌⺁虍几
搌	扌尸󰁺󰀖
損	扌口貝󰁶
搎	扌孑丿小
搏	扌甫寸󰁶
搐	扌亠幺田
搑	扌艹耳󰀝
搒	扌亠丷方
搓	扌⺶工󰀝
搔	扌又丶虫
搕	扌土厶皿
搖	扌󰁝𠂉凵
搗	扌󰁟山󰀢
搘	扌土丿日
搙	扌厂二寸
搚	扌力力月
搛	扌䒑󰁬八
搜	扌臼丨又
搝	扌丿目犬
搞	扌󰁸冂口
搟	扌車干󰀢
搠	扌䒑凵月
搡	扌又又木
搢	扌一业日
搣	扌戊一火
搤	扌䒑八皿
搥	扌丿󰃧辶
搦	扌弓冫冫
搧	扌丶尸羽
搨	扌曰羽󰀝
搩	扌夕㐄木
搪	扌广󰁬口
搫	丿󰁪几手
搬	扌丿󰁪又
搭	扌艹人口
搮	扌覀木󰁶
搯	扌爫臼󰀝
搰	扌󰀾月󰀝
搱	扌尸辛󰀢
搲	扌宀八󰂃
搳	扌宀三口
搴	宀󰀀八手
搵	扌囗人皿
搶	扌人丶口
搷	扌十󰀣八
搸	扌三人禾
搹	扌一口丨
携	扌亻󰁷乃
搻	人一口手
搼	扌丷夫手
搽	扌艹人朩
搾	扌宀八二
搿	人一手
摀	扌󰁞灬󰁶
摁	扌囗大心
摂	扌耳󰀪󰁶
摃	扌工貝󰁶
摄	扌耳又又
摅	扌虍心󰁶
摆	扌罒土厶
摇	扌爫𠂉凵
摈	扌宀丘八
摉	扌宀八夕
摊	扌又亻󰁷
摋	扌乂朩又
摌	扌立丿
摍	扌宀亻日
摎	扌羽人彡
摏	扌三人臼
摐	扌彳人󰁾
摑	扌囗戈󰀞
摒	扌尸䒑廾
摓	扌夂三辶
摔	扌亠幺十
摕	扌廿儿丨
摖	扌󰁯二小
摗	扌木口人
摘	扌亠丷古
摙	扌車辶󰁶
摚	扌⺌冖土
摛	扌亠乂厶
摜	扌毌貝󰁶
摝	扌󰁙󰁴匕
摞	扌田幺小
摟	扌󰀻女󰀝
摠	扌丿囗心
摡	扌󰁮󰀄󰁜
摢	扌虍丿󰀛
摣	扌虍󰀐一
摤	扌大乂乂
摥	扌𠂉曰󰁤
摦	扌大二󰂃
摧	扌山亻󰁷
摨	扌尸氺󰀟
摩	广木木手
摪	扌爿󰁝寸
摫	扌夫目儿
摬	扌立曰儿
摭	扌广廿灬
摮	󰁡攵手
摯	土䒑十手
摰	土八土手
摱	扌曰罒又
摲	扌車斤󰀢
摳	扌匚口口
摴	扌󰀙二ㄅ
摵	扌戊上小
摶	扌一曰寸
摷	扌巛曰木
摸	扌艹曰大
摹	艹曰大手
摺	扌羽白󰀝
摻	扌厶厶彡
摼	扌匚丨土
摽	扌覀二小
摾	扌弓口虫
摿	扌人立日
撀	士󰁅几手
撁	扌亠幺󰀟
撂	扌田夂口
撃	車几又手
撄	扌贝贝女
撅	扌厂䒑人
撆	㡀攵手󰀬
撇	扌㡀攵󰁶
撈	扌火火力
撉	󰁸孑攵手
撊	扌門月󰀝
撋	扌門王󰀝
撌	扌口丨貝
撍	扌󰀄󰁜日
撎	扌士冖䒑
撏	扌彐工寸
撐	扌⺌冖丿
撑	扌⺌冖手
撒	扌󰁺月攵
撓	扌土土儿
撔	扌曰󰁸小
撕	扌󰀎八斤
撖	扌乛耳攵
撗	扌󰁺由八
撘	扌⺮人口
撙	扌丷西寸
撚	扌󰁝犬灬
撛	扌米夕㐄
撜	扌癶一䒑
撝	扌爫丿灬
撞	扌立曰土
撟	扌丿大口
撠	扌十早戈
撡	扌厶厶⺗
撢	扌覀早󰀢
撣	扌口口十
撤	扌亠厶攵
撥	扌癶弓又
撦	扌大土日
撧	扌糹⺈巴
撨	扌亻󰁷灬
撩	扌大丷小
撪	扌厶大車
撫	扌𠂉一灬
撬	扌毛毛毛
播	扌丿米田
撮	扌曰耳又
撯	扌⺶目󰀝
撰	扌巳巳八
撱	扌阝月
撲	扌业䒑夫
撳	扌釒⺈人
撴	扌󰁸孑攵
撵	扌夫夫车
撶	扌艹一󰀟
撷	扌士口贝
撸	扌󰁢一日
撹	扌󰀧冖儿
撺	扌宀八丨
撻	扌土羊辶
撼	扌戊一心
撽	扌白方攵
撾	扌ㄇ󰁈辶
撿	扌人一人
擀	扌十早干
擁	扌亠󰁲󰁷
擂	扌󰀙田󰀝
擃	扌ㄇ󰁺󰀖
擄	扌虍田力
擅	扌亠囗一
擆	扌艹土日
擇	扌罒土十
擈	扌业䒑未
擉	扌罒勹虫
擊	車凵几手
擋	扌⺌冖田
擌	扌⺮大人
操	扌口口木
擎	艹勹口手
擏	扌艹勹攵
擐	扌罒一󰀔
擑	扌口耳丶
擒	扌人亠厶
擓	扌匚氵󰁷
擔	扌⺈厂言
擕	扌亻󰁷𠃌
擖	扌艹日󰄃
擗	扌尸口辛
擘	尸口辛手
擙	扌丿ㄇ大
據	扌虍一󰀓
擛	扌艹廿木
擜	扌十冂犬
擝	扌日月皿
擞	扌米女攵
擟	扌一八乂
擠	扌󰀴󰀳󰀝
擡	扌士口土
擢	扌羽亻󰁷
擣	扌士乛寸
擤	扌丿目󰀯
擥	匚丨󰁃手
擦	扌宀󰁯小
擧	󰀗一󰁕手
擨	扌⺁虍人
擩	扌󰀙丆〢
擪	厂曰月手
擫	扌厂日犬
擬	扌匕𠂉󰁾
擭	扌艹亻又
擮	扌十戈󰁷
擯	扌宀一貝
擰	扌宀心丁
擱	扌門夂口
擲	扌丷西阝
擳	扌⺮󰁮卩
擴	扌广󰁺八
擵	扌广木手
擶	扌⺮䒑刂
擷	扌士口貝
擸	扌巛囗󰁒
擹	扌廿口人
擺	扌罒厶匕
擻	扌󰀻女攵
擼	扌󰁢灬日
擽	扌白幺木
擾	扌丆󰀐夂
擿	扌亠丷辶
攀	木乂乂手
攁	扌䒑夫艮
攂	扌田田田
攃	扌艹󰁯小
攄	扌虍田心
攅	扌夫夫貝
攆	扌夫夫車
攇	扌宀三心
攈	扌󰁙󰁴禾
攉	扌󰀙亻󰁷
攊	扌厂禾止
攋	扌木口貝
攌	扌囗罒󰀔
攍	扌󰄹月丶
攎	扌虍田皿
攏	扌立月三
攐	扌宀󰀀󰀔
攑	扌󰀗一󰀟
攒	扌丿土贝
攓	扌宀󰀀󰁾
攔	扌門木󰀹
攕	扌人人󰀞
攖	扌貝貝女
攗	扌󰁙󰁴米
攘	扌亠口󰀔
攙	扌⺈口丶
攚	扌火火口
攛	扌宀八󰁒
攜	扌山亻口
攝	扌耳耳耳
攞	扌罒糹󰁷
攟	扌󰁙󰁴禾
攠	扌广木三
攡	扌亠乂󰁷
攢	扌丿土貝
攣	言糹糹手
攤	扌廿口󰁷
攥	扌⺮目小
攦	扌一ㄇ匕
攧	扌十󰀣貝
攨	扌宀八󰂃
攩	扌⺌冖灬
攪	扌󰀗乂儿
攫	扌目目又
攬	扌匚丨儿
攭	扌彑󰀓虫
攮	扌一口󰀔
支	十又󰁧
攰	十又力󰀏
攱	立十又󰁶
攲	大丁口又
攳	十又彐寸
攴	󰀥又󰁧
攵	攵丿一󰂃
收	󰁐丨攵󰁶
攷	一ㄅ攵󰁶
攸	亻丨攵󰁶
改	󰁁攵󰁶
攺	󰁂攵󰁶
攻	工攵󰁶
攼	干攵󰁶
攽	八刀攵󰁶
放	方攵󰁶
政	一止攵󰁶
敀	白攵󰁶
敁	󰀥口󰀥又
敂	勹口攵󰁶
敃	󰁂󰀁攵󰁶
敄	󰁻乛亅丿
故	古攵󰁶
敆	人一口又
敇	木冂攵󰁶
效	六乂攵󰁶
敉	米攵󰁶
敊	上小󰀥又
敋	夂口攵󰁶
敌	丿古攵󰁶
敍	人一朩又
敎	乂孑攵
敏	𠂉母攵󰁶
敐	厂二󰀖攵
救	一氺丶攵
敒	亻曰丨攵
敓	八口儿攵
敔	五口攵󰁶
敕	木口攵󰁶
敖	󰁡攵󰁶
敗	貝攵󰁶
敘	人一朩攵
教	土丿孑攵
敚	丷口儿攵
敛	人一󰀧攵
敜	人丶乛攵
敝	㡀攵󰁶
敞	⺌冂口攵
敟	ㄇ󰁺八攵
敠	又又又又
敡	日勹󰁤又
敢	乛耳攵󰁶
散	󰁺月攵󰁶
敤	曰木󰀥又
敥	火火󰀥又
敦	󰁸孑攵󰁶
敧	大丁口又
敨	立口攵󰁶
敩	󰀧冖孑攵
敪	又又又攵
敫	白方攵󰁶
敬	艹勹口攵
敭	日一勹攵
敮	丿十臼又
敯	󰁂󰀁日又
数	米女攵󰁶
敱	山一口又
敲	󰁸冂口又
敳	山一口攵
整	木口攵止
敵	亠丷冂攵
敶	阝木曰攵
敷	甫方攵󰁶
數	󰀻女攵󰁶
敹	󰀥冖丿攵
敺	匚口口又
敻	⺈ㄇ人攵
敼	士口䒑又
敽	丿大口又
敾	羊䒑口攵
敿	丿大口攵
斀	罒勹虫又
斁	罒土䒑攵
斂	人一口攵
斃	㡀攵一匕
斄	未攵厂人
斅	󰀗乂乂又
斆	󰀗乂乂攵
文	文丶一󰂃
斈	文子󰀘
斉	文󰀳󰀘
斊	文耳󰀘
斋	文丆冂〢
斌	文一󰀁丶
斍	文目儿󰀅
斎	文󰀳小󰁧
斏	文丶艮󰁶
斐	丨三丨文
斑	王文王󰀝
斒	文丶尸艹
斓	文门木󰀹
斔	文虫臼人
斕	文門木󰀹
斖	文󰀗ㄇ一
斗	󰁦十󰀵
斘	夕󰁦十󰀢
料	米󰁦十󰀢
斚	厶厶冖十
斛	⺈用󰁦十
斜	人一朩十
斝	口口冖十
斞	臼人󰁦十
斟	󰀎八󰄃十
斠	󰀀冂土十
斡	十早人十
斢	󰁺由八十
斣	罒勹虫十
斤	斤丿丿丨
斥	斤丶󰀦
斦	斤斤󰀢
斧	八乂斤󰀬
斨	爿斤󰀢
斩	车斤󰀢
斪	勹口斤󰀢
斫	石斤󰀢
斬	車斤󰀢
断	米󰄃斤󰀢
斮	󰁺日斤󰀢
斯	󰀎八斤󰀢
新	立朩斤󰀢
斱	土丿日斤
斲	匚󰁃󰀚斤
斳	廿口斤
斴	米夕㐄斤
斵	󰁚丶刀斤
斶	斤罒勹虫
斷	幺幺一斤
斸	尸氺罒斤
方	方丶一丿
斺	方人󰀯󰀢
斻	方𠂉几󰁀
於	方人󰁦󰁶
施	方𠂉也󰁀
斾	方𠂉冂丨
斿	方𠂉子󰀝
旀	方厶小󰁶
旁	亠丷冖方
旂	方𠂉斤󰀢
旃	方𠂉󰀼亠
旄	方𠂉毛󰁀
旅	方𠂉󰀕󰁶
旆	方𠂉一丨
旇	方𠂉皮󰁶
旈	方亠厶󰀸
旉	甫方󰁣
旊	方𠂉一丶
旋	方𠂉乛󰁾
旌	方𠂉丿
旍	方𠂉人󰁻
旎	方𠂉尸匕
族	方𠂉𠂉大
旐	方𠂉儿󰀪
旑	方大丁口
旒	方𠂉亠󰀸
旓	方𠂉⺌月
旔	方󰁬󰀟廴
旕	方人󰁦匕
旖	方𠂉大口
旗	方𠂉󰀎八
旘	方亠丷日
旙	方丿米田
旚	方𠂉覀小
旛	方𠂉丿田
旜	方𠂉亠一
旝	方𠂉人日
旞	方𠂉䒑辶
旟	方𠂉󰀗八
无	二󰁜󰁫
旡	󰀄󰁜󰁫
既	󰁮󰀄󰁜󰁀
旣	白匕󰀄󰁜
旤	冂󰁈冂󰁜
日	日日日日
旦	曰一󰀘
旧	丨日󰀝
旨	匕曰󰀘
早	早丨󰁈丨
旪	日十󰀢
旫	日刀󰁥
旬	勹日󰀌
旭	九日󰀌
旮	九曰󰀘
旯	曰九󰀅
旰	日干󰀢
旱	曰干󰀬
旲	曰大󰁧
旳	日勹丶󰁶
旴	日一󰀛󰀢
旵	曰山󰀬
时	日寸󰁶
旷	日广󰁥
旸	日ㄋ󰁤󰁥
旹	凵丨一曰
旺	日王󰀝
旻	曰文󰁧
旼	日文󰁶
旽	日一凵乚
旾	一凵乚日
旿	日𠂉十󰀢
昀	日勹冫󰀝
昁	日一冂丨
昂	曰󰁚卩󰀬
昃	曰厂人󰁧
昄	日⺁又󰁶
昅	日乃󰂃󰁶
昆	曰󰁴匕󰀅
昇	曰丿廾󰀬
昈	日丶尸󰁥
昉	日方󰁥
昊	曰一大󰁧
昋	一大日󰀘
昌	曰曰󰀘
昍	日日󰀝
明	日月󰀝
昏	󰁚󰀁日󰀘
昐	日八刀󰁥
昑	日人丶乛
昒	日勹󰁤󰁥
易	曰勹󰁤󰁣
昔	󰁺曰󰀘
昕	日斤󰀢
昖	日八厶󰁶
昗	曰六󰁧
昘	曰方󰁣
昙	曰二厶󰁧
昚	大丷日󰀘
昛	日匚󰁃󰀝
昜	曰一勹󰁤
昝	夂卜曰󰀘
昞	日一冂人
星	曰丿󰀘
映	日ㄇ大󰁶
昡	日亠幺󰁶
昢	日凵山󰀢
昣	日人彡󰁥
昤	日人丶󰁻
春	三人曰󰀘
昦	曰大󰀯󰀬
昧	日未󰁶
昨	日𠂉丨二
昩	日一木󰁶
昪	曰厶廾󰀬
昫	日勹口󰀝
昬	󰁂󰀁日󰀘
昭	日刀口󰀝
昮	曰工力󰁣
是	曰一󰁾󰁧
昰	曰一止󰀘
昱	曰立󰀘
昲	日弓󰀯󰀢
昳	日丿夫󰁶
昴	曰󰁚丿卩
昵	日尸匕󰁀
昶	丶𠃌󰀩日
昷	曰皿󰀘
昸	日夂󰁦󰁶
昹	日丶𠃌󰀩
昺	曰一冂人
昻	曰工卩󰀬
昼	尸󰂃曰一
昽	日ヒ丶
显	曰业󰀘
昿	日广厶󰁶
晀	日儿󰀪󰁶
晁	曰儿󰀪󰁧
時	日土寸󰁶
晃	曰⺌一儿
晄	曰⺌一儿
晅	日一曰一
晆	日土土󰀝
晇	日大二ㄅ
晈	日六乂󰁶
晉	一厶厶日
晊	日一厶土
晋	一业曰󰀘
晌	日丿冂口
晍	日冂一口
晎	日󰁺八󰁶
晏	曰宀女󰀘
晐	日亠ㄥ人
晑	曰丿冂口
晒	日西󰀝
晓	日󰀁丿儿
晔	日亻ヒ十
晕	曰冖车󰀬
晖	日冖车󰀢
晗	日人丶口
晘	日曰干󰀢
晙	日厶八夂
晚	日⺈口󰁜
晛	日目儿󰁀
晜	曰丷弓丿
晝	󰁬土曰一
晞	日乂丨
晟	曰戊𠃌󰀅
晠	日戊𠃌󰁀
晡	日甫󰁶
晢	扌斤曰󰀘
晣	日扌斤󰀢
晤	日五口󰀝
晥	日宀二儿
晦	日𠂉母󰁶
晧	日丿土口
晨	曰厂二󰀖
晩	日⺈󰀱󰁜
晪	日ㄇ󰁺八
晫	日󰀥早󰀢
晬	日亠人十
晭	日󰀼土口
普	䒑业日󰀘
景	曰󰁸小󰁧
晰	日木斤󰀢
晱	日火火󰁶
晲	日臼儿󰁀
晳	木斤日󰀘
晴	日月󰀝
晵	丶尸攵日
晶	日日日󰀘
晷	曰夂卜口
晸	曰一止攵
晹	日曰勹󰁤
智	𠂉大口日
晻	日大曰乚
晼	日宀夕⺋
晽	日木木󰁶
晾	日󰁸小󰁶
晿	日曰曰󰀝
暀	日彳丶王
暁	日十艹儿
暂	车斤曰󰀘
暃	曰丨三三
暄	日宀一一
暅	日忄一一
暆	日方𠂉也
暇	日󰁃丨又
暈	曰冖車󰀬
暉	日冖車󰀢
暊	日丆貝󰁶
暋	󰁂󰀁攵日
暌	日癶一大
暍	日曰勹󰄃
暎	日艹ㄇ大
暏	日土丿日
暐	日󰁆口㐄
暑	曰土丿曰
暒	日曰丿
暓	󰁻乛亅日
暔	日十冂十
暕	日木󰀹󰀝
暖	日爫一又
暗	日立曰󰀝
暘	日曰一󰁤
暙	日三人日
暚	日爫𠂉凵
暛	日⺶工󰀝
暜	立立曰󰀘
暝	日冖曰六
暞	日丿目木
暟	日山一䒑
暠	曰󰁸冂口
暡	日八厶羽
暢	曰丨日󰁤
暣	日气米󰁶
暤	日白大十
暥	日曰宀女
暦	厂木木曰
暧	日爫冖又
暨	󰁮󰀄󰁜一
暩	日󰁯二小
暪	日廿冂󰂃
暫	車斤曰󰀘
暬	土八土日
暭	日白󰀪十
暮	艹曰大日
暯	日艹曰大
暰	日彳人󰁾
暱	日匚艹口
暲	日立早󰀢
暳	日三丨彐
暴	曰󰁺八氺
暵	日廿口夫
暶	日方𠂉󰁾
暷	日一曰寸
暸	日大丷小
暹	曰亻󰁷辶
暺	日口口十
暻	日曰󰁸小
暼	㡀攵曰󰀘
暽	日米夕㐄
暾	日󰁸孑攵
暿	日士口口
曀	日士冖䒑
曁	白匕󰀄一
曂	日󰁺由八
曃	日󰁬氺辶
曄	日艹一󰀟
曅	曰艹一󰀟
曆	厂禾禾曰
曇	曰󰀙二厶
曈	日立曰土
曉	日土土儿
曊	日弓󰀯貝
曋	日覀早󰀢
曌	日月宀工
曍	日丿目十
曎	日罒土十
曏	曰󰁲丿阝
曐	曰曰曰
曑	曰曰曰彡
曒	日白方攵
曓	曰凵山十
曔	日艹勹攵
曕	日⺈厂言
曖	日爫冖夂
曗	日业䒑未
曘	日󰀙丆〢
曙	日罒土曰
曚	日艹冖󰀓
曛	日丿一灬
曜	日羽亻󰁷
曝	日曰󰁺氺
曞	日厂艹丶
曟	日日日󰀖
曠	日广󰁺八
曡	日日日一
曢	日宀大小
曣	日廿口灬
曤	日󰀙亻󰁷
曥	日虍田皿
曦	日丷王丶
曧	曰一口虫
曨	日立月三
曩	曰亠口󰀔
曪	日罒糹󰁷
曫	言糹糹日
曬	日一ㄇ匕
曭	日⺌冖灬
曮	日口口攵
曯	日尸氺虫
曰	曰丨󰁈一
曱	ㄇ干󰀵
曲	ㄇ󰁺󰀌
曳	曰󰁒丿󰀏
更	一曰乂󰀦
曵	曰󰁒丿丶
曶	勹󰁤日󰀘
曷	曰勹人󰄃
書	󰁬土曰󰀘
曹	一ㄇ󰁺曰
曺	一由曰󰀘
曻	曰夕㐄󰀬
曼	曰罒又󰁧
曽	丷田日󰀘
曾	丷󰀺曰󰀘
替	夫夫日󰀘
最	曰耳又󰁧
朁	󰀄󰁜󰀄日
朂	曰耳力󰁣
會	人一󰀺日
朄	曰丨木󰀹
朅	土厶日󰄃
朆	丷󰀺日󰁤
朇	人一󰀺十
月	月月月月
有	月󰀘
朊	月二儿󰁀
朋	月月󰀝
朌	月八刀󰁥
服	月卩又󰁶
朎	月人丶󰁻
朏	月凵山󰀢
朐	月勹口󰀝
朑	月廿󰄃󰁀
朒	月冂人人
朓	月儿󰀪󰁶
朔	䒑凵丿月
朕	月䒑大󰁶
朖	月丶艮󰁶
朗	丶󰁮月󰀝
朘	月厶八夂
朙	囗八ㄇ月
朚	亠󰄃日月
望	亠󰄃月王
朜	月󰁸子󰀝
朝	十早月󰀝
朞	󰀎八月󰀘
期	󰀎八月󰀝
朠	月艹ㄇ大
朡	月乂凵夂
朢	匚丨󰁃王
朣	月立曰土
朤	月月月月
朥	月火火力
朦	月艹冖󰀓
朧	月立月三
木	木木木木
朩	朩一亅丶
未	未一一󰂃
末	一木󰀦
本	木一󰀌
札	木乚󰁀
朮	十儿丶󰀦
术	木丶󰀦
朰	木乙󰀅
朱	丿未󰀦
朲	木人󰁶
朳	木八󰁶
朴	木卜󰁶
朵	几木󰁧
朶	乃木󰁧
朷	木刀󰁥
朸	木力󰁥
朹	木九󰁀
机	木几󰁀
朻	木󰁐丨󰀢
朼	木匕󰁀
朽	木一ㄅ󰁀
朾	木丁󰀢
朿	木冂󰁫
杀	乂朩󰁧
杁	木丿󰂃󰁶
杂	九朩󰁧
权	木又󰁶
杄	木丿十󰀢
杅	木一󰀛󰀢
杆	木干󰀢
杇	木二ㄅ󰁀
杈	木又丶󰁶
杉	木彡󰁥
杊	木川󰀢
杋	木几丶󰁶
杌	木一儿󰁀
杍	木子󰀝
李	木子󰀘
杏	木口󰀘
材	木󰀛丿󰁥
村	木寸󰁶
杒	木刀丶󰁶
杓	木勹丶󰁶
杔	木丿七󰁀
杕	木大󰁶
杖	木󰂃󰁶
杗	亠󰄃木󰁧
杘	尸木󰀦
杙	木󰀁丶󰁶
杚	木𠂉乙󰁀
杛	木弓󰁀
杜	木土󰀝
杝	木也󰁀
杞	木己󰁀
束	木口󰀌
杠	木工󰀝
条	夂朩󰁧
杢	木工󰀘
杣	木山󰀢
杤	木一󰁡󰁥
来	一丷木󰀦
杦	木ク󰂃󰁶
杧	木亠󰄃󰁀
杨	木ㄋ󰁤󰁥
杩	木󰀊一󰀝
杪	木小丿󰁥
杫	木止󰀝
杬	木二儿󰁀
杭	木亠几󰁀
杮	木一冂丨
杯	木丆卜󰁶
杰	木灬󰁧
東	木曰󰀌
杲	曰木󰁧
杳	木曰󰀘
杴	木⺈人󰁶
杵	木𠂉十󰀢
杶	木一凵乚
杷	木巴󰁀
杸	木几又󰁶
杹	木亻ヒ󰁀
杺	木心󰁶
杻	木󰁈丨一
杼	木󰁻乛亅
杽	木手󰀢
松	木八厶󰁶
板	木⺁又󰁶
枀	八厶木󰁧
极	木乃󰂃󰁶
枂	木月󰀝
枃	木勹冫󰀝
构	木勹厶󰁶
枅	木一廾󰀢
枆	木毛󰁀
枇	木󰁴匕󰁀
枈	󰁴匕木󰁧
枉	木王󰀝
枊	木󰁚卩󰀢
枋	木方󰁥
枌	木八刀󰁥
枍	木八一ㄅ
枎	木夫󰁶
枏	木冂二󰀝
析	木斤󰀢
枑	木一彑󰀝
枒	木󰀄亅丿
枓	木󰁦十󰀢
枔	木人丶乛
枕	木冖󰁜󰁀
枖	木丿大󰁶
林	木木󰁶
枘	木冂人󰁶
枙	木厂⺋󰁀
枚	木攵󰁶
枛	木⺁丨󰂃
果	曰木󰀦
枝	木十又󰁶
枞	木人人󰁶
枟	木二厶󰁶
枠	木九十󰀢
枡	木丿廾󰀢
枢	木匚乂󰁶
枣	木ㄇ󰁦󰁧
枤	木犬󰁶
枥	木厂力󰁥
枦	木丶尸󰁥
枧	木ㄇ󰁜󰁀
枨	木丿七󰂃
枩	木八厶󰁧
枪	木人⺋󰁀
枫	木几乂󰁶
枬	木󰀼亠󰀝
枭	󰁠木󰁧
枮	木󰀥口󰀝
枯	木古󰀝
枰	木一丷十
枱	木厶口󰀝
枲	厶口木󰁧
枳	木口八󰁶
枴	木口刀󰁥
枵	木口一ㄅ
架	力口木󰁧
枷	木力口󰀝
枸	木勹口󰀝
枹	木勹巳󰁀
枺	木一木󰁶
枻	木廿󰄃󰁀
枼	廿󰄃木󰁧
枽	十廿木󰁧
枾	木十󰀯一
枿	木十廾󰀢
柀	木皮󰁶
柁	木宀匕󰁀
柂	木𠂉也󰁀
柃	木人丶󰁻
柄	木一冂人
柅	木尸匕󰁀
柆	木立󰀝
柇	木禾󰁶
柈	木丷󰀟󰀢
柉	木丿之󰁶
柊	木夂󰁦󰁶
柋	亻󰀁丶木
柌	木𠃌一口
柍	木ㄇ大󰁶
柎	木亻寸󰁶
柏	木白󰀝
某	甘木󰁧
柑	木甘󰀝
柒	氵七木󰁧
染	氵九木󰁧
柔	󰁻乛亅木
柕	木󰁻乛丿
柖	木刀口󰀝
柗	木八口󰀝
柘	木石󰀝
柙	木甲󰀢
柚	木由󰀝
柛	木曰丨󰀢
柜	木匚󰁃󰀝
柝	木斤丶󰁶
柞	木𠂉丨二
柟	木冂土󰀝
柠	木宀丁󰀢
柡	木二水󰁶
柢	木󰁚󰀁丶
柣	木丿夫󰁶
柤	木󰀐一󰀝
查	木曰一󰀘
柦	木日一󰀝
柧	木⺁厶󰂃
柨	木冂丨
柩	木匚ク丶
柪	木幺力󰁥
柫	木弓󰀯󰀢
柬	木󰀹󰀌
柭	木又丶
柮	木凵山󰀢
柯	木丁口󰀝
柰	木二小󰁧
柱	木丶王󰀝
柲	木心丿󰁥
柳	木󰁚丿卩
柴	止匕木󰁧
柵	木冂艹󰀢
柶	木四󰀝
柷	木口儿󰁀
柸	木丆卜一
柹	木丿ㄅ丿
柺	木口力󰁥
査	木󰀐一󰀘
柼	木宀八󰁶
柽	木又土󰀝
柾	木一止󰀝
柿	木亠冂丨
栀	木⺁一⺋
栁	木夕卩󰀢
栂	木母󰁶
栃	木⺁一󰁡
栄	󰀧冖木󰁧
栅	木󰀼󰀼一
栆	一口丨󰁦
标	木二小󰁶
栈	木一戈󰁶
栉	木艹ㄗ󰀢
栊	木ヒ丶
栋	木󰀂小󰁶
栌	木󰀥尸󰁥
栍	木丿󰀝
栎	木丿󰄃小
栏	木丷三󰀝
栐	木丶𠃌󰀩
树	木又寸󰁶
栒	木勹日󰀝
栓	木人王󰀝
栔	三丨刀木
栕	木匚丨丨
栖	木西󰀝
栗	覀木󰁧
栘	木夕夕󰁶
栙	木夂㐄󰀢
栚	木䒑大󰁶
栛	木力力力
栜	木木冂󰁀
栝	木丿古󰀝
栞	一干木
栟	木䒑廾󰀢
栠	亻丿士木
校	木六乂󰁶
栢	木丆日󰀝
栣	木亻丿士
栤	木冫水󰁶
栥	冫⺈人木
栦	木丶丿丨
栧	木曰󰁒丿
栨	木冫⺈人
栩	木羽󰀝
株	木丿未󰁶
栫	木丨子
栬	木⺈巴󰁀
栭	木丆冂〢
栮	木耳󰀝
栯	木月󰀝
栰	木亻戈󰁶
栱	木󰁺八󰁶
栲	木土丿ㄅ
栳	木土丿匕
栴	木𠂉󰀼亠
栵	木一夕刂
栶	木囗大󰁶
样	木羊󰀢
核	木亠ㄥ人
根	木艮󰁶
栺	木匕日󰀝
栻	木󰀁工丶
格	木夂口󰀝
栽	十戈木󰀦
栾	亠󰁗木󰁧
栿	木亻犬󰁶
桀	夕㐄木󰁧
桁	木彳一丁
桂	木土土󰀝
桃	木儿󰀪󰁶
桄	木⺌一儿
桅	木⺈厂⺋
框	木匚王󰀝
桇	女口木󰁧
案	宀女木󰁧
桉	木宀女󰀝
桊	丷夫木󰁧
桋	木一弓人
桌	󰀥曰木󰁧
桍	木大二ㄅ
桎	木一厶土
桏	木工阝󰀢
桐	木冂一口
桑	又又又木
桒	十艹木󰁧
桓	木一曰一
桔	木士口󰀝
桕	木臼󰀝
桖	木丿皿󰀝
桗	木乃木󰁶
桘	木丿󰃧󰀝
桙	木厶丿󰀟
桚	木巛夕󰁶
桛	木上一卜
桜	木󰀧女󰀝
桝	木夕㐄󰀢
桞	木夕阝󰀢
桟	木二戈󰁶
桠	木一业󰀝
桡	木󰀁丿儿
桢	木󰀥贝󰁶
档	木⺌彐󰀝
桤	木山己󰁀
桥	木丿大󰀯
桦	木亻ヒ十
桧	木人二厶
桨	丬夕木󰁧
桩	木广土󰀝
桪	木彐寸󰁶
桫	木氵小丿
桬	氵小丿木
桭	木厂二󰀖
桮	木丆卜口
桯	木口王󰀝
桰	木󰁚󰀁口
桱	木一巛工
桲	木十冖子
桳	木厶大十
桴	木爫子󰀝
桵	木爫女󰀝
桶	木󰁻用󰀢
桷	木⺈用󰀢
桸	木乂丨
桹	木丶艮󰁶
桺	木一󰀯󰁃
桻	木夂三丨
桼	木人氺󰁧
桽	木人人土
桾	木󰁬丿口
桿	木曰干󰀢
梀	木木口󰀝
梁	氵刀八木
梂	木一氺丶
梃	木丿士廴
梄	木西一󰀝
梅	木𠂉母󰁶
梆	木三丿阝
梇	木王廾󰀢
梈	木󰁸了󰀢
梉	木爿士󰀝
梊	扌斤木󰁧
梋	木口月󰀝
梌	木人一朩
梍	木白七󰁀
梎	木白匕󰁀
梏	木丿土口
梐	木󰁴匕土
梑	木犭󰁥火
梒	木人丶口
梓	木辛󰀢
梔	木⺁一巴
梕	木刀丶心
梖	木貝󰁶
梗	木一曰乂
梘	木目儿󰁀
梙	木口口丨
梚	木⺈口󰁜
梛	木𠃌󰀠阝
梜	木大人人
條	亻丨夂朩
梞	木己心󰁶
梟	󰁟木󰁧
梠	木口口󰀝
梡	木宀二儿
梢	木⺌月󰀝
梣	木山人乛
梤	木山八刀
梥	宀八厶木
梦	木木夕󰁧
梧	木五口󰀝
梨	禾刂木󰁧
梩	木曰土󰀝
梪	木一口䒑
梫	木彐冖又
梬	木由一ㄅ
梭	木厶八夂
梮	木尸𠃌口
梯	木丷弓丿
械	木戈廾󰀢
梱	木囗木󰁶
梲	木八口儿
梳	木亠厶󰀸
梴	木丿󰀥廴
梵	木木几丶
梶	木尸毛󰁀
梷	󰀥口又木
梸	木禾刂󰀢
梹	木丘八󰁶
梺	木木一卜
梻	木亻弓󰀯
梼	木三丿寸
梽	木士心󰁶
梾	木一丷木
梿	木车辶󰁶
检	木人一一
棁	木丷口儿
棂	木彐火󰁶
棃	禾勹丿木
棄	亠厶廿木
棅	木禾󰁬󰀝
棆	木人一艹
棇	木八厶心
棈	木月󰀝
棉	木白冂丨
棊	󰀎八木󰁧
棋	木󰀎八󰁶
棌	木爫木󰁶
棍	木曰󰁴匕
棎	木冖八木
棏	木曰一寸
棐	丨三丨木
棑	木丨三三
棒	木三人󰀟
棓	木立口󰀝
棔	木󰁚󰀁日
棕	木宀二小
棖	木󰀍󰀖󰁶
棗	木冂木冂
棘	木冂木冂
棙	木丶尸犬
棚	木月月󰀝
棛	木亠厶月
棜	木方人󰁦
棝	木囗古󰀝
棞	木囗禾󰁶
棟	木木曰󰀝
棠	⺌冖口木
棡	木冂䒑山
棢	木冂䒑󰄃
棣	木󰁬氺󰁶
棤	木󰁺日󰀝
棥	木乂乂木
棦	木⺈󰁬亅
棧	木戈戈󰁶
棨	丶尸攵木
棩	木󰀲一󰀝
棪	木火火󰁶
棫	木戈口󰀞
棬	木丷夫⺋
棭	木亠亻丶
森	木木木󰁧
棯	木人丶心
棰	木丿士󰁺
棱	木土八夂
棲	木一󰁬女
棳	木又又又
棴	木月卩又
棵	木曰木󰁶
棶	木木人人
棷	木耳又󰁶
棸	耳又木󰁧
棹	木󰀥早󰀢
棺	木宀󰃧󰀝
棻	艹八刀木
棼	木木八刀
棽	木木人乛
棾	木木冖几
棿	木臼儿󰁀
椀	木宀夕⺋
椁	木󰁸子󰀝
椂	木󰁭氺󰁶
椃	木虍几󰁀
椄	木立女󰀝
椅	木大丁口
椆	木󰀼土口
椇	木󰀣八󰁶
椈	木勹米󰁶
椉	亠夕㐄木
椊	木亠人十
椋	木󰁸小󰁶
椌	木宀八工
植	木十󰀣󰀝
椎	木亻󰁷󰀝
椏	木一󰀚一
椐	木尸古󰀝
椑	木白丿十
椒	木上小又
椓	木一󰀓丶
椔	木巛田󰀝
椕	木八刀木
椖	木丶尸方
椗	木宀一󰁾
椘	木木之󰁧
椙	木曰曰󰀝
椚	木門󰀝
椛	木艹亻ヒ
検	木人一人
椝	夫冂󰁜木
椞	木斤木󰁧
椟	木十乛大
椠	车斤木󰁧
椡	木一厶刂
椢	木囗王丶
椣	木ㄇ󰁺八
椤	木罒夕󰁶
椥	木𠂉大口
椦	木丷夫力
椧	木人一卩
椨	木广亻寸
椩	木广󰁬人
椪	木䒑业󰀝
椫	木丷曰十
椬	木宀󰀐一
椭	木阝月
椮	木厶大彡
椯	木山丆〢
椰	木耳阝󰀢
椱	木𠂉曰夂
椲	木󰁆口㐄
椳	木田一󰀖
椴	木丿丨又
椵	木󰁃丨又
椶	木乂凵夂
椷	木戊一口
椸	木方𠂉也
椹	木󰀎八󰄃
椺	木亻口木
椻	木匚曰女
椼	木彳氵丁
椽	木彑󰀓󰁶
椾	木䒑月刂
椿	木三人日
楀	木丿口丶
楁	木宀夂口
楂	木木曰一
楃	木尸一土
楄	木丶尸艹
楅	木一口田
楆	木覀女󰀝
楇	木ㄇ󰁈口
楈	木乛󰁾月
楉	木艹口
楊	木曰一󰁤
楋	木木口刂
楌	木立丿彡
楍	木口口口
楎	木冖車󰀢
楏	木大土土
楐	木田人󰀯
楑	木癶一大
楒	木田心󰁶
楓	木几丿虫
楔	木三丨大
楕	木工月
楖	木󰁮卩󰀢
楗	木󰁬󰀟廴
楘	󰁻乛亅木
楙	木󰁻乛木
楚	木木乛󰁾
楛	木艹古󰀝
楜	木古月󰀝
楝	木木󰀹󰀝
楞	木罒方󰁥
楟	木󰁸冖丁
楠	木十冂十
楡	木人一巜
楢	木丷西一
楣	木󰁅目󰀝
楤	木勹󰁤心
楥	木爫一又
楦	木宀一一
楧	木艹ㄇ大
楨	木󰀥貝󰁶
楩	木亻一乂
楪	木廿󰄃木
楫	木口耳󰀝
楬	木曰勹󰄃
業	业䒑未󰁧
楮	木土丿日
楯	木⺁十目
楰	木臼人󰁶
楱	木三人大
楲	木戊一女
楳	木甘木󰁶
楴	木亠丷丨
極	木了口一
楶	冫⺈人木
楷	木󰁴匕白
楸	木禾火󰁶
楹	木乃又皿
楺	木󰁻乛木
楻	木白王󰀝
楼	木米女󰀝
楽	白󰀪木󰁧
楾	木白水󰁶
楿	木禾日󰀝
榀	木口口口
榁	木宀一土
概	木󰁮󰀄󰁜
榃	木木田󰀘
榄	木〢𠂉󰁜
榅	木曰皿󰀝
榆	木人一刂
榇	木立朩󰁶
榈	木门口口
榉	木󰀧一󰀟
榊	木礻󰁶丨
榋	木彐彐彐
榌	木⺄〈丨
榍	木尸⺌月
榎	木丆目夂
榏	木䒑八皿
榐	木尸󰁺󰀖
榑	木甫寸󰁶
榒	木弓冫冫
榓	木心丿皿
榔	木丶󰁮阝
榕	木宀八口
榖	士冖一又
榗	木一业日
榘	𠂉大匚木
榙	木艹人口
榚	木丷王灬
榛	木三人禾
榜	木亠丷方
榝	木乂朩又
榞	木厂白小
榟	木宀辛󰀢
榠	木冖日六
榡	木幺小
榢	木宀一󰀓
榣	木爫𠂉凵
榤	木夕㐄木
榥	木日⺌儿
榦	十早人木
榧	木匚丨三
榨	木宀八二
榩	木虍文󰁶
榪	木󰀋灬󰁶
榫	木亻󰁷十
榬	木土口󰀔
榭	木丿󰀽寸
榮	火火冖木
榯	木日土寸
榰	木土丿日
榱	木亠口󰀔
榲	木囗人皿
榳	木广丿廴
榴	木󰁚丶田
榵	木艹耳󰀝
榶	木广󰁬口
榷	木冖亻󰁷
榸	木土曰土
榹	木⺁虍几
榺	月丷夫木
榻	木曰羽󰀝
榼	木土厶皿
榽	木爫幺大
榾	木󰀾月󰀝
榿	木山一䒑
槀	󰁸冂口木
槁	木󰁸冂口
槂	木孑丿小
槃	丿󰁪几木
槄	木爫臼󰀝
槅	木一口丨
槆	木艹勹日
槇	木匕目八
槈	木厂二寸
槉	木疒𠂉大
槊	䒑凵丿木
構	木󰀀冂土
槌	木丿󰃧辶
槍	木人丶口
槎	木⺶工󰀝
槏	木䒑󰁬八
槐	木白󰁜厶
槑	口木口木
槒	木亠幺田
槓	木工貝󰁶
槔	木白大十
槕	木󰀥曰木
槖	士冖石木
槗	木口口
様	木丷王水
槙	木十󰀣八
槚	木覀贝󰁶
槛	木〢𠂉皿
槜	木亻󰁷乃
槝	木󰁟山󰀢
槞	木立曰乚
槟	木宀丘八
槠	木讠土日
槡	木又又木
槢	木羽白󰀝
槣	木宀大口
槤	木車辶󰁶
槥	木三丨彐
槦	木广󰁬丨
槧	車斤木󰁧
槨	木󰁸孑阝
槩	白󰁴󰀄木
槪	木白匕󰁜
槫	木一曰寸
槬	木大二󰂃
槭	木戊上小
槮	木厶厶彡
槯	木山亻󰁷
槰	木夂三辶
槱	木西一灬
槲	木⺈用十
槳	爿󰁝寸木
槴	木丶尸巴
槵	木口口心
槶	木囗戈󰀞
槷	土八土木
槸	木土八丶
槹	木白󰀪十
槺	木广󰁬氺
槻	木夫目儿
槼	夫目儿木
槽	木一ㄇ日
槾	木曰罒又
槿	木廿口
樀	木亠丷古
樁	木三人臼
樂	白幺幺木
樃	木丶󰁮月
樄	木阝木曰
樅	木彳人󰁾
樆	木亠乂厶
樇	木亻丨月
樈	木立曰儿
樉	木大乂乂
樊	木乂乂大
樋	木󰁻用辶
樌	木毌貝󰁶
樍	木貝󰁶
樎	木宀亻日
樏	木田幺小
樐	木󰀥囗󰁘
樑	木氵刀木
樒	木宀心山
樓	木󰀻女󰀝
樔	木巛曰木
樕	木木口人
樖	人一口口
樗	木󰀙二ㄅ
樘	木⺌冖土
標	木覀二小
樚	木󰁙󰁴匕
樛	木羽人彡
樜	木广廿灬
樝	木虍󰀐一
樞	木匚口口
樟	木立早󰀢
樠	木廿冂丶
模	木艹曰大
樢	木󰁟灬󰁶
樣	木丷王󰀩
樤	木亻丨朩
樥	木艹夂丨
樦	木⺮丶王
樧	木乂木又
樨	木尸氺󰀟
権	木𠂉一󰁷
横	木󰁺由八
樫	木匚丨土
樬	木丿囗心
樭	木󰀎八土
樮	木覀火󰁶
樯	木十䒑口
樰	木󰀙彐󰀝
樱	木贝贝女
樲	木󰀁二丶
樳	木彐工寸
樴	木亠丷日
樵	木亻󰁷灬
樶	木曰耳又
樷	木木耳又
樸	木业䒑夫
樹	木土口寸
樺	木艹一󰀟
樻	木口丨貝
樼	木尸子子
樽	木丷西寸
樾	木土󰁾󰁐
樿	木口口十
橀	木亠厶皿
橁	木⺮勹日
橂	木丷西大
橃	木癶弓又
橄	木乛耳攵
橅	木𠂉一灬
橆	𠂉一󰀷木
橇	木毛毛毛
橈	木土土儿
橉	木米夕㐄
橊	木一〢田
橋	木丿大口
橌	木門月󰀝
橍	木門王󰀝
橎	木丿米田
橏	木羊䒑口
橐	一口丨木
橑	木大丷小
橒	木󰀙二厶
橓	木爫冖㐄
橔	木󰁸孑攵
橕	木⺌冖丿
橖	木⺌冖木
橗	木艹日月
橘	木󰁻乛口
橙	木癶一䒑
橚	木󰁬十󰀲
橛	木厂䒑人
橜	厂䒑凵木
橝	木覀早󰀢
橞	木一曰心
機	木幺幺人
橠	木亠夕󰀔
橡	木⺈口󰀓
橢	木阝月
橣	木宀心用
橤	心心心木
橥	犭󰁥土木
橦	木立曰土
橧	木丷󰀺日
橨	木十艹貝
橩	木火火几
橪	木󰁝犬灬
橫	木廿一八
橬	木󰀄󰁜日
橭	木古辛󰀢
橮	木󰁚丶貝
橯	木火火力
橰	木丿目十
橱	木厂一寸
橲	木士口口
橳	木月丷力
橴	木止匕小
橵	木󰁺月攵
橶	木十早戈
橷	木白丬儿
橸	木曰曰曰
橹	木󰁢一曰
橺	木門日󰀝
橻	木󰁈丨一
橼	木纟彑󰀓
橽	木土羊辶
橾	木口口木
橿	木一田一
檀	木亠囗一
檁	木亠囗禾
檂	木ㄇ󰁺󰀖
檃	阝爫工木
檄	木白方攵
檅	木止戊󰀤
檆	木火火口
檇	木亻󰁷𠃌
檈	木罒一󰀔
檉	木耳口王
檊	木十早干
檋	木󰁺八車
檌	木罒丨三
檍	木立曰心
檎	木人亠厶
檏	木业䒑未
檐	木⺈厂言
檑	木󰀙田󰀝
檒	木木几虫
檓	木臼工又
檔	木⺌冖田
檕	車凵几木
檖	木䒑󰀓辶
檗	尸口辛木
檘	木尸口辛
檙	木目󰁕󰁈
檚	木木木󰁾
檛	木ㄇ󰁈辶
檜	木人一日
檝	木口耳丶
檞	木⺈用󰀟
檟	木覀貝󰁶
檠	艹勹口木
檡	木罒土十
檢	木人一人
檣	木土人口
檤	木䒑丿辶
檥	木丷王丶
檦	木覀二刂
檧	木艹勹心
檨	木丷王人
檩	木亠囗小
檪	木白󰀪木
檫	木宀󰁯小
檬	木艹冖󰀓
檭	木釒艮󰁶
檮	木士乛寸
檯	木士口土
檰	木糹白丨
檱	木⺮󰀎八
檲	木囗一寸
檳	木宀一貝
檴	木艹亻又
檵	木幺幺󰄃
檶	木大匚口
檷	木一八乂
檸	木宀心丁
檹	木方𠂉口
檺	木󰁸冖󰀓
檻	木匚丨皿
檼	木爫工心
檽	木󰀙丆〢
檾	火火冖木
檿	厂曰月木
櫀	木󰀎八小
櫁	木宀心虫
櫂	木羽亻󰁷
櫃	木匚口貝
櫄	木丿一灬
櫅	木󰀴󰀳󰀝
櫆	木白󰁜十
櫇	木皮丆貝
櫈	木癶一几
櫉	木厂士寸
櫊	木門夂口
櫋	木丿目方
櫌	木丆󰀐夂
櫍	木斤斤貝
櫎	木广󰁺八
櫏	木覀大辶
櫐	田田田木
櫑	木田田田
櫒	木艹󰁯小
櫓	木󰁢灬日
櫔	木厂艹丶
櫕	木夫夫貝
櫖	木虍田心
櫗	木艹罒人
櫘	木三丨心
櫙	木艹匚口
櫚	木門口口
櫛	木⺮󰁮卩
櫜	一口丨木
櫝	木士罒貝
櫞	木糹彑󰀓
櫟	木白幺木
櫠	木广癶又
櫡	木⺮土日
櫢	木󰀻女攵
櫣	木艹車辶
櫤	木⺮䒑刂
櫥	木广士寸
櫦	木󰁙乛夂
櫧	木言土日
櫨	木虍田皿
櫩	木門⺈臼
櫪	木厂禾止
櫫	一󰀓土木
櫬	木立朩儿
櫭	木󰁮󰀄一
櫮	木王口口
櫯	木󰁢灬禾
櫰	木亠罒󰀔
櫱	凵丿丿木
櫲	木󰁻乛󰀓
櫳	木立月三
櫴	木木口貝
櫵	木艹亻灬
櫶	木宀三心
櫷	木丿󰁵󰀝
櫸	木󰀗一󰀟
櫹	木艹󰁬󰀲
櫺	木󰀙口口
櫻	木貝貝女
櫼	木人人󰀞
櫽	阝爫工木
櫾	木爫𠂉小
櫿	木火火口
欀	木亠口󰀔
欁	木ㄇ󰁺木
欂	木艹氵寸
欃	木⺈口丶
欄	木門木󰀹
欅	木󰀗一手
欆	木亻󰁷又
欇	木耳耳耳
欈	木山亻口
欉	木业䒑又
權	木艹口󰁷
欋	木目目󰁷
欌	木艹戈丨
欍	木艹亻臼
欎	木乂乂寸
欏	木罒糹󰁷
欐	木一ㄇ匕
欑	木丿土貝
欒	言糹糹木
欓	木⺌冖灬
欔	木目目又
欕	木口口攵
欖	木匚丨儿
欗	木艹門󰀹
欘	木尸氺虫
欙	木田田小
欚	木彑󰀓虫
欛	木󰀙廿月
欜	木一口󰀔
欝	木乂乂寸
欞	木󰀙口人
欟	木艹口儿
欠	⺈人󰁧
次	冫⺈人󰁶
欢	又⺈人󰁶
欣	斤⺈人󰁶
欤	一ㄅ󰀞人
欥	日⺈人󰁶
欦	人丶乛人
欧	匚乂⺈人
欨	勹口⺈人
欩	刀口⺈人
欪	凵山⺈人
欫	𠂉一止人
欬	亠ㄥ丿人
欭	囗大⺈人
欮	䒑凵丿人
欯	士口⺈人
欰	丿皿⺈人
欱	人一口人
欲	八人口人
欳	󰀥冂艹人
欴	丶󰁮⺈人
欵	匕𠂉大人
欶	木口⺈人
欷	乂冂人
欸	厶𠂉大人
欹	大丁口人
欺	󰀎八⺈人
欻	火火⺈人
欼	又又又人
欽	釒⺈人󰁶
款	士二小人
欿	⺈臼⺈人
歀	木二小人
歁	󰀎八󰄃人
歂	山丆冂人
歃	丿十臼人
歄	ㄇ󰁈冂人
歅	覀土⺈人
歆	立日⺈人
歇	日勹人人
歈	人一月人
歉	䒑󰁬〢人
歊	󰁸冂口人
歋	⺁虍几人
歌	丁口丁人
歍	󰁞灬⺈人
歎	廿口夫人
歏	廿口人
歐	匚口口人
歑	虍丿丷人
歒	亠丷冂人
歓	𠂉一亻人
歔	虍业⺈人
歕	十艹貝人
歖	士口䒑人
歗	󰁬十󰀲人
歘	火火火人
歙	人一口人
歚	羊䒑口人
歛	人一口人
歜	罒勹虫人
歝	罒土䒑人
歞	日幺幺人
歟	󰀗一󰁕人
歠	又又又人
歡	艹口口人
止	止丨一一
正	一止󰀌
此	止匕󰁀
步	止󰀤󰁣
武	一󰀁止丶
歧	止十又󰁶
歨	止󰁾󰁧
歩	󰁾小丿󰁣
歪	丆卜一止
歫	止匚󰁃󰀝
歬	止丿󰁪󰁧
歭	止土寸󰁶
歮	止止止󰀘
歯	止米凵󰀬
歰	刀丶刀止
歱	止丿一土
歲	止戊一󰀤
歳	止戊一小
歴	厂木木止
歵	止貝󰁶
歶	止匕曰丶
歷	厂禾禾止
歸	丿󰃧止丨
歹	一夕󰀦
歺	󰀥夕󰁧
死	一夕匕󰁫
歼	一夕丿十
歽	一夕斤󰀢
歾	一夕勹󰁤
歿	一夕󰁡又
殀	一夕丿大
殁	一夕几又
殂	一夕󰀐一
殃	一夕ㄇ大
殄	一夕人彡
殅	一夕丿
殆	一夕厶口
殇	一夕𠂉󰁤
殈	一夕丿皿
殉	一夕勹日
殊	一夕丿未
残	一夕一戈
殌	一夕一工
殍	一夕爫子
殎	一夕大人
殏	一夕一丶
殐	一夕木口
殑	一夕古儿
殒	一夕口贝
殓	一夕人一
殔	一夕󰁬氺
殕	一夕立口
殖	一夕十󰀣
殗	一夕大乚
殘	一夕戈戈
殙	一夕󰁚日
殚	一夕丷十
殛	一夕了一
殜	一夕廿木
殝	一夕三禾
殞	一夕口貝
殟	一夕曰皿
殠	一夕丿犬
殡	一夕宀八
殢	一夕廿丨
殣	一夕廿
殤	一夕𠂉󰁤
殥	一夕宀八
殦	一夕󰁟灬
殧	一夕󰁸丶
殨	一夕口貝
殩	一夕󰀥米
殪	一夕士䒑
殫	一夕口十
殬	一夕罒土
殭	一夕一一
殮	一夕人人
殯	一夕宀貝
殰	一夕士貝
殱	一夕十󰀞
殲	一夕人󰀞
殳	几又󰁧
殴	匚乂几又
段	丿丨三又
殶	丶王几又
殷	⺁彐𠃌又
殸	士󰁅几又
殹	匚𠂉大又
殺	乂朩几又
殻	士冖几又
殼	士冖一又
殽	乂月又
殾	土丿日又
殿	尸󰁺八又
毀	臼土几又
毁	臼工几又
毂	士冖车又
毃	󰁸冂口又
毄	車口几又
毅	立󰀓几又
毆	匚口口又
毇	臼米几又
毈	󰁚丶丿又
毉	匚𠂉大人
毊	士󰁅几口
毋	󰄃𠃌󰀏
毌	毌󰄃󰁈丨
母	母󰄃𠃌丶
毎	𠂉󰄃𠃌十
每	𠂉母󰁧
毐	土󰄃𠃌
毑	母也󰁀
毒	母󰁧
毓	𠂉母亠󰀸
比	󰁴匕󰁀
毕	󰁴匕十󰀬
毖	󰁴匕心丿
毗	田󰁴匕󰁀
毘	田󰁴匕󰀅
毙	󰁴匕一匕
毚	⺈口󰁴丶
毛	毛丿一乚
毜	毛小󰀦
毝	毛彡󰀏
毞	󰁴匕毛󰀅
毟	小丿毛󰀅
毠	力口毛󰀅
毡	毛󰀥口󰀌
毢	毛西󰀌
毣	羽毛󰀅
毤	八厶儿毛
毥	毛勹日󰀌
毦	耳毛󰁀
毧	毛戈󰀏
毨	毛丿土儿
毩	毛米󰀦
毪	毛厶丿󰀟
毫	󰁸冖毛󰀅
毬	毛一氺丶
毭	一口䒑毛
毮	扌小丿毛
毯	毛火火󰀦
毰	毛立口󰀌
毱	毛勹米󰀦
毲	又又又毛
毳	毛毛毛󰀅
毴	毛丨三三
毵	厶大彡毛
毶	毛厶大彡
毷	󰀰目毛󰁀
毸	毛田心󰀦
毹	人一月毛
毺	毛人一刂
毻	工月毛
毼	曰勹人毛
毽	毛󰁬󰀟廴
毾	曰羽毛󰁀
毿	厶厶厶毛
氀	󰀻女毛󰁀
氁	毛艹曰大
氂	未攵厂毛
氃	立曰土毛
氄	󰁻乛亅毛
氅	⺌冂口毛
氆	毛䒑业曰
氇	毛󰁢一曰
氈	亠囗口毛
氉	口口口毛
氊	毛亠囗一
氋	艹冖二毛
氌	毛󰁢灬日
氍	目目亻毛
氎	田田田毛
氏	󰁚󰀁󰁫
氐	󰁚󰀁丶󰀦
民	󰁂󰀁󰁫
氒	󰁚󰀁十󰀬
氓	亠󰄃󰁂󰀁
气	气丿一⺄
氕	气丿󰀏
氖	气乃󰀏
気	气乂󰀦
氘	气󰀯󰀵
氙	气山󰀵
氚	气川󰀵
氛	气八刀󰀏
氜	气日󰀌
氝	气冂人󰀦
氞	气一冂人
氟	气弓󰀯󰀵
氠	气曰丨󰀵
氡	气夂󰁦󰀦
氢	气ス工󰀌
氣	气米󰀦
氤	气囗大󰀦
氥	气西󰀌
氦	气亠ㄥ人
氧	气羊󰀵
氨	气宀女󰀌
氩	气一业󰀌
氪	气古儿󰁫
氫	气一巛工
氬	气一󰀚一
氭	气木曰󰀌
氮	气火火󰀦
氯	气󰁭氺󰀦
氰	气月󰀌
氱	气曰一󰁤
氲	气曰皿󰀌
氳	气囗人皿
水	水水水水
氵	氵丶丶󰀞
氶	了󰀩󰀦
氷	丶水󰀦
永	丶𠃌󰀩󰀦
氹	乙水󰀦
氺	氺亅丶丶
氻	氵力󰁥
氼	水人󰁧
氽	人水󰁧
氾	氵⺋󰁀
氿	氵九󰁀
汀	氵丁󰀢
汁	氵十󰀢
求	一氺丶󰀦
汃	氵八󰁶
汄	氵人󰁶
汅	氵一ㄅ󰁀
汆	丿󰂃水󰁧
汇	氵匚󰁀
汈	氵𠃌󰀞󰀝
汉	氵又󰁶
汊	氵又丶󰁶
汋	氵勹丶󰁶
汌	氵川󰀢
汍	氵九丶󰁶
汎	氵几丶󰁶
汏	氵大󰁶
汐	氵夕󰁶
汑	氵丿七󰁀
汒	氵亠󰄃󰁀
汓	氵子󰀝
汔	氵𠂉乙󰁀
汕	氵山󰀢
汖	山水󰁧
汗	氵干󰀢
汘	氵丿十󰀢
汙	氵一󰀛󰀢
汚	氵二ㄅ󰁀
汛	氵⺄十󰀢
汜	氵巳󰁀
汝	氵女󰀝
汞	工水󰁧
江	氵工󰀝
池	氵也󰁀
污	氵二ㄅ󰁀
汢	氵土󰀝
汣	氵ク󰂃󰁶
汤	氵ㄋ󰁤󰁥
汥	氵十又󰁶
汦	氵󰁚󰀁󰁀
汧	氵一廾󰀢
汨	氵日󰀝
汩	氵曰󰀝
汪	氵王󰀝
汫	氵二󰀯󰀢
汬	二󰀯水󰁧
汭	氵冂人󰁶
汮	氵勹冫󰀝
汯	氵厶󰁶
汰	氵大丶󰁶
汱	氵犬󰁶
汲	氵乃󰂃󰁶
汳	氵⺁又󰁶
汴	氵亠卜󰁶
汵	氵人丶乛
汶	氵文󰁶
汷	氵夂󰁶
汸	氵方󰁥
汹	氵乂凵󰀢
決	氵ユ人󰁶
汻	氵𠂉十󰀢
汼	氵丿󰀟󰀢
汽	氵气󰁀
汾	氵八刀󰁥
汿	氵󰁻乛亅
沀	水󰁻乛亅
沁	氵心󰁶
沂	氵斤󰀢
沃	氵丿大󰁶
沄	氵二厶󰁶
沅	氵二儿󰁀
沆	氵亠几󰁀
沇	氵厶儿󰁀
沈	氵冖󰁜󰁀
沉	氵冖几󰁀
沊	冖󰁜水󰀦
沋	氵乚丶
沌	氵一凵乚
沍	氵一彑󰀝
沎	氵亻ヒ󰁀
沏	氵七刀󰁥
沐	氵木󰁶
沑	氵󰁈丨一
沒	氵󰁡又󰁶
沓	水曰󰀘
沔	氵一丨𠃌
沕	氵勹󰁤󰁥
沖	氵口丨󰀢
沗	一大氺󰁧
沘	氵󰁴匕󰁀
沙	氵小丿󰁥
沚	氵止󰀝
沛	氵一冂丨
沜	氵丿丨󰁈
沝	水水󰁶
沞	氵一冂丨
沟	氵勹厶󰁶
沠	氵⺁丨󰂃
没	氵几又󰁶
沢	氵尸󰂃󰁶
沣	氵三丨󰀢
沤	氵匚乂󰁶
沥	氵厂力󰁥
沦	氵人匕󰁀
沧	氵人⺋󰁀
沨	氵几乂󰁶
沩	氵丶力丶
沪	氵丶尸󰁥
沫	氵一木󰁶
沬	氵未󰁶
沭	氵木丶󰁶
沮	氵󰀐一󰀝
沯	水石󰀘
沰	氵石󰀝
沱	氵宀匕󰁀
沲	氵𠂉也󰁀
河	氵丁口󰀝
沴	氵人彡󰁥
沵	氵⺈小󰁶
沶	氵二小󰁶
沷	氵又丶
沸	氵弓󰀯󰀢
油	氵由󰀝
沺	氵田󰀝
治	氵厶口󰀝
沼	氵刀口󰀝
沽	氵古󰀝
沾	氵󰀥口󰀝
沿	氵几口󰀝
泀	氵𠃌一口
況	氵口儿󰁀
泂	氵冂口󰀝
泃	氵勹口󰀝
泄	氵廿󰄃󰁀
泅	氵囗人󰁶
泆	氵丿夫󰁶
泇	氵力口󰀝
泈	氵夂󰁦󰁶
泉	白水󰁧
泊	氵白󰀝
泋	氵十廾󰀢
泌	氵心丿󰁥
泍	氵木一󰀝
泎	氵𠂉丨二
泏	氵凵山󰀢
泐	氵阝力󰁥
泑	氵幺力󰁥
泒	氵⺁厶󰂃
泓	氵弓厶󰁶
泔	氵甘󰀝
法	氵土厶󰁶
泖	氵󰁚丿卩
泗	氵四󰀝
泘	氵丿丷󰀛
泙	氵一丷十
泚	氵止匕󰁀
泛	氵丿之󰁶
泜	氵󰁚󰀁丶
泝	氵斤丶󰁶
泞	氵宀丁󰀢
泟	氵一止󰀝
泠	氵人丶󰁻
泡	氵勹巳󰁀
波	氵皮󰁶
泣	氵立󰀝
泤	氵󰁐丶人
泥	氵尸匕󰁀
泦	氵尸九󰁀
泧	氵戈󰁐󰁀
注	氵丶王󰀝
泩	氵丿󰀝
泪	氵目󰀝
泫	氵亠幺󰁶
泬	氵宀八󰁶
泭	氵亻寸󰁶
泮	氵丷󰀟󰀢
泯	氵󰁂󰀁󰁀
泰	三人氺󰁧
泱	氵ㄇ大󰁶
泲	氵丿ㄅ丿
泳	氵丶𠃌󰀩
泴	水皿󰀘
泵	石水󰁧
泶	󰀧冖水󰁧
泷	氵ヒ丶
泸	氵󰀥尸󰁥
泹	氵曰一󰀝
泺	氵丿󰄃小
泻	氵冖一一
泼	氵ㄥ丿丶
泽	氵又󰀟󰀢
泾	氵ス工󰀝
泿	氵艮󰁶
洀	氵丿󰁪󰁶
洁	氵士口󰀝
洂	氵亠󰁖󰁶
洃	氵火󰁶
洄	氵囗口󰀝
洅	氵一冂土
洆	氵了󰀩一
洇	氵囗大󰁶
洈	氵⺈厂⺋
洉	氵⺁一口
洊	氵丨子
洋	氵羊󰀢
洌	氵一夕刂
洍	氵匚丨丨
洎	氵丿目󰀝
洏	氵丆冂〢
洐	氵彳一丁
洑	氵亻犬󰁶
洒	氵西󰀝
洓	氵木冂󰁀
洔	氵土寸󰁶
洕	氵八月󰀝
洖	氵口一大
洗	氵丿土儿
洘	氵土丿ㄅ
洙	氵丿未󰁶
洚	氵夂㐄󰀢
洛	氵夂口󰀝
洜	夂口水󰁧
洝	氵宀女󰀝
洞	氵冂一口
洟	氵一弓人
洠	氵厶丿󰀟
洡	氵二木󰁶
洢	氵亻󰁬丿
洣	氵米󰁶
洤	氵人王󰀝
津	氵󰁬󰀟󰀢
洦	氵丆日󰀝
洧	氵月󰀝
洨	氵六乂󰁶
洩	氵曰󰁒丿
洪	氵󰁺八󰁶
洫	氵丿皿󰀝
洬	氵几一夕
洭	氵匚王󰀝
洮	氵儿󰀪󰁶
洯	三丨刀水
洰	氵匚󰁃󰀝
洱	氵耳󰀝
洲	氵丶丿丨
洳	氵女口󰀝
洴	氵䒑廾󰀢
洵	氵勹日󰀝
洶	氵勹乂凵
洷	氵一厶土
洸	氵⺌一儿
洹	氵一曰一
洺	氵夕口󰀝
活	氵丿古󰀝
洼	氵土土󰀝
洽	氵人一口
派	氵⺁󰀕󰁶
洿	氵大二ㄅ
浀	氵ㄇ󰁺󰀝
流	氵亠厶󰀸
浂	氵䒑大󰁶
浃	氵一丷大
浄	氵⺈󰁬亅
浅	氵一戈󰁶
浆	丬夕水󰁧
浇	氵󰀁丿儿
浈	氵󰀥贝󰁶
浉	氵リ一丨
浊	氵虫󰁶
测	氵贝刂󰀢
浌	氵亻戈󰁶
浍	氵人二厶
济	氵文󰀯󰀢
浏	氵文刂󰀢
浐	氵立丿󰁥
浑	氵冖车󰀢
浒	氵讠𠂉十
浓	氵冖󰀔󰁶
浔	氵彐寸󰁶
浕	氵尸󰂃󰁦
浖	氵爫寸󰁶
浗	氵一氺丶
浘	氵尸毛󰁀
浙	氵扌斤󰀢
浚	氵厶八夂
浛	氵人丶口
浜	氵丘八󰁶
浝	氵乚丶
浞	氵口󰁾󰁶
浟	氵亻丨攵
浠	氵乂丨
浡	氵十冖子
浢	氵一口䒑
浣	氵宀二儿
浤	氵宀厶
浥	氵口巴󰁀
浦	氵甫󰁶
浧	氵口王󰀝
浨	氵宀木󰁶
浩	氵丿土口
浪	氵丶艮󰁶
浫	氵冖八干
浬	氵曰土󰀝
浭	氵一曰乂
浮	氵爫子󰀝
浯	氵五口󰀝
浰	氵禾刂󰀢
浱	氵厂二󰀖
浲	氵夂三丨
浳	氵󰀁丶月
浴	氵八人口
浵	氵󰀼亠彡
浶	氵宀丿󰀟
海	氵𠂉母󰁶
浸	氵彐冖又
浹	氵大人人
浺	氵忄口丨
浻	氵冂八口
浼	氵⺈口󰁜
浽	氵爫女󰀝
浾	氵土󰁖󰁶
浿	氵貝󰁶
涀	氵目儿󰁀
涁	氵木彡󰁥
涂	氵人一朩
涃	氵囗木󰁶
涄	氵由一ㄅ
涅	氵曰土󰀝
涆	氵日干󰀢
涇	氵一巛工
消	氵⺌月󰀝
涉	氵止󰀤󰁥
涊	氵刀丶心
涋	氵宀犬󰁶
涌	氵󰁻用󰀢
涍	氵土丿子
涎	氵丿󰀥廴
涏	氵丿士廴
涐	氵丿扌丶
涑	氵木口󰀝
涒	氵󰁬丿口
涓	氵口月󰀝
涔	氵山人乛
涕	氵丷弓丿
涖	氵亻立󰀝
涗	氵八口儿
涘	氵厶𠂉大
涙	氵丶尸大
涚	氵丷口儿
涛	氵三丿寸
涜	氵士冖儿
涝	氵艹冖力
涞	氵一丷木
涟	氵车辶󰁶
涠	氵囗二丨
涡	氵口冂人
涢	氵口贝󰁶
涣	氵⺈ㄇ大
涤	氵夂朩󰁶
涥	氵󰁸了󰀢
润	氵门王󰀝
涧	氵门日󰀝
涨	氵弓丿󰂃
涩	氵刀丶止
涪	氵立口󰀝
涫	氵宀󰃧󰀝
涬	氵土䒑十
涭	氵爫冖又
涮	氵尸冂刂
涯	氵厂土土
涰	氵又又又
涱	氵󰀍󰀖󰁶
液	氵亠亻丶
涳	氵宀八工
涴	氵宀夕⺋
涵	氵了󰀪凵
涶	氵丿士󰁺
涷	氵木曰󰀝
涸	氵囗古󰀝
涹	氵禾女󰀝
涺	氵尸古󰀝
涻	氵人干口
涼	氵󰁸小󰁶
涽	氵󰁚󰀁日
涾	氵水日󰀝
涿	氵一󰀓丶
淀	氵宀一󰁾
淁	氵立女󰀝
淂	氵日一寸
淃	氵丷夫⺋
淄	氵巛田󰀝
淅	氵木斤󰀢
淆	氵乂月
淇	氵󰀎八󰁶
淈	氵尸凵山
淉	氵曰木󰁶
淊	氵⺈臼󰀝
淋	氵木木󰁶
淌	氵⺌冂口
淍	氵󰀼土口
淎	氵三人󰀟
淏	氵曰一大
淐	氵曰曰󰀝
淑	氵上小又
淒	氵一󰁬女
淓	氵艹方󰁥
淔	氵十󰀣󰀝
淕	氵土八土
淖	氵󰀥早󰀢
淗	氵勹米󰁶
淘	氵勹𠂉凵
淙	氵宀二小
淚	氵丶尸犬
淛	氵𠂉一刂
淜	氵月月󰀝
淝	氵月巴󰁀
淞	氵木八厶
淟	氵ㄇ󰁺八
淠	氵田一󰀯
淡	氵火火󰁶
淢	氵戈口󰀞
淣	氵臼儿󰁀
淤	氵方人󰁦
淥	氵彑氺󰁶
淦	氵金󰀝
淧	氵宀心丿
淨	氵爫󰁬亅
淩	氵土八夂
淪	氵人一艹
淫	氵爫丿士
淬	氵亠人十
淭	氵丶尸木
淮	氵亻󰁷󰀝
淯	氵亠厶月
淰	氵人丶心
深	氵冖八木
淲	氵虍几󰁀
淳	氵󰁸子󰀝
淴	氵勹󰁤心
淵	氵󰀲一󰀝
淶	氵木人人
混	氵曰󰁴匕
淸	氵冂一
淹	氵大曰乚
淺	氵戈戈󰁶
添	氵一大⺗
淼	水水水󰁧
淽	氵艹止󰀝
淾	金水󰁧
淿	氵白冂丨
渀	氵大十廾
渁	氵水水󰁶
渂	氵曰文󰁶
渃	氵艹口
渄	氵丨三三
清	氵月󰀝
渆	氵䒑廾刂
渇	氵曰勹匕
済	氵文󰀳󰀝
渉	氵止小丿
渊	氵丿米丨
渋	氵止󰀪󰁶
渌	氵󰁭氺󰁶
渍	氵贝󰁶
渎	氵十乛大
渏	氵大丁口
渐	氵车斤󰀢
渑	氵口曰乚
渒	氵白丿十
渓	氵爫夫󰁶
渔	氵󰁢一󰀝
渕	氵䒑大刂
渖	氵宀曰丨
渗	氵厶大彡
渘	氵󰁻乛木
渙	氵⺈ㄇ大
渚	氵土丿日
減	氵戊一口
渜	氵丆冂大
渝	氵人一刂
渞	氵䒑丿目
渟	氵󰁸冖丁
渠	氵匚󰁃木
渡	氵广廿又
渢	氵几丿虫
渣	氵木曰一
渤	氵十冖力
渥	氵尸一土
渦	氵ㄇ󰁈口
渧	氵亠丷丨
渨	氵田一󰀖
温	氵曰皿󰀝
渪	氵丿口丶
渫	氵廿󰄃木
測	氵貝刂󰀢
渭	氵田月󰀝
渮	氵艹丁口
港	氵󰁺八巳
渰	氵人一廾
渱	氵虫工󰀝
渲	氵宀一一
渳	氵弓耳󰀝
渴	氵曰勹󰄃
渵	氵艹田󰀝
渶	氵艹ㄇ大
渷	氵六口儿
游	氵方𠂉子
渹	氵勹言󰀝
渺	氵目小丿
渻	氵小丿目
渼	氵丷王大
渽	氵十戈口
渾	氵冖車󰀢
渿	氵木二小
湀	氵癶一大
湁	氵扌人口
湂	氵口口ㄅ
湃	氵三十
湄	氵󰁅目󰀝
湅	氵木󰀹󰀝
湆	氵立曰󰀝
湇	氵立月󰀝
湈	氵甘木󰁶
湉	氵忄丿古
湊	氵三人大
湋	氵󰁆口㐄
湌	氵人丶艮
湍	氵山丆〢
湎	氵丆囗二
湏	氵丆貝󰁶
湐	氵木白󰀝
湑	氵乛󰁾月
湒	氵口耳󰀝
湓	氵八刀皿
湔	氵䒑月刂
湕	氵󰁬󰀟廴
湖	氵古月󰀝
湗	氵土土寸
湘	氵木目󰀝
湙	氵亠󰁖大
湚	氵丿幺乚
湛	氵󰀎八󰄃
湜	氵日一󰁾
湝	氵󰁴匕白
湞	氵󰀥貝󰁶
湟	氵白王󰀝
湠	氵山火
湡	氵曰冂丶
湢	氵一口田
湣	氵󰁂󰀁日
湤	氵方𠂉也
湥	氵宀八犬
湦	氵日丿
湧	氵󰁻用力
湨	氵目犬󰁶
湩	氵丿一土
湪	氵彑󰀓󰁶
湫	氵禾火󰁶
湬	禾火水󰁧
湭	氵丷西一
湮	氵覀土󰀝
湯	氵曰一󰁤
湰	氵夂一
湱	氵三丨石
湲	氵爫一又
湳	氵十冂十
湴	氵䒑业󰀝
湵	氵丷王󰂃
湶	氵白水󰁶
湷	氵三人日
湸	氵󰁸冖几
湹	氵厂曰土
湺	氵亻口木
湻	氵󰁸曰󰀝
湼	氵臼工󰀝
湽	氵巛一田
湾	氵亠󰁗弓
湿	氵曰业󰀝
満	氵󰁺冂山
溁	氵艹冖木
溂	氵木口刂
溃	氵口丨贝
溄	氵山夂󰀟
溅	氵贝一戈
溆	氵人一又
溇	氵米女󰀝
溈	氵丶丿灬
溉	氵󰁮󰀄󰁜
溊	氵󰁃丨又
溋	氵乃又皿
溌	氵癶二儿
溍	氵一业日
溎	氵木土土
溏	氵广󰁬口
源	氵厂白小
溑	氵⺌貝󰁶
溒	氵土口󰀔
溓	氵䒑󰁬八
溔	氵丷王灬
溕	氵冖二󰀓
準	氵亻󰁷十
溗	氵禾丬匕
溘	氵土厶皿
溙	氵三人氺
溚	氵艹人口
溛	氵宀八󰂃
溜	氵󰁚丶田
溝	氵󰀀冂土
溞	氵又丶虫
溟	氵冖曰六
溠	氵⺶工󰀝
溡	氵日土寸
溢	氵䒑八皿
溣	氵亻人艹
溤	氵󰀋灬󰁶
溥	氵甫寸󰁶
溦	氵山一攵
溧	氵覀木󰁶
溨	氵十戈木
溩	氵󰁞灬󰁶
溪	氵爫幺大
溫	氵囗人皿
溬	氵⺶乚厶
溭	氵田八夂
溮	氵丿󰃧丨
溯	氵䒑凵月
溰	氵山一䒑
溱	氵三人禾
溲	氵臼丨又
溳	氵口貝󰁶
溴	氵丿目犬
溵	氵⺁彐又
溶	氵宀八口
溷	氵囗一󰀓
溸	氵幺小
溹	氵十冖小
溺	氵弓冫冫
溻	氵曰羽󰀝
溼	氵一幺土
溽	氵厂二寸
溾	氵白󰁜厶
溿	氵田丷󰀟
滀	氵亠幺田
滁	氵阝人朩
滂	氵亠丷方
滃	氵八厶羽
滄	氵人丶口
滅	氵戊一火
滆	氵一口丨
滇	氵十󰀣八
滈	氵󰁸冂口
滉	氵曰⺌儿
滊	氵气米󰁶
滋	氵䒑幺幺
滌	氵亻丨朩
滍	氵凵丨虫
滎	火火冖水
滏	氵八乂䒑
滐	氵夕㐄木
滑	氵󰀾月󰀝
滒	氵丁口口
滓	氵宀辛󰀢
滔	氵爫臼󰀝
滕	月丷夫氺
滖	氵亠口󰀔
滗	氵⺮毛󰁀
滘	氵冖八口
滙	氵匚亻󰁷
滚	氵六厶󰀔
滛	氵爫𠂉凵
滜	氵白大十
滝	氵立曰乚
滞	氵一〣丨
滟	氵三丨巴
滠	氵耳又又
满	氵艹一人
滢	氵艹冖丶
滣	氵厂二口
滤	氵虍心󰁶
滥	氵〢𠂉皿
滦	氵亠󰁗木
滧	氵六乂攵
滨	氵宀丘八
滩	氵又亻󰁷
滪	氵󰁻乛贝
滫	氵亻丨月
滬	氵丶尸巴
滭	氵曰艹󰀟
滮	氵虍几彡
滯	氵廿儿丨
滰	氵立曰儿
滱	氵宀二又
滲	氵厶厶彡
滳	氵亠丷口
滴	氵亠丷古
滵	氵宀心山
滶	氵󰁡攵
滷	氵󰀥囗󰁘
滸	氵言𠂉十
滹	氵虍丿󰀛
滺	氵亻丨心
滻	氵立丿
滼	氵木木丶
滽	氵广󰁬丨
滾	氵六口󰀔
滿	氵廿冂丶
漀	士󰁅几水
漁	氵󰁢灬󰁶
漂	氵覀二小
漃	氵宀上又
漄	氵山厂土
漅	氵巛曰木
漆	氵木人氺
漇	氵彳止󰁾
漈	氵󰁯二小
漉	氵󰁙󰁴匕
漊	氵󰀻女󰀝
漋	氵阝夂一
漌	氵廿口
漍	氵囗戈󰀞
漎	氵彳人󰁾
漏	氵尸雨󰁶
漐	土䒑十水
漑	氵白匕󰁜
漒	氵弓口虫
漓	氵亠乂厶
演	氵宀一八
漕	氵一ㄇ曰
漖	氵土丿攵
漗	氵丿囗心
漘	氵厂二月
漙	氵一曰寸
漚	氵匚口口
漛	氵丷夫氺
漜	氵木木土
漝	氵羽白󰀝
漞	氵爫目儿
漟	氵⺌冖土
漠	氵艹曰大
漡	氵𠂉曰󰁤
漢	氵廿口夫
漣	氵車辶󰁶
漤	氵木木女
漥	氵宀八土
漦	未攵厂水
漧	氵十早乙
漨	氵夂三辶
漩	氵方𠂉󰁾
漪	氵犭󰁥口
漫	氵曰罒又
漬	氵貝󰁶
漭	氵艹犬廾
漮	氵广󰁬氺
漯	氵田幺小
漰	氵山月月
漱	氵木口人
漲	氵弓󰀍󰀖
漳	氵立早󰀢
漴	氵山宀小
漵	氵人一攵
漶	氵口口心
漷	氵󰁸孑阝
漸	氵車斤󰀢
漹	氵一止灬
漺	氵大乂乂
漻	氵羽人彡
漼	氵山亻󰁷
漽	氵尸氺󰀟
漾	氵丷王󰀩
漿	爿󰁝寸水
潀	氵罒亻丶
潁	匕水丆貝
潂	氵山䒑业
潃	氵彳夂月
潄	氵木口攵
潅	氵𠂉一󰁷
潆	氵艹冖小
潇	氵艹󰁬八
潈	氵罒󰀓󰁶
潉	氵山曰󰁴
潊	氵人一又
潋	氵人一攵
潌	氵宀八土
潍	氵纟亻󰁷
潎	氵㡀攵󰁶
潏	氵󰁻乛口
潐	氵亻󰁷灬
潑	氵癶弓又
潒	氵⺈口󰀓
潓	氵一曰心
潔	氵三丨小
潕	氵𠂉一灬
潖	氵王王巴
潗	氵亻󰁷木
潘	氵丿米田
潙	氵爫丿灬
潚	氵󰁬十󰀲
潛	氵󰀄󰁜日
潜	氵夫夫曰
潝	氵人一羽
潞	氵口止口
潟	氵臼勹灬
潠	氵巳巳八
潡	氵󰁸孑攵
潢	氵󰁺由八
潣	氵門文󰁶
潤	氵門王󰀝
潥	氵覀米󰁶
潦	氵大丷小
潧	氵丷󰀺日
潨	氵丿罒乑
潩	氵田󰁺八
潪	氵𠂉大日
潫	氵丷夫小
潬	氵口口十
潭	氵覀早󰀢
潮	氵十早月
潯	氵彐工寸
潰	氵口丨貝
潱	氵士冖䒑
潲	氵禾⺌月
潳	氵尸土日
潴	氵犭󰁥日
潵	氵󰁺月攵
潶	氵󰀹土灬
潷	氵⺮󰁬󰀟
潸	氵木木月
潹	氵木木木
潺	氵尸子子
潻	氵禾人氺
潼	氵立曰土
潽	氵䒑业日
潾	氵米夕㐄
潿	氵囗󰁆㐄
澀	氵刀丶止
澁	氵止止止
澂	氵山一攵
澃	彡丆貝水
澄	氵癶一䒑
澅	氵󰁬土一
澆	氵土土儿
澇	氵火火力
澈	氵亠厶攵
澉	氵乛耳攵
澊	氵丷西寸
澋	氵曰󰁸小
澌	氵󰀎八斤
澍	氵士口寸
澎	氵士口彡
澏	氵口口山
澐	氵󰀙二厶
澑	氵一〢田
澒	氵工丆貝
澓	氵彳𠂉攵
澔	氵白丿口
澕	氵艹一󰀟
澖	氵門木󰁶
澗	氵門日󰀝
澘	氵木木曰
澙	氵臼一灬
澚	氵丿冂ㄅ
澛	氵󰁢一日
澜	氵门木󰀹
澝	氵宀心用
澞	氵虍口大
澟	氵亠囗禾
澠	氵黽󰀝
澡	氵口口木
澢	氵⺌冖田
澣	氵十早干
澤	氵罒土十
澥	氵⺈用󰀟
澦	氵󰁻乛貝
澧	氵ㄇ󰁺䒑
澨	氵⺮工人
澩	󰀗乂乂水
澪	氵󰀙人󰁻
澫	氵艹曰丶
澬	氵冫⺈貝
澭	氵亠󰁲󰁷
澮	氵人一日
澯	氵󰀥夕米
澰	氵人一人
澱	氵尸󰁺又
澲	氵业䒑未
澳	氵丿ㄇ大
澴	氵罒一󰀔
澵	氵立朩斤
澶	氵亠囗一
澷	氵曰罒方
澸	氵戊一心
澹	氵⺈厂言
澺	氵立曰心
澻	氵䒑󰀓辶
澼	氵尸口辛
澽	氵虍一󰀓
澾	氵土羊辶
澿	氵木木小
激	氵白方攵
濁	氵罒勹虫
濂	氵广䒑八
濃	氵ㄇ󰁺󰀖
濄	氵ㄇ󰁈辶
濅	氵宀彐又
濆	氵十艹貝
濇	氵土人口
濈	氵口耳丶
濉	氵目亻󰁷
濊	氵止戊󰀤
濋	氵木木󰁾
濌	丿一曰日
濍	氵艹勹心
濎	氵目󰁕󰁈
濏	氵王王丿
濐	氵曰土日
濑	氵木口贝
濒	氵止󰀤贝
濓	氵立丿八
濔	氵一八乂
濕	氵日幺灬
濖	氵罒土日
濗	氵艹曰丨
濘	氵宀心丁
濙	氵火火火
濚	氵火火木
濛	氵艹冖󰀓
濜	氵󰁬丨皿
濝	氵󰀎八小
濞	氵丿目󰀯
濟	氵󰀴󰀳󰀝
濠	氵󰁸冖󰀓
濡	氵󰀙丆〢
濢	氵羽亠十
濣	氵十早十
濤	氵士乛寸
濥	氵夕宀八
濦	氵爫工心
濧	氵业丷寸
濨	氵䒑幺心
濩	氵艹亻又
濪	氵月巴
濫	氵匚丨皿
濬	氵󰀥冖目
濭	氵艹土皿
濮	氵亻业夫
濯	氵羽亻󰁷
濰	氵糹亻󰁷
濱	氵宀一貝
濲	氵士冖又
濳	氵丿土日
濴	氵火火水
濵	氵宀󰁅貝
濶	氵門丿古
濷	水氵廿丶
濸	氵艹人口
濹	氵曰土土
濺	氵貝戈戈
濻	氵阝口貝
濼	氵白幺木
濽	氵夫夫貝
濾	氵虍田心
濿	氵厂艹丶
瀀	氵丆󰀐夂
瀁	氵䒑夫艮
瀂	氵󰁢灬日
瀃	氵貝曰󰁤
瀄	氵⺮󰁮卩
瀅	氵火火丶
瀆	氵士罒貝
瀇	氵广󰁺八
瀈	氵羽冖車
瀉	氵宀臼灬
瀊	氵丿󰁪皿
瀋	氵宀丿田
瀌	氵󰁙󰁴灬
瀍	氵广曰土
瀎	氵艹罒人
瀏	氵󰁚丶刂
瀐	氵十戈󰀞
瀑	氵曰󰁺氺
瀒	氵木人口
瀓	氵彳山攵
瀔	氵士冖又
瀕	氵止󰀤貝
瀖	氵󰀙亻󰁷
瀗	氵宀三心
瀘	氵虍田皿
瀙	氵立朩儿
瀚	氵十早羽
瀛	氵󰄹月丶
瀜	氵一口虫
瀝	氵厂禾止
瀞	氵月亅
瀟	氵艹󰁬󰀲
瀠	氵火火小
瀡	氵阝辶
瀢	氵口丨辶
瀣	氵󰀥夕一
瀤	氵亠罒󰀔
瀥	氵羽󰁸口
瀦	氵一󰀓日
瀧	氵立月三
瀨	氵木口貝
瀩	氵禾几貝
瀪	𠂉母攵水
瀫	氵士冖又
瀬	氵木口貝
瀭	氵車人刂
瀮	氵󰀙木木
瀯	氵火火口
瀰	氵弓一乂
瀱	氵罒厂刂
瀲	氵人一攵
瀳	氵艹󰁙灬
瀴	氵貝貝女
瀵	氵米田八
瀶	氵匚丨口
瀷	氵羽田八
瀸	氵人人󰀞
瀹	氵人一艹
瀺	氵⺈口丶
瀻	氵十戈八
瀼	氵亠口󰀔
瀽	氵宀󰀀󰁾
瀾	氵門木󰀹
瀿	氵𠂉母小
灀	氵󰀙木目
灁	氵門白水
灂	氵爫罒寸
灃	氵山三䒑
灄	氵耳耳耳
灅	氵田田土
灆	氵艹匚皿
灇	氵业䒑又
灈	氵目目󰁷
灉	氵巛口󰁷
灊	氵󰀄󰁜丨
灋	氵󰁙一厶
灌	氵艹口󰁷
灍	氵門䒑人
灎	氵ㄇ󰁺皿
灏	氵曰󰁸贝
灐	氵火火金
灑	氵一ㄇ匕
灒	氵丿土貝
灓	言糹糹水
灔	氵ㄇ󰁺巴
灕	氵亠乂󰁷
灖	氵广木三
灗	氵虫亠一
灘	氵廿口󰁷
灙	氵⺌冖灬
灚	氵󰀗乂儿
灛	氵門口十
灜	氵󰄹月丶
灝	氵曰󰁸貝
灞	氵󰀙廿月
灟	氵尸氺虫
灠	氵匚丨儿
灡	氵艹門󰀹
灢	氵一口󰀔
灣	氵言糹弓
灤	氵言糹木
灥	白水白水
灦	氵日幺貝
灧	氵山三巴
灨	氵立早貝
灩	氵山三皿
灪	氵木𠂉彡
火	火火火火
灬	灬丶丶丶
灭	一火󰀦
灮	火儿󰀅
灯	火丁󰀢
灰	火󰁧
灱	火刀󰁥
灲	火刂󰀢
灳	勹火󰀦
灴	火工󰀝
灵	彐火󰁧
灶	火土󰀝
灷	火廾󰀬
灸	ク󰂃火󰁧
灹	火丿七󰁀
灺	火也󰁀
灻	土火󰁧
灼	火勹丶󰁶
災	巛火󰁧
灾	宀火󰁧
灿	火山󰀢
炀	火ㄋ󰁤󰁥
炁	󰀄󰁜灬󰁧
炂	火八厶󰁶
炃	八刀火󰁧
炄	火󰁈丨一
炅	曰火󰁧
炆	火文󰁶
炇	火攵󰁶
炈	火几又󰁶
炉	火丶尸󰁥
炊	火⺈人󰁶
炋	火丆卜󰁶
炌	火人󰀯󰀢
炍	火⺁又󰁶
炎	火火󰁧
炏	火火󰁶
炐	火三丨󰀢
炑	火木󰁶
炒	火小丿󰁥
炓	火󰁦十󰀢
炔	火ユ人󰁶
炕	火亠几󰁀
炖	火一凵乚
炗	廿火󰁧
炘	火斤󰀢
炙	󰁝火󰁧
炚	日火󰁶
炛	火亻ヒ󰀅
炜	火二𠃌丨
炝	火人⺋󰁀
炞	火亠卜󰁶
炟	火日一󰀝
炠	火甲󰀢
炡	火一止󰀝
炢	火木丶󰁶
炣	火丁口󰀝
炤	火刀口󰀝
炥	火弓󰀯󰀢
炦	火又丶
炧	火𠂉也󰁀
炨	火宀匕󰁀
炩	火人丶󰁻
炪	火凵山󰀢
炫	火亠幺󰁶
炬	火匚󰁃󰀝
炭	山火󰁧
炮	火勹巳󰁀
炯	火冂口󰀝
炰	勹巳灬󰁧
炱	厶口火󰁧
炲	火厶口󰀝
炳	火一冂人
炴	火ㄇ大󰁶
炵	火夂󰁦󰁶
炶	火󰀥口󰀝
炷	火丶王󰀝
炸	火𠂉丨二
点	󰀥口灬󰁧
為	丶丿乛灬
炻	火石󰀝
炼	火󰀂𠃌八
炽	火口八󰁶
炾	火口儿󰁀
炿	火丿󰀼亠
烀	火丿丷󰀛
烁	火丿󰄃小
烂	火丷三󰀝
烃	火ス工󰀝
烄	火六乂󰁶
烅	火丿皿󰀝
烆	火彳一丁
烇	火人王󰀝
烈	一夕刂灬
烉	⺈ㄇ八火
烊	火羊󰀢
烋	亻木灬󰁧
烌	火亻木󰁶
烍	火丿土儿
烎	一廾火󰁧
烏	󰁞灬󰀦
烐	火丿󰁪󰁶
烑	火儿󰀪󰁶
烒	火󰀁工丶
烓	火土土󰀝
烔	火冂一口
烕	戊一火󰀦
烖	十戈火󰀦
烗	火亠ㄥ人
烘	火󰁺八󰁶
烙	火夂口󰀝
烚	火人一口
烛	火虫󰁶
烜	火一曰一
烝	了󰀩一灬
烞	火木卜󰁶
烟	火囗大󰁶
烠	火月󰀝
烡	火󰁺八󰁧
烢	火宀丿七
烣	火火󰁶
烤	火土丿ㄅ
烥	火匚丨丨
烦	火丆贝󰁶
烧	火󰀁丿儿
烨	火亻ヒ十
烩	火人二厶
烪	火䒑大󰁶
烫	氵ㄋ󰁤火
烬	火尸󰂃󰁦
热	扌九丶灬
烮	一夕刂火
烯	火乂丨
烰	火爫子󰀝
烱	火冂八口
烲	扌斤火󰁧
烳	火甫󰁶
烴	火一巛工
烵	火艹勹丶
烶	火丿士廴
烷	火宀二儿
烸	火𠂉母󰁶
烹	󰁸了灬󰁧
烺	火丶艮󰁶
烻	火丿󰀥廴
烼	火一󰀓󰁶
烽	火夂三丨
烾	火火土󰀘
烿	火󰀼亠彡
焀	火八人口
焁	口⺈人火
焂	亻丨攵火
焃	火土󰁖󰁶
焄	󰁬丿口灬
焅	火丿土口
焆	火口月󰀝
焇	火⺌月󰀝
焈	丶尸巳火
焉	一止一灬
焊	火曰干󰀢
焋	爿士火󰁧
焌	火厶八夂
焍	火丷弓丿
焎	扌斤灬󰁧
焏	了口又灬
焐	火五口󰀝
焑	火囗木󰁶
焒	火口口󰀝
焓	火人丶口
焔	火󰁡丨日
焕	火⺈ㄇ大
焖	火门心󰁶
焗	火尸𠃌口
焘	三丿寸灬
焙	火立口󰀝
焚	木木火󰁧
焛	門火󰀦
焜	火曰󰁴匕
焝	火󰁚󰀁日
焞	火󰁸子󰀝
焟	火󰁺日󰀝
焠	火亠人十
無	𠂉一󰀷灬
焢	火宀八工
焣	耳又灬󰁧
焤	广亻寸火
焥	火宀夕⺋
焦	亻󰁷灬󰁧
焧	火八厶心
焨	火日月󰀝
焩	火月月󰀝
焪	火宀八弓
焫	火艹冂人
焬	火曰勹󰁤
焭	火火冖几
焮	火斤⺈人
焯	火󰀥早󰀢
焰	火⺈臼󰀝
焱	火火火󰁧
焲	火亠亻丶
焳	火亻󰁷󰀝
焴	火亠厶月
焵	火冂䒑山
然	󰁝犬灬󰁧
焷	火白丿十
焸	日日火󰁧
焹	火冂䒑󰄃
焺	火曰丿廾
焻	火日曰󰀝
焼	火十艹儿
焽	日月火󰁧
焾	火人丶乛
焿	火广󰁬人
煀	火尸凵山
煁	火󰀎八󰄃
煂	火廿󰀜󰀢
煃	火大土土
煄	火丿一土
煅	火丿丨又
煆	火󰁃丨又
煇	火冖車󰀢
煈	火几丿虫
煉	火木󰀹󰀝
煊	火宀一一
煋	火曰丿
煌	火白王󰀝
煍	火禾火󰁶
煎	䒑月刂灬
煏	火一口田
煐	火艹ㄇ大
煑	土丿曰火
煒	火󰁆口㐄
煓	火山丆〢
煔	火火󰀥口
煕	匚丨󰁕灬
煖	火爫一又
煗	火丆冂大
煘	火戊一口
煙	火覀土󰀝
煚	日匚󰁃火
煛	目目火󰁧
煜	火曰立󰀝
煝	火󰁅目󰀝
煞	⺈彐攵灬
煟	火田月󰀝
煠	火廿󰄃木
煡	火󰁬󰀟廴
煢	火火冖十
煣	火󰁻乛木
煤	火甘木󰁶
煥	火⺈ㄇ大
煦	日勹口灬
照	日刀口灬
煨	火田一󰀖
煩	火丆貝󰁶
煪	火丷西一
煫	火䒑󰀓󰁶
煬	火日一󰁤
煭	灬一夕灬
煮	土丿曰灬
煯	火󰁴匕白
煰	火口口口
煱	火ㄇ󰁈口
煲	亻口木火
煳	火古月󰀝
煴	火日皿󰀝
煵	火十冂十
煶	火曰一󰁾
煷	火󰁸冖几
煸	火丶尸艹
煹	火󰀀冂土
煺	火艮辶󰁶
煻	火广󰁬口
煼	火勹凵丿
煽	火丶尸羽
煾	火囗大心
煿	火甫寸󰁶
熀	火日⺌儿
熁	火力力月
熂	火气米󰁶
熃	󰁻乛亅火
熄	火丿目心
熅	火囗人皿
熆	火土厶皿
熇	火󰁸冂口
熈	丿匚丨灬
熉	火口貝󰁶
熊	厶月匕灬
熋	厶月匕火
熌	火門人󰁶
熍	火宀口口
熎	火爫𠂉凵
熏	丿一󰀹灬
熐	火冖日六
熑	火䒑󰁬八
熒	火火冖火
熓	火󰁞灬󰁶
熔	火宀八口
熕	火工貝󰁶
熖	火爫臼󰀝
熗	火人丶口
熘	火󰁚丶田
熙	匚丨口灬
熚	火曰艹󰀟
熛	火覀二小
熜	火丿囗心
熝	火󰁙󰁴匕
熞	火匚丨土
熟	󰁸孑九灬
熠	火羽白󰀝
熡	火󰀻女󰀝
熢	火夂三辶
熣	火山亻󰁷
熤	火羽立󰀝
熥	火󰁻用辶
熦	火小亻󰁷
熧	彳人人火
熨	尸二小火
熩	火丶尸巴
熪	火禾夕夕
熫	火广廿灬
熬	󰁡攵灬
熭	三丨三火
熮	火羽人彡
熯	火廿口夫
熰	火匚口口
熱	土八土灬
熲	匕火丆貝
熳	火曰罒又
熴	火山曰󰁴
熵	火亠丷口
熶	火曰耳又
熷	火丷󰀺日
熸	火󰀄󰁜日
熹	士口䒑灬
熺	火士口口
熻	火人一羽
熼	火田󰁺八
熽	火󰁬十󰀲
熾	火亠丷日
熿	火󰁺由八
燀	火口口十
燁	火艹一󰀟
燂	火覀早󰀢
燃	火󰁝犬灬
燄	⺈臼火火
燅	土八土火
燆	火丿大口
燇	火丷西寸
燈	火癶一䒑
燉	火󰁸孑攵
燊	火火火木
燋	火亻󰁷灬
燌	火十艹貝
燍	火󰀎八斤
燎	火大丷小
燏	火󰁻乛口
燐	火米夕㐄
燑	火立曰土
燒	火土土儿
燓	木乂乂火
燔	火丿米田
燕	廿口丬灬
燖	火彐工寸
燗	火門月󰀝
燘	火門文󰁶
燙	氵曰一火
燚	火火火火
燛	󰁃丨匚火
燜	火門心󰁶
燝	火曰󰁸小
燞	亻󰁷⺈灬
營	火火冖口
燠	火丿ㄇ大
燡	火罒土十
燢	󰀗乂乂火
燣	火亠囗禾
燤	火艹曰丶
燥	火口口木
燦	火󰀥夕米
燧	火䒑󰀓辶
燨	火丷王丶
燩	火白方攵
燪	火艹勹心
燫	火广䒑八
燬	火臼工又
燭	火罒勹虫
燮	言火火又
燯	火󰀙人󰁻
燰	火爫冖夂
燱	火立曰心
燲	火力力貝
燳	火日刀灬
燴	火人一日
燵	火土羊辶
燶	火ㄇ󰁺󰀖
燷	火亠囗小
燸	火󰀙丆〢
燹	一󰀓一火
燺	火󰁸冂木
燻	火丿一灬
燼	火󰁬丨皿
燽	火士乛寸
燾	士乛工灬
燿	火羽亻󰁷
爀	火土󰁖󰁖
爁	火匚丨皿
爂	󰀗ㄇ一火
爃	火火火木
爄	火厂艹丶
爅	火󰀹土土
爆	火曰󰁺氺
爇	艹土八灬
爈	火虍田心
爉	火巛囗󰁒
爊	火󰁙󰁴灬
爋	火丿一力
爌	火广󰁺八
爍	火白幺木
爎	火宀大小
爏	火厂禾止
爐	火虍田皿
爑	火艹亻灬
爒	󰁝火大小
爓	火門⺈臼
爔	火丷王丶
爕	言火火火
爖	火立月三
爗	火曰艹一
爘	火󰀥夕艮
爙	火亠口󰀔
爚	火人一艹
爛	火門木󰀹
爜	火业䒑又
爝	火爫罒寸
爞	火虫虫虫
爟	火艹口󰁷
爠	火目目󰁷
爡	火艹曰虫
爢	广木木灬
爣	火⺌冖灬
爤	火艹門󰀹
爥	火尸氺虫
爦	火匚丨儿
爧	火󰀙口人
爨	󰀗ㄇ一火
爩	火木𠂉彡
爪	⺁丨󰂃󰀦
爫	爫丿丶丿
爬	⺁丨󰂃巴
爭	爫󰁬亅󰀬
爮	⺁丨󰂃巳
爯	爫冂土󰀘
爰	爫一又
爱	爫冖又
爲	爫丿乛灬
爳	爫丿乛了
爴	囗戈口󰂃
爵	爫罒󰁮寸
父	八乂󰁧
爷	八乂卩󰀬
爸	八乂巴󰀅
爹	八乂夕夕
爺	八乂耳阝
爻	乂乂󰁧
爼	乂乂󰀐一
爽	大乂乂乂
爾	一八冂乂
爿	爿󰄃丨丿
牀	爿木󰁶
牁	爿丁口󰀝
牂	爿羊󰀢
牃	爿廿󰄃木
牄	爿人丶口
牅	爿广󰁬丨
牆	爿土人口
片	丿丨一󰁈
版	丿丨一又
牉	丿丨一󰀟
牊	丿丨一口
牋	丿丨一戈
牌	丿丨一十
牍	丿丨一大
牎	丿丨一󰁈
牏	丿丨一刂
牐	丿丨一臼
牑	丿丨一艹
牒	丿丨一木
牓	丿丨一方
牔	丿丨一寸
牕	丿丨一󰁈
牖	丿丨一甫
牗	丿丨一丨
牘	丿丨一貝
牙	󰀄亅丿󰀏
牚	⺌冖口丿
牛	丿󰀟󰀵
牜	牜丿一󰀞
牝	牜匕󰁀
牞	牜力󰁥
牟	厶丿󰀟󰀬
牠	牜也󰁀
牡	牜土󰀝
牢	宀丿󰀟󰀬
牣	牜刀丶󰁶
牤	牜亠󰄃󰁀
牥	牜方󰁥
牦	牜毛󰁀
牧	牜攵󰁶
牨	牜亠几󰁀
物	牜勹󰁤󰁥
牪	牜丿󰀟󰀢
牫	牜戈󰁶
牬	牜丿ㄅ丿
牭	牜四󰀝
牮	亻󰀁丶󰀟
牯	牜古󰀝
牰	牜由󰀝
牱	牜丁口󰀝
牲	牜丿󰀝
牳	牜母󰁶
牴	牜󰁚󰀁丶
牵	大冖丿󰀟
牶	丷夫丿󰀟
牷	牜人王󰀝
牸	牜宀子󰀝
特	牜土寸󰁶
牺	牜西󰀝
牻	牜乚丶
牼	牜一巛工
牽	亠幺冖󰀟
牾	牜五口󰀝
牿	牜丿土口
犀	尸氺丿󰀟
犁	禾刂丿󰀟
犂	禾勹丿󰀟
犃	牜立口󰀝
犄	牜大丁口
犅	牜冂䒑山
犆	牜十󰀣󰀝
犇	丿󰀟牜󰀟
犈	牜丷夫⺋
犉	牜󰁸子󰀝
犊	牜十乛大
犋	牜󰀣八󰁶
犌	牜󰁃丨又
犍	牜󰁬󰀟廴
犎	土土寸󰀟
犏	牜丶尸艹
犐	牜禾󰁦十
犑	牜目犬󰁶
犒	牜󰁸冂口
犓	牜勹凵丿
犔	牜气米󰁶
犕	牜󰁺丿用
犖	火火冖󰀟
犗	牜宀三口
犘	广木木󰀟
犙	牜厶厶彡
犚	尸二小󰀟
犛	未攵厂󰀟
犜	牜󰁸孑攵
犝	牜立曰土
犞	牜丿大口
犟	弓口虫󰀟
犠	牜丷王丶
犡	牜厂艹丶
犢	牜士罒貝
犣	牜巛囗󰁒
犤	牜罒厶匕
犥	牜󰁙󰁴灬
犦	牜曰󰁺氺
犧	牜丷王丶
犨	亻󰁷亻󰀟
犩	禾女白󰀟
犪	牜䒑丿夂
犫	亻󰁷言󰀟
犬	犬一丿丶
犭	犭󰁥丿丿
犮	又丶󰀦
犯	犭󰁥⺋󰁀
犰	犭󰁥九󰁀
犱	犭󰁥九丶
犲	犭󰁥󰀛丿
犳	犭󰁥勹丶
犴	犭󰁥干󰀢
犵	犭󰁥𠂉乙
状	丬犬󰁶
犷	犭󰁥广󰁥
犸	犭󰁥󰀊一
犹	犭󰁥丶
犺	犭󰁥亠几
犻	犭󰁥一丨
犼	犭󰁥孑乚
犽	犭󰁥󰀄丿
犾	犭󰁥犬󰁶
犿	犭󰁥亠卜
狀	爿犬󰁶
狁	犭󰁥厶儿
狂	犭󰁥王󰀝
狃	犭󰁥󰁈一
狄	犭󰁥火󰁶
狅	犭󰁥丿士
狆	犭󰁥口丨
狇	犭󰁥木󰁶
狈	犭󰁥贝󰁶
狉	犭󰁥丆一
狊	目犬󰁧
狋	犭󰁥二小
狌	犭󰁥丿
狍	犭󰁥勹巳
狎	犭󰁥甲󰀢
狏	犭󰁥𠂉也
狐	犭󰁥⺁󰂃
狑	犭󰁥人󰁻
狒	犭󰁥弓󰀯
狓	犭󰁥皮󰁶
狔	犭󰁥尸匕
狕	犭󰁥幺力
狖	犭󰁥宀八
狗	犭󰁥勹口
狘	犭󰁥戈󰁐
狙	犭󰁥󰀐一
狚	犭󰁥日一
狛	犭󰁥白󰀝
狜	犭󰁥古󰀝
狝	犭󰁥⺈小
狞	犭󰁥宀丁
狟	犭󰁥一一
狠	犭󰁥艮󰁶
狡	犭󰁥六乂
狢	犭󰁥夂口
狣	犭󰁥儿󰀪
狤	犭󰁥士口
狥	犭󰁥勹日
狦	犭󰁥冂〢
狧	犭󰁥丿古
狨	犭󰁥戈
狩	犭󰁥宀寸
狪	犭󰁥冂口
狫	犭󰁥土匕
独	犭󰁥虫󰁶
狭	犭󰁥一大
狮	犭󰁥リ丨
狯	犭󰁥人厶
狰	犭󰁥⺈亅
狱	犭󰁥讠犬
狲	犭󰁥孑小
狳	犭󰁥人朩
狴	犭󰁥󰁴土
狵	犭󰁥丶
狶	犭󰁥乂丨
狷	犭󰁥口月
狸	犭󰁥曰土
狹	犭󰁥大人
狺	犭󰁥言󰀝
狻	犭󰁥厶夂
狼	犭󰁥丶艮
狽	犭󰁥貝󰁶
狾	犭󰁥扌斤
狿	犭󰁥丿廴
猀	犭󰁥氵丿
猁	犭󰁥禾刂
猂	犭󰁥曰干
猃	犭󰁥人一
猄	犭󰁥󰁸小
猅	犭󰁥丨三
猆	丨三丨三
猇	犭󰁥虍几
猈	犭󰁥白十
猉	犭󰁥󰀎八
猊	犭󰁥臼儿
猋	犬犬犬󰁧
猌	木人人犬
猍	犭󰁥木人
猎	犭󰁥󰁺曰
猏	犭󰁥丶月
猐	犭󰁥⺶乚
猑	犭󰁥曰匕
猒	曰月犬󰁶
猓	犭󰁥曰木
猔	犭󰁥宀小
猕	犭󰁥弓小
猖	犭󰁥曰曰
猗	犭󰁥大口
猘	犭󰁥𠂉刂
猙	犭󰁥爫亅
猚	犭󰁥亻󰁷
猛	犭󰁥子皿
猜	犭󰁥月
猝	犭󰁥亠十
猞	犭󰁥人口
猟	犭󰁥󰀧󰀟
猠	犭󰁥ㄇ八
猡	犭󰁥罒夕
猢	犭󰁥古月
猣	犭󰁥乂夂
猤	犭󰁥癶大
猥	犭󰁥田󰀖
猦	犭󰁥几虫
猧	犭󰁥ㄇ口
猨	犭󰁥爫又
猩	犭󰁥曰
猪	犭󰁥土日
猫	犭󰁥艹田
猬	犭󰁥田月
猭	犭󰁥彑󰀓
献	十冂䒑犬
猯	犭󰁥山〢
猰	犭󰁥三大
猱	犭󰁥󰁻木
猲	犭󰁥日󰄃
猳	犭󰁥󰁃又
猴	犭󰁥亻大
猵	犭󰁥丶艹
猶	犭󰁥丷一
猷	丷西一犬
猸	犭󰁥󰁅目
猹	犭󰁥木一
猺	犭󰁥爫凵
猻	犭󰁥孑小
猼	犭󰁥甫寸
猽	犭󰁥冖六
猾	犭󰁥󰀾月
猿	犭󰁥土󰀔
獀	犭󰁥臼又
獁	犭󰁥󰀋灬
獂	犭󰁥厂小
獃	山一口犬
獄	犭󰁥言犬
獅	犭󰁥丿丨
獆	犭󰁥白十
獇	犭󰁥⺶厶
獈	犭󰁥䒑皿
獉	犭󰁥三禾
獊	犭󰁥人口
獋	犭󰁥丿十
獌	犭󰁥曰又
獍	犭󰁥立儿
獎	爿󰁝寸犬
獏	犭󰁥艹大
獐	犭󰁥立早
獑	犭󰁥車斤
獒	󰁡攵犬
獓	犭󰁥攵
獔	犭󰁥白十
獕	犭󰁥山󰁷
獖	犭󰁥十貝
獗	犭󰁥厂人
獘	㡀攵犬󰁧
獙	犭󰁥㡀攵
獚	犭󰁥󰁺八
獛	犭󰁥业夫
獜	犭󰁥米㐄
獝	犭󰁥󰁻口
獞	犭󰁥立土
獟	犭󰁥土儿
獠	犭󰁥大小
獡	犭󰁥臼灬
獢	犭󰁥丿口
獣	󰀧田一犬
獤	犭󰁥󰁸攵
獥	犭󰁥白攵
獦	犭󰁥艹󰄃
獧	犭󰁥罒󰀔
獨	犭󰁥罒虫
獩	犭󰁥止󰀤
獪	犭󰁥人日
獫	犭󰁥人人
獬	犭󰁥⺈󰀟
獭	犭󰁥木贝
獮	犭󰁥一乂
獯	犭󰁥丿灬
獰	犭󰁥宀丁
獱	犭󰁥宀貝
獲	犭󰁥艹又
獳	犭󰁥󰀙〢
獴	犭󰁥艹󰀓
獵	犭󰁥巛󰁒
獶	犭󰁥丆夂
獷	犭󰁥广八
獸	口口田犬
獹	犭󰁥虍田
獺	犭󰁥木貝
獻	虍一口犬
獼	犭󰁥弓乂
獽	犭󰁥亠󰀔
獾	犭󰁥艹󰁷
獿	犭󰁥丆夂
玀	犭󰁥罒󰁷
玁	犭󰁥口攵
玂	犭󰁥艹斤
玃	犭󰁥目又
玄	亠幺󰁧
玅	亠幺小丿
玆	亠幺亠幺
率	亠幺󰀪十
玈	亠幺𠂉󰀕
玉	王丶󰀦
玊	王丶󰀦
王	王王王王
玌	王乚󰁀
玍	𠂉土󰀘
玎	王丁󰀢
玏	王力󰁥
玐	王八󰁶
玑	王几󰁀
玒	王工󰀝
玓	王勹丶󰁶
玔	王川󰀢
玕	王干󰀢
玖	王ク󰂃󰁶
玗	王一󰀛󰀢
玘	王己󰁀
玙	王一ㄅ一
玚	王ㄋ󰁤󰁥
玛	王󰀊一󰀝
玜	王八厶󰁶
玝	王𠂉十󰀢
玞	王夫󰁶
玟	王文󰁶
玠	王人󰀯󰀢
玡	王󰀄亅丿
玢	王八刀󰁥
玣	王亠卜󰁶
玤	王三丨󰀢
玥	王月󰀝
玦	王ユ人󰁶
玧	王厶儿󰁀
玨	王王󰀝
玩	王二儿󰁀
玪	王人丶乛
玫	王攵󰁶
玬	王󰀼亠󰀝
玭	王󰁴匕󰁀
玮	王二𠃌丨
环	王丆卜󰁶
现	王ㄇ󰁜󰁀
玱	王人⺋󰁀
玲	王人丶󰁻
玳	王亻󰀁丶
玴	王廿󰄃󰁀
玵	王甘󰀝
玶	王一丷十
玷	王󰀥口󰀝
玸	王勹巳󰁀
玹	王亠幺󰁶
玺	⺈小王丶
玻	王皮󰁶
玼	王止匕󰁀
玽	王勹口󰀝
玾	王甲󰀢
玿	王刀口󰀝
珀	王白󰀝
珁	王一󰁐丶
珂	王丁口󰀝
珃	王冂土󰀝
珄	王丿󰀝
珅	王曰丨󰀢
珆	王厶口󰀝
珇	王󰀐一󰀝
珈	王力口󰀝
珉	王󰁂󰀁󰁀
珊	王󰀼󰀼一
珋	王󰁚丿卩
珌	王心丿󰁥
珍	王人彡󰁥
珎	王⺈小󰁶
珏	王王丶󰁶
珐	王土厶󰁶
珑	王ヒ丶
珒	王󰁬󰀟󰀢
珓	王六乂󰁶
珔	王丨子
珕	王力力力
珖	王⺌一儿
珗	王丿土儿
珘	王丿󰁪󰁶
珙	王󰁺八󰁶
珚	王囗大󰁶
珛	王月󰀝
珜	王羊󰀢
珝	王羽󰀝
珞	王夂口󰀝
珟	王几一夕
珠	王丿未󰁶
珡	王王人󰁧
珢	王艮󰁶
珣	王勹日󰀝
珤	王𠂉十凵
珥	王耳󰀝
珦	王丿冂口
珧	王儿󰀪󰁶
珨	王人一口
珩	王彳一丁
珪	王土土󰀝
珫	王亠厶儿
珬	王戊一󰀝
班	王丶丿王
珮	王几一丨
珯	王土丿匕
珰	王⺌彐󰀝
珱	王󰀧女󰀝
珲	王冖车󰀢
珳	王文彡󰁥
珴	王丿扌丶
珵	王口王󰀝
珶	王丷弓丿
珷	王一󰀁丶
珸	王五口󰀝
珹	王戊𠃌󰁀
珺	王󰁬丿口
珻	王𠂉母󰁶
珼	王貝󰁶
珽	王丿士廴
現	王目儿󰁀
珿	王口󰁾󰁶
琀	王人丶口
琁	王𠂉乛󰁾
琂	王言󰀝
球	王一氺丶
琄	王口月󰀝
琅	王丶艮󰁶
理	王曰土󰀝
琇	王禾乃󰁥
琈	王爫子󰀝
琉	王亠厶󰀸
琊	王󰀄亅阝
琋	王乂丨
琌	王山人乛
琍	王禾刂󰀢
琎	王二󰀯辶
琏	王车辶󰁶
琐	王⺌贝󰁶
琑	王⺌月󰀝
琒	王夂三丨
琓	王宀二儿
琔	王宀一󰁾
琕	王白丿十
琖	王戈戈󰁶
琗	王亠人十
琘	王󰁚󰀁日
琙	王戈口󰀞
琚	王尸古󰀝
琛	王冖八木
琜	王木人人
琝	王日文󰁶
琞	日月王丶
琟	王亻󰁷󰀝
琠	王ㄇ󰁺八
琡	王上小又
琢	王一󰀓丶
琣	王立口󰀝
琤	王⺈󰁬亅
琥	王虍几󰁀
琦	王大丁口
琧	一󰀚一丶
琨	王曰󰁴匕
琩	王日曰󰀝
琪	王󰀎八󰁶
琫	王三人󰀟
琬	王宀夕⺋
琭	王󰁭氺󰁶
琮	王宀二小
琯	王宀󰃧󰀝
琰	王火火󰁶
琱	王󰀼土口
琲	王丨三三
琳	王木木󰁶
琴	王王人乛
琵	王王󰁴匕
琶	王王巴󰀅
琷	王⺶乚󰁀
琸	王󰀥早󰀢
琹	王王木󰁧
琺	王氵土厶
琻	王金󰀝
琼	王󰁸小󰁶
琽	王土丿日
琾	王田人󰀯
琿	王冖車󰀢
瑀	王丿口丶
瑁	王󰀰目󰀝
瑂	王󰁅目󰀝
瑃	王三人日
瑄	王宀一一
瑅	王日一󰁾
瑆	王日丿
瑇	王母󰁶
瑈	王󰁻乛木
瑉	王󰁂󰀁日
瑊	王戊一口
瑋	王󰁆口㐄
瑌	王丆冂大
瑍	王⺈ㄇ大
瑎	王󰁴匕白
瑏	王宀八丿
瑐	王䒑月刂
瑑	王彑󰀓󰁶
瑒	王日一󰁤
瑓	王木󰀹󰀝
瑔	王白水󰁶
瑕	王󰁃丨又
瑖	王丿丨又
瑗	王爫一又
瑘	王耳阝󰀢
瑙	王巛丿乂
瑚	王古月󰀝
瑛	王艹ㄇ大
瑜	王人一刂
瑝	王白王󰀝
瑞	王山丆〢
瑟	王王心丿
瑠	王󰁚丶田
瑡	王丿󰃧丨
瑢	王宀八口
瑣	王⺌貝󰁶
瑤	王󰁝𠂉凵
瑥	王日皿󰀝
瑦	王󰁞灬󰁶
瑧	王三人禾
瑨	王一业日
瑩	火火冖丶
瑪	王󰀋灬󰁶
瑫	王爫臼󰀝
瑬	氵亠厶丶
瑭	王广󰁬口
瑮	王覀木󰁶
瑯	王丶󰁮阝
瑰	王白󰁜厶
瑱	王十󰀣八
瑲	王人丶口
瑳	王⺶工󰀝
瑴	士冖一又
瑵	王又丶虫
瑶	王爫𠂉凵
瑷	王爫冖又
瑸	王宀丘八
瑹	王艹人朩
瑺	王⺌冖丨
瑻	王毌貝󰁶
瑼	王一曰寸
瑽	王彳人󰁾
瑾	王廿口
瑿	匚𠂉大丶
璀	王山亻󰁷
璁	王丿囗心
璂	王󰀎八土
璃	王亠乂厶
璄	王立曰儿
璅	王巛曰木
璆	王羽人彡
璇	王方𠂉󰁾
璈	王󰁡攵
璉	王車辶󰁶
璊	王廿冂丶
璋	王立早󰀢
璌	王宀一八
璍	王艹一󰀟
璎	王贝贝女
璏	王彑󰁴匕
璐	王口止口
璑	王𠂉一灬
璒	王癶一䒑
璓	王艹禾乃
璔	王丷󰀺日
璕	王彐工寸
璖	王氵匚木
璗	氵曰一丶
璘	王米夕㐄
璙	王大丷小
璚	王󰁻乛口
璛	王󰁬十󰀲
璜	王󰁺由八
璝	王口丨貝
璞	王业䒑夫
璟	王曰󰁸小
璠	王丿米田
璡	王亻󰁷辶
璢	王一〢田
璣	王幺幺人
璤	王一曰心
璥	王艹勹攵
璦	王爫冖夂
璧	尸口辛丶
璨	王󰀥夕米
璩	王虍一󰀓
璪	王口口木
璫	王⺌冖田
璬	王白方攵
璭	王冖車辶
璮	王亠囗一
璯	王人一日
環	王罒一󰀔
璱	王王王丿
璲	王䒑󰀓辶
璳	王丿未貝
璴	王木木󰁾
璵	王󰀗一八
璶	王󰁬丨皿
璷	王甫方攵
璸	王宀一貝
璹	王士乛寸
璺	󰀗ㄇ一丶
璻	王羽亠十
璼	王匚丨皿
璽	一八冂丶
璾	王󰀴󰀳󰀝
璿	王󰀥冖目
瓀	王󰀙丆〢
瓁	王艹亻又
瓂	王艹土皿
瓃	王田田田
瓄	王士罒貝
瓅	王白幺木
瓆	王斤斤貝
瓇	王丆󰀐夂
瓈	王禾勹氺
瓉	王夫夫貝
瓊	王⺈ㄇ夂
瓋	王亠丷辶
瓌	王亠罒󰀔
瓍	王阝辶
瓎	王木口貝
瓏	王立月三
瓐	王虍田皿
瓑	王厂禾止
瓒	王丿土贝
瓓	王門木󰀹
瓔	王貝貝女
瓕	弓一八丶
瓖	王亠口󰀔
瓗	王山亻口
瓘	王艹口󰁷
瓙	王士乛灬
瓚	王丿土貝
瓛	王虍一犬
瓜	⺁厶󰂃󰀦
瓝	⺁厶󰂃丶
瓞	⺁厶󰂃夫
瓟	⺁厶󰂃巳
瓠	大二ㄅ󰂃
瓡	土䒑十󰂃
瓢	覀二小󰂃
瓣	辛⺁厶辛
瓤	亠口口󰂃
瓥	⺁厶󰂃虫
瓦	一󰁐󰁊丶
瓧	一󰁐󰁊十
瓨	工一󰁐丶
瓩	一󰁐󰁊十
瓪	一󰁐󰁊又
瓫	八刀一丶
瓬	方一󰁐丶
瓭	冖󰁜一丶
瓮	八厶一丶
瓯	匚乂一丶
瓰	一󰁐󰁊刀
瓱	一󰁐󰁊毛
瓲	一󰁐󰁊乚
瓳	古一󰁐丶
瓴	人丶󰁻丶
瓵	厶口一丶
瓶	䒑廾一丶
瓷	冫⺈人丶
瓸	一󰁐󰁊日
瓹	口月一丶
瓺	󰂞一󰁐丶
瓻	乂冂丶
瓼	一󰁐󰁊土
瓽	⺌冖口丶
瓾	禾女一丶
瓿	立口一丶
甀	丿士󰁺丶
甁	丿一丶
甂	丶尸冂丶
甃	禾火一丶
甄	覀土一丶
甅	一󰁐󰁊土
甆	䒑幺幺丶
甇	火火冖丶
甈	丿目木丶
甉	䒑󰁬〢丶
甊	󰀻女一丶
甋	亠丷冂丶
甌	匚口口丶
甍	艹罒冖丶
甎	一曰丨丶
甏	士口䒑丶
甐	米夕㐄丶
甑	丷󰀺日丶
甒	𠂉一󰀷丶
甓	尸口辛丶
甔	⺈厂八丶
甕	亠󰁲丿丶
甖	貝貝一丶
甗	虍一口丶
甘	甘一丨一
甙	󰀁甘丶󰀦
甚	󰀎八󰄃󰀅
甛	甘丿古󰀝
甜	丿古甘󰀝
甝	虍几甘󰀌
甞	⺌冖口甘
生	丿󰀌
甠	日丿󰀝
甡	丿丿
產	文厂丿
産	立丿丿
甤	一󰀓丿
甥	丿田力
甦	一曰乂
甧	丿丿月
用	用丿𠃌丨
甩	月乚󰁫
甪	丿用󰀵
甫	甫一丨丶
甬	󰁻用󰀬
甭	丆卜用󰀬
甮	勹󰁤用󰀬
甯	宀心用󰀬
田	田田田田
由	由丨󰁈一
甲	甲丨󰁈丨
申	曰丨󰀵
甴	ㄇ丨二󰀌
电	曰乚󰁫
甶	丿田󰀌
男	田力󰁣
甸	勹田󰀌
甹	由一ㄅ󰀅
町	田丁󰀢
画	一田凵󰀬
甼	田丁󰀬
甽	田川󰀢
甾	巛田󰀘
甿	田亠󰄃󰁀
畀	田一󰀯󰀬
畁	由一󰀯󰀬
畂	田ク󰂃󰁶
畃	曰丨勹丶
畄	󰀧田󰀘
畅	曰丨ㄋ󰁤
畆	亠田厶󰁶
畇	田勹冫󰀝
畈	田⺁又󰁶
畉	田夫󰁶
畊	田二󰀯󰀢
畋	田攵󰁶
界	田人󰀯󰀬
畍	田人󰀯󰀢
畎	田犬󰁶
畏	田一󰀖󰁧
畐	一口田󰀘
畑	火田󰀝
畒	亠田人󰁶
畓	水田󰀘
畔	田丷󰀟󰀢
畕	田田󰀘
畖	田⺁厶󰂃
畗	󰁸田󰀘
畘	田冂土󰀝
留	󰁚丶刀田
畚	厶大田󰀘
畛	田人彡󰁥
畜	亠幺田󰀘
畝	亠田ク󰂃
畞	十田ク󰂃
畟	田八夂󰁧
畠	白田󰀘
畡	田亠ㄥ人
畢	曰艹󰀟󰀵
畣	人一口田
畤	田土寸󰁶
略	田夂口󰀝
畦	田土土󰀝
畧	田夂口󰀘
畨	米田󰀘
畩	田亠󰀔󰁶
番	丿米田󰀘
畫	󰁬土田一
畬	人一朩田
畭	田人一朩
畮	田𠂉母󰁶
畯	田厶八夂
異	田󰁺八󰁧
畱	一〢匚田
畲	人二小田
畳	田冖󰀐一
畴	田三丿寸
畵	󰁬土田凵
當	⺌冖口田
畷	田又又又
畸	田大丁口
畹	田宀夕⺋
畺	一田一一
畻	田丷夫土
畼	田日一󰁤
畽	田丿一土
畾	田田田󰀘
畿	幺幺戈田
疀	巛田一󰁾
疁	田羽人彡
疂	田󰀪冖一
疃	田立曰土
疄	田米夕㐄
疅	田一田一
疆	弓土一一
疇	田士乛寸
疈	一口田田
疉	田田田彑
疊	田田田一
疋	乛󰁾󰀦
疌	一󰁬󰁾󰀦
疍	乛󰁾曰一
疎	乛止木口
疏	乛止亠󰀸
疐	十冖田󰁾
疑	匕𠂉大󰁾
疒	疒丶一󰀞
疓	疒乃󰀏
疔	疒丁󰀵
疕	疒匕󰁫
疖	疒ㄗ󰀵
疗	疒了󰀵
疘	疒工󰀌
疙	疒𠂉乙󰁫
疚	疒ク󰂃󰀦
疛	疒寸󰀦
疜	疒一卜󰀦
疝	疒山󰀵
疞	疒二ㄅ󰁫
疟	疒匚一󰀌
疠	疒一󰁡󰀏
疡	疒ㄋ󰁤󰀏
疢	疒火󰀦
疣	疒乚丶
疤	疒巴󰁫
疥	疒人󰀯󰀵
疦	疒ユ人󰀦
疧	疒󰁚󰀁󰁫
疨	疒󰀄亅丿
疩	疒九十󰀵
疪	疒󰁴匕󰁫
疫	疒几又󰀦
疬	疒厂力󰀏
疭	疒人人󰀦
疮	疒人⺋󰁫
疯	疒几乂󰀦
疰	疒丶王󰀌
疱	疒勹巳󰁫
疲	疒皮󰀦
疳	疒甘󰀌
疴	疒丁口󰀌
疵	疒止匕󰁫
疶	疒廿󰄃󰁫
疷	疒󰁚󰀁丶
疸	疒曰一󰀌
疹	疒人彡󰀏
疺	疒丿之󰀦
疻	疒口八󰀦
疼	疒夂󰁦󰀦
疽	疒󰀐一󰀌
疾	疒𠂉大󰀦
疿	疒弓󰀯󰀵
痀	疒勹口󰀌
痁	疒󰀥口󰀌
痂	疒力口󰀌
痃	疒亠幺󰀦
痄	疒𠂉丨二
病	疒一冂人
痆	疒尸匕󰁫
症	疒一止󰀌
痈	疒用󰀵
痉	疒ス工󰀌
痊	疒人王󰀌
痋	疒虫󰀦
痌	疒冂一口
痍	疒一弓人
痎	疒亠ㄥ人
痏	疒月󰀌
痐	疒囗口󰀌
痑	疒夕夕󰀦
痒	疒羊󰀵
痓	疒一厶土
痔	疒土寸󰀦
痕	疒艮󰀦
痖	疒一业󰀌
痗	疒𠂉母󰀦
痘	疒一口䒑
痙	疒一巛工
痚	疒土丿子
痛	疒󰁻用󰀵
痜	疒禾几󰁫
痝	疒乚丶
痞	疒丆卜口
痟	疒⺌月󰀌
痠	疒厶八夂
痡	疒甫󰀦
痢	疒禾刂󰀵
痣	疒士心󰀦
痤	疒人人土
痥	疒丷口儿
痦	疒五口󰀌
痧	疒氵小丿
痨	疒艹冖力
痩	疒曰丨又
痪	疒⺈ㄇ大
痫	疒门木󰀦
痬	疒曰勹󰁤
痭	疒月月󰀌
痮	疒󰀍󰀖󰀦
痯	疒宀󰃧󰀌
痰	疒火火󰀦
痱	疒丨三三
痲	疒十儿儿
痳	疒木木󰀦
痴	疒𠂉大口
痵	疒禾子󰀌
痶	疒ㄇ󰁺八
痷	疒大曰乚
痸	疒𠂉一刂
痹	疒田一󰀯
痺	疒白丿十
痻	疒󰁚󰀁日
痼	疒囗古󰀌
痽	疒亻󰁷󰀌
痾	疒阝丁口
痿	疒禾女󰀌
瘀	疒方人󰁦
瘁	疒亠人十
瘂	疒一󰀚一
瘃	疒一󰀓丶
瘄	疒󰁺日󰀌
瘅	疒丷曰十
瘆	疒厶大彡
瘇	疒丿一土
瘈	疒三丨大
瘉	疒人一刂
瘊	疒亻ユ大
瘋	疒几丿虫
瘌	疒木口刂
瘍	疒曰一󰁤
瘎	疒󰀎八󰄃
瘏	疒土丿日
瘐	疒臼人󰀦
瘑	疒冂󰁈口
瘒	疒冖車󰀵
瘓	疒⺈ㄇ大
瘔	疒艹古󰀌
瘕	疒󰁃丨又
瘖	疒立日󰀌
瘗	疒一丷土
瘘	疒米女󰀌
瘙	疒又丶虫
瘚	疒䒑凵人
瘛	疒三丨心
瘜	疒丿目心
瘝	疒罒󰀫󰀦
瘞	疒大人土
瘟	疒曰皿󰀌
瘠	疒󰀪人月
瘡	疒人丶口
瘢	疒丿󰁪又
瘣	疒白󰁜厶
瘤	疒󰁚丶田
瘥	疒⺶工󰀌
瘦	疒臼丨又
瘧	疒虍匚一
瘨	疒十󰀣八
瘩	疒艹人口
瘪	疒丿目匕
瘫	疒又亻󰁷
瘬	疒弓󰀍󰀖
瘭	疒覀二小
瘮	疒厶厶彡
瘯	疒方𠂉大
瘰	疒田幺小
瘱	疒大人心
瘲	疒彳人󰁾
瘳	疒羽人彡
瘴	疒立早󰀵
瘵	疒󰁯二小
瘶	疒木口人
瘷	疒木口攵
瘸	疒力口人
瘹	疒釒勹丶
瘺	疒尸雨󰀦
瘻	疒󰀻女󰀌
瘼	疒艹曰大
瘽	疒廿口
瘾	疒阝⺈心
瘿	疒贝贝女
癀	疒󰁺由八
癁	疒彳𠂉夂
療	疒大丷小
癃	疒阝夂
癄	疒亻󰁷灬
癅	疒一〢田
癆	疒火火力
癇	疒門月󰀌
癈	疒癶弓又
癉	疒口口十
癊	疒阝人厶
癋	疒一󰀚心
癌	疒口口山
癍	疒王文王
癎	疒門日󰀌
癏	疒罒一󰀔
癐	疒人一日
癑	疒ㄇ󰁺󰀖
癒	疒人一心
癓	疒彳山攵
癔	疒立曰心
癕	疒亠󰁲󰁷
癖	疒尸口辛
癗	疒󰀙田󰀌
癘	疒艹曰丶
癙	疒臼󰁐󰁒
癚	疒⺈厂言
癛	疒亠囗禾
癜	疒尸󰁺又
癝	疒亠囗小
癞	疒木口贝
癟	疒丿目艹
癠	疒󰀴󰀳󰀌
癡	疒匕𠂉󰁾
癢	疒䒑夫艮
癣	疒󰁢󰀞羊
癤	疒⺮󰁮卩
癥	疒彳山攵
癦	疒󰀹土土
癧	疒厂禾止
癨	疒󰀙亻󰁷
癩	疒木口貝
癪	疒禾貝
癫	疒十󰀣贝
癬	疒󰁢灬羊
癭	疒貝貝女
癮	疒阝爫心
癯	疒目目󰁷
癰	疒巛口󰁷
癱	疒廿口󰁷
癲	疒十󰀣貝
癳	疒田田小
癴	疒言糹手
癵	疒言糹人
癶	癶乛丶󰂃
癷	癶干󰀬
癸	癶一大󰁧
癹	癶几又󰁧
発	癶二儿󰀅
登	癶一口䒑
發	癶弓几又
白	白白白白
百	丆曰󰀘
癿	白乚󰁀
皀	白匕󰀅
皁	白十󰀬
皂	白七󰀅
皃	白儿󰀅
的	白勹丶󰁶
皅	白巴󰁀
皆	󰁴匕白󰀘
皇	白王󰀘
皈	白⺁又󰁶
皉	白止匕󰁀
皊	白人丶󰁻
皋	白大十󰀬
皌	白一木󰁶
皍	白󰁴卩󰀬
皎	白六乂󰁶
皏	白䒑廾󰀢
皐	白󰀪十󰀬
皑	白山己󰁀
皒	白丿扌丶
皓	白丿土口
皔	白曰干󰀢
皕	丆日丆日
皖	白宀二儿
皗	白󰀼土口
皘	白月󰀝
皙	木斤白󰀘
皚	白山一䒑
皛	白白白󰀘
皜	白󰁸冂口
皝	白王⺌儿
皞	白白大十
皟	白貝󰁶
皠	白山亻󰁷
皡	白白󰀪十
皢	白土土儿
皣	白艹一󰀟
皤	白丿米田
皥	白丿目十
皦	白白方攵
皧	白爫冖夂
皨	白白白土
皩	白王日儿
皪	白白幺木
皫	白󰁙󰁴灬
皬	白󰀙亻󰁷
皭	白爫罒寸
皮	皮乛丿󰂃
皯	皮干󰀢
皰	皮勹巳󰁀
皱	⺈彐皮󰁶
皲	冖车皮󰁶
皳	一氺丶皮
皴	厶八夂皮
皵	󰁺日皮󰁶
皶	木日󰀞皮
皷	士口䒑皮
皸	冖車皮󰁶
皹	皮冖車󰀢
皺	勹凵丿皮
皻	虍󰀐󰀞皮
皼	士冖一皮
皽	亠囗口皮
皾	士罒貝皮
皿	皿丨󰁈一
盀	卜皿󰀘
盁	乃皿󰀘
盂	一󰀛皿󰀘
盃	丆卜皿󰀘
盄	弓丨皿󰀘
盅	口丨皿󰀘
盆	八刀皿󰀘
盇	大丶皿󰀘
盈	乃又皿󰀘
盉	禾皿󰀘
益	䒑八皿󰀘
盋	又丶皿
盌	夕⺋皿󰀘
盍	土厶皿󰀘
盎	ㄇ大皿󰀘
盏	一戈皿󰀘
盐	土卜皿󰀘
监	〢𠂉丶皿
盒	人一口皿
盓	氵一󰀛皿
盔	火皿󰀘
盕	氵几丶皿
盖	丷王皿󰀘
盗	冫⺈人皿
盘	丿󰁪皿󰀘
盙	甫皿󰀘
盚	一氺丶皿
盛	戊𠃌皿󰀘
盜	氵⺈人皿
盝	󰁭氺皿󰀘
盞	戈戈皿󰀘
盟	日月皿󰀘
盠	彑󰀓皿󰀘
盡	󰁬丨一皿
盢	田犬皿󰀘
監	匚丨󰁃皿
盤	丿󰁪几皿
盥	󰀗水皿󰀘
盦	人丶乛皿
盧	虍田皿󰀌
盨	彡丆貝皿
盩	土䒑十皿
盪	氵曰一皿
盫	人一口皿
盬	匚丨󰁃皿
盭	幺土䒑皿
目	目目目目
盯	目丁󰀢
盰	目干󰀢
盱	目一󰀛󰀢
盲	亠󰄃目󰀘
盳	目亠󰄃󰁀
直	十󰀣󰀘
盵	目𠂉乙󰁀
盶	目二儿󰁀
盷	目勹冫󰀝
相	木目󰀝
盹	目一凵乚
盺	目斤󰀢
盻	目八一ㄅ
盼	目八刀󰁥
盽	目三丨󰀢
盾	⺁十目󰀌
盿	目文󰁶
眀	目月󰀝
省	小丿目󰀘
眂	目󰁚󰀁󰁀
眃	目二厶󰁶
眄	目一丨𠃌
眅	目⺁又󰁶
眆	目方󰁥
眇	目小丿󰁥
眈	目冖󰁜󰁀
眉	󰁅目󰀌
眊	目毛󰁀
看	目󰀘
県	目󰄃小󰁧
眍	目匚乂󰁶
眎	目二小󰁶
眏	目ㄇ大󰁶
眐	目一止󰀝
眑	目幺力󰁥
眒	目曰丨󰀢
眓	目戈󰁐󰁀
眔	罒󰀫󰁧
眕	目人彡󰁥
眖	目口儿󰁀
眗	目勹口󰀝
眘	大丷目󰀘
眙	目厶口󰀝
眚	丿目󰀘
眛	目未󰁶
眜	目一木󰁶
眝	目宀丁󰀢
眞	匕目󰄃八
真	十󰀣八󰁧
眠	目󰁂󰀁󰁀
眡	目󰁚󰀁丶
眢	夕⺋目󰀘
眣	目丿夫󰁶
眤	目尸匕󰁀
眥	止匕目󰀘
眦	目止匕󰁀
眧	目刀口󰀝
眨	目丿之󰁶
眩	目亠幺󰁶
眪	目一冂人
眫	目丷󰀟󰀢
眬	目ヒ丶
眭	目土土󰀝
眮	目冂一口
眯	目米󰁶
眰	目一厶土
眱	目一弓人
眲	目耳󰀝
眳	目夕口󰀝
眴	目勹日󰀝
眵	目夕夕󰁶
眶	目匚王󰀝
眷	丷夫目󰀘
眸	目厶丿󰀟
眹	目䒑大󰁶
眺	目儿󰀪󰁶
眻	目羊󰀢
眼	目艮󰁶
眽	目⺁󰀕󰁶
眾	罒亻人人
眿	目丶𠃌󰀩
着	⺶目󰀘
睁	目⺈󰁬亅
睂	人人丨目
睃	目厶八夂
睄	目⺌月󰀝
睅	目曰干󰀢
睆	目宀二儿
睇	目丷弓丿
睈	目口王󰀝
睉	目人人土
睊	目口月󰀝
睋	目丿扌丶
睌	目⺈口󰁜
睍	目目儿󰁀
睎	目乂丨
睏	目囗木󰁶
睐	目一丷木
睑	目人一一
睒	目火火󰁶
睓	目ㄇ󰁺八
睔	目人一艹
睕	目宀夕⺋
睖	目土八夂
睗	目曰勹󰁤
睘	罒一口󰀔
睙	目丶尸犬
睚	目厂土土
睛	目月󰀝
睜	目爫󰁬亅
睝	禾勹丿目
睞	目木人人
睟	目亠人十
睠	目丷夫⺋
睡	目丿士󰁺
睢	目亻󰁷󰀝
督	上小又目
睤	目田一󰀯
睥	目白丿十
睦	目土八土
睧	目󰁚󰀁日
睨	目臼儿󰁀
睩	目󰁭氺󰁶
睪	罒土䒑十
睫	目一󰁬󰁾
睬	目爫木󰁶
睭	目󰀼土口
睮	目人一刂
睯	󰁂󰀁攵目
睰	目艹口
睱	目󰁃丨又
睲	目曰丿
睳	目大土土
睴	目冖車󰀢
睵	目十戈口
睶	目三人日
睷	目󰁬󰀟廴
睸	目󰁅目󰀝
睹	目土丿日
睺	目亻ユ大
睻	目宀一一
睼	目日一󰁾
睽	目癶一大
睾	丿罒土十
睿	󰀥冖一目
瞀	󰁻乛亅目
瞁	目目犬󰁶
瞂	⺁十目丶
瞃	目⺁十目
瞄	目艹田󰀝
瞅	目禾火󰁶
瞆	目口丨贝
瞇	目米辶󰁶
瞈	目八厶羽
瞉	士冖一又
瞊	目广󰁬口
瞋	目十󰀣八
瞌	目土厶皿
瞍	目臼丨又
瞎	目宀三口
瞏	罒土口󰀔
瞐	目目目󰀘
瞑	目冖曰六
瞒	目艹一人
瞓	目言川󰀢
瞔	目貝󰁶
瞕	目立早󰀢
瞖	匚𠂉大目
瞗	目󰁟灬󰁶
瞘	目匚口口
瞙	目艹曰大
瞚	目宀一八
瞛	目彳人󰁾
瞜	目󰀻女󰀝
瞝	目亠乂厶
瞞	目廿冂丶
瞟	目覀二小
瞠	目⺌冖土
瞡	目夫目儿
瞢	艹罒冖目
瞣	目口口心
瞤	目門王󰀝
瞥	㡀攵目󰀘
瞦	目士口口
瞧	目亻󰁷灬
瞨	目业䒑夫
瞩	目尸丿丶
瞪	目癶一䒑
瞫	目覀早󰀢
瞬	目爫冖㐄
瞭	目大丷小
瞮	目亠厶攵
瞯	目門月󰀝
瞰	目乛耳攵
瞱	目艹一󰀟
瞲	目󰁻乛口
瞳	目立曰土
瞴	目𠂉一灬
瞵	目米夕㐄
瞶	目口丨貝
瞷	目門日󰀝
瞸	目艹廿木
瞹	目爫冖夂
瞺	目人一日
瞻	目⺈厂言
瞼	目人一人
瞽	士口䒑目
瞾	目目宀工
瞿	目目亻󰁷
矀	目彳山攵
矁	目禾火心
矂	目口口木
矃	目宀心丁
矄	目丿一灬
矅	目羽亻󰁷
矆	目艹亻又
矇	目艹冖󰀓
矈	目白宀方
矉	目宀一貝
矊	目糹白丨
矋	目厂艹丶
矌	目广󰁺八
矍	目目亻又
矎	目⺈ㄇ夂
矏	目丿目方
矐	目󰀙亻󰁷
矑	目虍田皿
矒	目艹罒目
矓	目立月三
矔	目艹口󰁷
矕	言糹糹目
矖	目一冂匕
矗	十󰀣十󰀣
矘	目⺌冖灬
矙	目門乛攵
矚	目尸氺虫
矛	󰁻乛亅丿
矜	󰁻乛亅乛
矝	󰁻乛亅󰁻
矞	󰁻乛亅口
矟	󰁻乛亅月
矠	󰁻乛亅日
矡	󰁻乛亅又
矢	𠂉大󰁧
矣	厶𠂉大󰁧
矤	弓𠂉大󰁶
知	𠂉大口󰀝
矦	⺈厂𠂉大
矧	𠂉大弓丨
矨	𠂉大丿大
矩	𠂉大匚󰁃
矪	𠂉大丿󰁪
矫	𠂉大丿󰀯
矬	𠂉大人土
短	𠂉大一䒑
矮	𠂉大禾女
矯	𠂉大丿口
矰	𠂉大丷日
矱	𠂉大艹又
矲	𠂉大罒匕
石	石一丿一
矴	石丁󰀢
矵	石刂󰀢
矶	石几󰁀
矷	石子󰀝
矸	石干󰀢
矹	石一儿󰁀
矺	石丿七󰁀
矻	石𠂉乙󰁀
矼	石工󰀝
矽	石夕󰁶
矾	石几丶󰁶
矿	石广󰁥
砀	石ㄋ󰁤󰁥
码	石󰀊一󰀝
砂	石小丿󰁥
砃	石󰀼亠󰀝
砄	石ユ人󰁶
砅	石水󰁶
砆	石夫󰁶
砇	石文󰁶
砈	石厂⺋󰁀
砉	三丨石󰀘
砊	石亠几󰁀
砋	石止󰀝
砌	石七刀󰁥
砍	石⺈人󰁶
砎	石人󰀯󰀢
砏	石八刀󰁥
砐	石乃󰂃󰁶
砑	石󰀄亅丿
砒	石󰁴匕󰁀
砓	石几又󰁶
研	石一廾󰀢
砕	石九十󰀢
砖	石二󰁓丶
砗	石车󰀢
砘	石一凵乚
砙	石一󰁐丶
砚	石ㄇ󰁜󰁀
砛	石人丶乛
砜	石几乂󰁶
砝	石土厶󰁶
砞	石一木󰁶
砟	石𠂉丨二
砠	石󰀐一󰀝
砡	石王丶󰁶
砢	石丁口󰀝
砣	石宀匕󰁀
砤	石𠂉也󰁀
砥	石󰁚󰀁丶
砦	止匕石󰀘
砧	石󰀥口󰀝
砨	石丶尸乙
砩	石弓󰀯󰀢
砪	石母󰁶
砫	石丶王󰀝
砬	石立󰀝
砭	石丿之󰁶
砮	女又石󰀘
砯	石丶水󰁶
砰	石一丷十
砱	石人丶󰁻
砲	石勹巳󰁀
砳	石石󰀝
破	石皮󰁶
砵	石木一󰀝
砶	石白󰀝
砷	石曰丨󰀢
砸	石匚冂丨
砹	石艹乂󰁶
砺	石厂一󰁡
砻	ヒ丶石
砼	石人工󰀝
砽	石用󰀢
砾	石丿󰄃小
砿	石广厶󰁶
础	石凵山󰀢
硁	石ス工󰀝
硂	石人王󰀝
硃	石丿未󰁶
硄	石⺌一儿
硅	石土土󰀝
硆	石人一口
硇	石丿囗乂
硈	石士口󰀝
硉	石󰁬󰀟󰀢
硊	石⺈厂⺋
硋	石亠ㄥ人
硌	石夂口󰀝
硍	石艮󰁶
硎	石一廾刂
硏	石一干
硐	石冂一口
硑	石䒑廾󰀢
硒	石西󰀝
硓	石土丿匕
硔	石󰁺八󰁶
硕	石丆贝󰁶
硖	石一丷大
硗	石󰀁丿儿
硘	石囗口󰀝
硙	石山己󰁀
硚	石丿大󰀯
硛	石亠󰁖󰁶
硜	石一巛工
硝	石⺌月󰀝
硞	石丿土口
硟	石丿󰀥廴
硠	石丶艮󰁶
硡	石宀厶
硢	石人一朩
硣	石土丿子
硤	石大人人
硥	石乚丶
硦	石王廾󰀢
硧	石󰁻用󰀢
硨	石車󰀢
硩	扌斤石󰀘
硪	石丿扌丶
硫	石亠厶󰀸
硬	石一曰乂
硭	石艹亠󰄃
确	石⺈用󰀢
硯	石目儿󰁀
硰	氵小丿石
硱	石囗木󰁶
硲	石八人口
硳	石土󰁖󰁶
硴	石艹亻ヒ
硵	石󰀥囗乂
硶	石山人乛
硷	石人一一
硸	石山厂干
硹	石木八厶
硺	石一󰀓丶
硻	匚丨󰁃石
硼	石月月󰀝
硽	石大曰乚
硾	石丿士󰁺
硿	石宀八工
碀	石⺈󰁬亅
碁	󰀎八石󰀘
碂	石宀二小
碃	石月󰀝
碄	石木木󰁶
碅	石囗禾󰁶
碆	氵皮石󰀘
碇	石宀一󰁾
碈	石󰁚󰀁日
碉	石󰀼土口
碊	石戈戈󰁶
碋	石山丁口
碌	石󰁭氺󰁶
碍	石曰一寸
碎	石亠人十
碏	石󰁺日󰀝
碐	石土八夂
碑	石白丿十
碒	石金󰀝
碓	石亻󰁷󰀝
碔	石一󰀁丶
碕	石大丁口
碖	石人一艹
碗	石宀夕⺋
碘	石ㄇ󰁺八
碙	石冂䒑山
碚	石立口󰀝
碛	石贝󰁶
碜	石厶大彡
碝	石丆冂大
碞	口口口石
碟	石廿󰄃木
碠	石󰁸冖丁
碡	石母󰁶
碢	石ㄇ󰁈口
碣	石曰勹󰄃
碤	石艹ㄇ大
碥	石丶尸艹
碦	石宀夂口
碧	王白石󰀘
碨	石田一󰀖
碩	石丆貝󰁶
碪	石󰀎八󰄃
碫	石丿丨又
碬	石󰁃丨又
碭	石日一󰁤
碮	石日一󰁾
碯	石巛丿乂
碰	石䒑业󰀝
碱	石戊一口
碲	石亠丷丨
碳	石山火
碴	石木曰一
碵	石󰀥貝󰁶
碶	石三丨大
碷	石⺁十目
碸	石几丿虫
碹	石宀一一
確	石冖亻󰁷
碻	石󰁸冂口
碼	石󰀋灬󰁶
碽	石工貝󰁶
碾	石尸󰁺󰀖
碿	石尸⺌月
磀	石䒑凵辶
磁	石䒑幺幺
磂	石󰁚丶田
磃	石⺁虍几
磄	石广󰁬口
磅	石亠丷方
磆	石󰀾月󰀝
磇	石丿囗匕
磈	石白󰁜厶
磉	石又又木
磊	石石石󰀘
磋	石⺶工󰀝
磌	石十󰀣八
磍	石宀三口
磎	石爫幺大
磏	石䒑󰁬八
磐	丿󰁪几石
磑	石山一䒑
磒	石口貝󰁶
磓	石丿󰃧辶
磔	石夕㐄木
磕	石土厶皿
磖	石羽白󰀝
磗	石甫寸󰁶
磘	石爫𠂉凵
磙	石六厶󰀔
磚	石一曰寸
磛	車斤石󰀘
磜	石󰁯二小
磝	石󰁡攵
磞	石山月月
磟	石羽人彡
磠	石󰀥囗󰁘
磡	石󰀎八力
磢	石大乂乂
磣	石厶厶彡
磤	石⺁彐又
磥	石田幺小
磦	石覀二小
磧	石貝󰁶
磨	广木木石
磩	石戊上小
磪	石山亻󰁷
磫	石彳人󰁾
磬	士󰁅几石
磭	石厂二月
磮	石山人艹
磯	石幺幺人
磰	石羊䒑口
磱	石火火力
磲	石氵匚木
磳	石丷󰀺日
磴	石癶一䒑
磵	石門日󰀝
磶	石臼勹灬
磷	石米夕㐄
磸	石丷西大
磹	石覀早󰀢
磺	石󰁺由八
磻	石丿米田
磼	石亻󰁷木
磽	石土土儿
磾	石口口十
磿	厂禾禾石
礀	石門月󰀝
礁	石亻󰁷灬
礂	石士口口
礃	石⺌冖手
礄	石丿大口
礅	石󰁸孑攵
礆	石人一人
礇	石丿ㄇ大
礈	石䒑󰀓辶
礉	石白方攵
礊	車凵几石
礋	石罒土十
礌	石󰀙田󰀝
礍	石艹曰󰄃
礎	石木木󰁾
礏	石业䒑未
礐	󰀗乂乂石
礑	石⺌冖田
礒	石丷王丶
礓	石一田一
礔	石尸口辛
礕	尸口辛石
礖	石󰀗一八
礗	石宀一貝
礘	石曰幺灬
礙	石匕𠂉󰁾
礚	石艹土皿
礛	石匚丨皿
礜	󰀗一󰁕石
礝	石󰀙丆〢
礞	石艹冖󰀓
礟	石󰀋灬乂
礠	石䒑幺心
礡	石艹甫寸
礢	石䒑夫艮
礣	石艹罒人
礤	石艹󰁯小
礥	石匚丨貝
礦	石广󰁺八
礧	石田田田
礨	田田田石
礩	石斤斤貝
礪	石厂艹丶
礫	石白幺木
礬	木乂乂石
礭	石󰀙亻󰁷
礮	石󰀋灬乂
礯	石火火小
礰	石厂禾止
礱	立月一石
礲	石立月三
礳	石广木石
礴	石艹氵寸
礵	石󰀙木目
礶	石艹口󰁷
礷	石艹匚皿
礸	石丿土貝
礹	石口口攵
示	二小󰁧
礻	礻󰁶丶丶
礼	礻󰁶乚󰁀
礽	礻󰁶乃󰁥
社	礻󰁶土󰀝
礿	礻󰁶勹丶
祀	礻󰁶巳󰁀
祁	礻󰁶阝󰀢
祂	礻󰁶也󰁀
祃	礻󰁶󰀊一
祄	礻󰁶人󰀯
祅	礻󰁶丿大
祆	礻󰁶一大
祇	礻󰁶󰁚󰀁
祈	礻󰁶斤󰀢
祉	礻󰁶止󰀝
祊	礻󰁶方󰁥
祋	礻󰁶几又
祌	礻󰁶口丨
祍	礻󰁶丿士
祎	礻󰁶二丨
祏	礻󰁶石󰀝
祐	礻󰁶口
祑	礻󰁶丿夫
祒	礻󰁶刀口
祓	礻󰁶丶
祔	礻󰁶亻寸
祕	礻󰁶心丿
祖	礻󰁶󰀐一
祗	礻󰁶󰁚丶
祘	二小二小
祙	礻󰁶未󰁶
祚	礻󰁶𠂉二
祛	礻󰁶土厶
祜	礻󰁶古󰀝
祝	礻󰁶口儿
神	礻󰁶曰丨
祟	凵山二小
祠	礻󰁶𠃌口
祡	止匕二小
祢	礻󰁶⺈小
祣	礻󰁶𠂉󰀕
祤	礻󰁶羽󰀝
祥	礻󰁶羊󰀢
祦	礻󰁶口大
祧	礻󰁶儿󰀪
票	覀二小󰁧
祩	礻󰁶丿未
祪	礻󰁶⺈⺋
祫	礻󰁶人口
祬	礻󰁶一土
祭	󰁯二小󰁧
祮	礻󰁶士口
祯	礻󰁶󰀥贝
祰	礻󰁶丿口
祱	礻󰁶丷儿
祲	礻󰁶彐又
祳	礻󰁶厂󰀖
祴	礻󰁶戈廾
祵	礻󰁶囗木
祶	礻󰁶丷丿
祷	礻󰁶三寸
祸	礻󰁶口人
祹	礻󰁶勹凵
祺	礻󰁶󰀎八
祻	礻󰁶囗古
祼	礻󰁶曰木
祽	礻󰁶亠十
祾	礻󰁶土夂
祿	礻󰁶彑氺
禀	亠囗口小
禁	木木二小
禂	礻󰁶󰀼口
禃	礻󰁶十󰀣
禄	礻󰁶󰁭氺
禅	礻󰁶丷十
禆	礻󰁶白十
禇	礻󰁶土日
禈	礻󰁶冖車
禉	礻󰁶丷一
禊	礻󰁶三大
禋	礻󰁶覀土
禌	礻󰁶䒑幺
禍	礻󰁶ㄇ口
禎	礻󰁶󰀥貝
福	礻󰁶一田
禐	礻󰁶爫又
禑	礻󰁶曰丶
禒	礻󰁶彑󰀓
禓	礻󰁶日󰁤
禔	礻󰁶日󰁾
禕	礻󰁶󰁆㐄
禖	礻󰁶甘木
禗	礻󰁶田心
禘	礻󰁶亠丨
禙	礻󰁶丬月
禚	礻󰁶丷灬
禛	礻󰁶十八
禜	火火冖小
禝	礻󰁶田夂
禞	礻󰁶󰁸口
禟	礻󰁶广口
禠	礻󰁶⺁几
禡	礻󰁶󰀋灬
禢	礻󰁶曰羽
禣	礻󰁶甫寸
禤	礻󰁶罒羽
禥	礻󰁶󰀎土
禦	彳𠂉一小
禧	礻󰁶士口
禨	礻󰁶幺人
禩	礻󰁶田八
禪	礻󰁶口十
禫	礻󰁶覀早
禬	礻󰁶人日
禭	礻󰁶䒑辶
禮	礻󰁶ㄇ䒑
禯	礻󰁶ㄇ󰀖
禰	礻󰁶一乂
禱	礻󰁶士寸
禲	礻󰁶厂丶
禳	礻󰁶亠󰀔
禴	礻󰁶人艹
禵	礻󰁶日貝
禶	礻󰁶丿貝
禷	礻󰁶米貝
禸	冂厶󰀦
禹	丿口冂丶
禺	曰冂丨丶
离	亠乂凵厶
禼	󰀥囗乂厶
禽	人亠乂厶
禾	禾禾禾禾
禿	禾儿󰀅
秀	禾乃󰁣
私	禾厶󰁶
秂	禾人󰁧
秃	禾几󰀅
秄	禾子󰀝
秅	禾丿七󰁀
秆	禾干󰀢
秇	禾九丶󰁶
秈	禾山󰀢
秉	禾󰁬󰀌
秊	禾丿十󰀬
秋	禾火󰁶
秌	火禾󰁶
种	禾口丨󰀢
秎	禾八刀󰁥
秏	禾毛󰁀
秐	禾二厶󰁶
科	禾󰁦十󰀢
秒	禾小丿󰁥
秓	禾十又󰁶
秔	禾亠几󰁀
秕	禾󰁴匕󰁀
秖	禾󰁚󰀁󰁀
秗	禾丿大󰁶
秘	禾心丿󰁥
秙	禾古󰀝
秚	禾丷󰀟󰀢
秛	禾皮󰁶
秜	禾尸匕󰁀
秝	禾禾󰁶
秞	禾由󰀝
租	禾󰀐一󰀝
秠	禾丆卜一
秡	禾又丶
秢	禾人丶󰁻
秣	禾一木󰁶
秤	禾一丷十
秥	禾󰀥口󰀝
秦	三人禾󰁧
秧	禾ㄇ大󰁶
秨	禾𠂉丨二
秩	禾丿夫󰁶
秪	禾󰁚󰀁丶
秫	禾木丶󰁶
秬	禾匚󰁃󰀝
秭	禾丿ㄅ丿
秮	禾厶口󰀝
积	禾口八󰁶
称	禾⺈小󰁶
秱	禾冂一口
秲	禾土寸󰁶
秳	禾丿古󰀝
秴	禾人一口
秵	禾囗大󰁶
秶	冫⺈人禾
秷	禾一厶土
秸	禾士口󰀝
秹	禾亻丿士
秺	禾宀丿七
移	禾夕夕󰁶
秼	禾丿未󰁶
秽	禾山夕󰁶
秾	禾冖󰀔󰁶
秿	禾甫󰁶
稀	禾乂丨
稁	󰁸冖禾󰁧
稂	禾丶艮󰁶
稃	禾爫子󰀝
稄	禾厶八夂
稅	禾八口儿
稆	禾口口󰀝
稇	禾囗木󰁶
稈	禾曰干󰀢
稉	禾一曰乂
稊	禾丷弓丿
程	禾口王󰀝
稌	禾人一朩
稍	禾⺌月󰀝
税	禾丷口儿
稏	禾一󰀚一
稐	禾人一艹
稑	禾土八土
稒	禾囗古󰀝
稓	禾󰁺日󰀝
稔	禾人丶心
稕	禾󰁸子󰀝
稖	禾立口󰀝
稗	禾白丿十
稘	禾󰀎八󰁶
稙	禾十󰀣󰀝
稚	禾亻󰁷󰀝
稛	禾囗禾󰁶
稜	禾土八夂
稝	禾月月󰀝
稞	禾曰木󰁶
稟	亠囗口禾
稠	禾󰀼土口
稡	禾亠人十
稢	禾戈口󰀞
稣	󰁢󰀞禾󰁶
稤	禾󰁸小󰁶
稥	禾灬日󰀘
稦	禾󰁆口㐄
稧	禾三丨大
稨	禾丶尸艹
稩	禾田月󰀝
稪	禾𠂉日夂
稫	禾一口田
稬	禾丆冂大
稭	禾󰁴匕白
種	禾丿一土
稯	禾乂凵夂
稰	禾乛󰁾月
稱	禾爫冂土
稲	禾爫丨日
稳	禾⺈彐心
稴	禾䒑󰁬八
稵	禾䒑幺幺
稶	禾戈口󰁤
稷	禾田八夂
稸	禾亠幺田
稹	禾十󰀣八
稺	禾尸辛󰀢
稻	禾爫臼󰀝
稼	禾宀一󰀓
稽	禾乚日
稾	󰁸冂口禾
稿	禾󰁸冂口
穀	士冖一又
穁	禾艹耳󰀝
穂	禾一由心
穃	禾宀八口
穄	禾癶二小
穅	禾广󰁬氺
穆	禾白小彡
穇	禾厶厶彡
穈	广木木禾
穉	禾尸氺󰀟
穊	禾󰁮󰀄󰁜
穋	禾羽人彡
穌	󰁢灬禾󰁶
積	禾貝󰁶
穎	匕禾丆貝
穏	禾爫彐心
穐	禾⺈曰乚
穑	禾十䒑口
穒	禾󰁟灬󰁧
穓	禾田󰁺八
穔	禾󰁺由八
穕	禾亻󰁷木
穖	禾幺幺人
穗	禾一曰心
穘	禾土土儿
穙	禾业䒑夫
穚	禾丿大口
穛	禾亻󰁷灬
穜	禾立曰土
穝	禾曰耳又
穞	禾󰁢一日
穟	禾䒑󰀓辶
穠	禾ㄇ󰁺󰀖
穡	禾土人口
穢	禾止戊󰀤
穣	禾六󰀀󰀔
穤	禾󰀙丆〢
穥	禾󰀗一八
穦	禾宀一貝
穧	禾󰀴󰀳󰀝
穨	禾几口貝
穩	禾爫工心
穪	禾一八乂
穫	禾艹亻又
穬	禾广󰁺八
穭	禾󰁢灬日
穮	禾󰁙󰁴灬
穯	禾土口口
穰	禾亠口󰀔
穱	禾爫罒寸
穲	禾一冂匕
穳	禾丿土貝
穴	宀八󰁧
穵	宀八乙󰀅
究	宀八九󰀅
穷	宀八力󰁣
穸	宀八夕󰁧
穹	宀八弓󰀅
空	宀八工󰀘
穻	宀八一󰀛
穼	宀八木󰁧
穽	宀八二󰀯
穾	宀八丿大
穿	宀八󰀄丿
窀	宀八一乚
突	宀八犬󰁧
窂	宀八丿󰀟
窃	宀八七刀
窄	宀八𠂉二
窅	宀八目󰀘
窆	宀八丿之
窇	宀八勹巳
窈	宀八幺力
窉	宀八一人
窊	宀八⺁󰂃
窋	宀八凵山
窌	宀八󰁚卩
窍	宀八工ㄅ
窎	宀八󰁠一
窏	宀八氵󰀛
窐	宀八土土
窑	宀八𠂉凵
窒	宀八一土
窓	宀八厶心
窔	宀八六乂
窕	宀八儿󰀪
窖	宀八丿口
窗	宀八丿夕
窘	宀八󰁬口
窙	宀八土子
窚	宀八戊𠃌
窛	宀八二女
窜	宀八口丨
窝	宀八口人
窞	宀八⺈臼
窟	宀八尸山
窠	宀八曰木
窡	宀八又又
窢	宀八戈󰀞
窣	宀八亠十
窤	宀八曰󰁴
窥	宀八夫󰁜
窦	宀八十大
窧	宀八󰀥早
窨	宀八立曰
窩	宀八ㄇ口
窪	宀八氵土
窫	宀八三大
窬	宀八人刂
窭	宀八米女
窮	宀八丿弓
窯	宀八丷灬
窰	宀八爫凵
窱	宀八亻木
窲	宀八米十
窳	宀八⺁󰂃
窴	宀八十八
窵	宀八󰁟灬
窶	宀八󰀻女
窷	宀八耳卩
窸	宀八丿心
窹	宀八爿口
窺	宀八夫儿
窻	宀八丿心
窼	宀八巛木
窽	宀八匕人
窾	宀八士人
窿	宀八阝
竀	宀八一儿
竁	宀八毛毛
竂	宀八大小
竃	宀八土乚
竄	宀八臼󰁒
竅	宀八白攵
竆	宀八丿口
竇	宀八士貝
竈	宀八土黽
竉	宀八立三
竊	宀八丿厶
立	立立立立
竌	立几󰁀
竍	立十󰀢
竎	立廾󰀬
竏	立丿十󰀢
竐	立几又󰁶
竑	立厶󰁶
竒	立口亅󰀬
竓	立毛󰁀
竔	立丿廾󰀢
竕	立八刀󰁥
竖	〢又立󰀘
竗	立小丿󰁥
竘	立勹口󰀝
站	立󰀥口󰀝
竚	立宀丁󰀢
竛	立人丶󰁻
竜	立曰乚󰀅
竝	立立󰀝
竞	立口儿󰀅
竟	立曰儿󰀅
章	立早󰀬
竡	立丆日󰀝
竢	立厶𠂉大
竣	立厶八夂
竤	立宀厶
童	立曰土󰀘
竦	立木口󰀝
竧	立丿󰀽丿
竨	立󰀥早󰀢
竩	立宀󰀐一
竪	匚丨󰁃立
竫	立⺈󰁬亅
竬	立丿口丶
竭	立曰勹󰄃
竮	立尸䒑廾
端	立山丆〢
竰	立厂曰土
竱	立一曰寸
竲	立丷󰀺日
竳	立癶一䒑
竴	立丷西寸
竵	立一口丨
競	立口儿儿
竷	立早夂夂
竸	立曰儿儿
竹	𠂉丨𠂉亅
竺	⺮二󰀘
竻	⺮力󰁣
竼	⺮几丶󰁧
竽	⺮一󰀛󰀬
竾	⺮也󰀅
竿	⺮干󰀬
笀	⺮亠󰄃󰀅
笁	⺮工󰀘
笂	⺮九丶󰁧
笃	⺮󰀊一󰀘
笄	⺮一廾󰀬
笅	⺮乂乂󰁧
笆	⺮巴󰀅
笇	⺮亠卜󰁧
笈	⺮乃󰂃󰁧
笉	⺮勹冫󰀘
笊	⺮⺁丨󰂃
笋	⺮󰁬丿󰁣
笌	⺮󰀄亅丿
笍	⺮冂人󰁧
笎	⺮二儿󰀅
笏	⺮勹󰁤󰁣
笐	⺮亠几󰀅
笑	⺮丿大󰁧
笒	⺮人丶乛
笓	⺮󰁴匕󰀅
笔	⺮毛󰀅
笕	⺮ㄇ儿󰀅
笖	⺮󰁐丶人
笗	⺮夂󰁦󰁧
笘	⺮󰀥口󰀘
笙	⺮丿󰀘
笚	⺮甲󰀬
笛	⺮由󰀘
笜	⺮凵山󰀬
笝	⺮囗又󰁧
笞	⺮厶口󰀘
笟	⺮⺁厶󰂃
笠	⺮立󰀘
笡	⺮󰀐一󰀘
笢	⺮󰁂󰀁󰀅
笣	⺮勹巳󰀅
笤	⺮刀口󰀘
笥	⺮𠃌一口
符	⺮亻寸󰁧
笧	⺮󰀼󰀼一
笨	⺮木一󰀘
笩	⺮亻󰀁丶
笪	⺮曰一󰀘
笫	⺮丿ㄅ丿
第	⺮弓丨丿
笭	⺮人丶󰁻
笮	⺮𠂉丨二
笯	⺮女又󰁧
笰	⺮弓󰀯󰀬
笱	⺮勹口󰀘
笲	⺮厶廾󰀬
笳	⺮力口󰀘
笴	⺮丁口󰀘
笵	⺮氵⺋󰀅
笶	⺮𠂉大󰁧
笷	⺮󰁚丿卩
笸	⺮匚口󰀘
笹	⺮廿󰄃󰀅
笺	⺮一戈󰁧
笻	⺮工卩󰀬
笼	⺮ヒ丶
笽	⺮皿󰀘
笾	⺮力辶󰁧
笿	⺮夂口󰀘
筀	⺮土土󰀘
筁	⺮ㄇ󰁺󰀘
筂	⺮氵也󰀅
筃	⺮囗大󰁧
筄	⺮儿󰀪󰁧
筅	⺮丿土儿
筆	⺮󰁬󰀟󰀬
筇	⺮工阝󰀬
筈	⺮丿古󰀘
等	⺮土寸󰁧
筊	⺮六乂󰁧
筋	⺮月力󰁣
筌	⺮人王󰀘
筍	⺮勹日󰀘
筎	⺮女口󰀘
筏	⺮亻戈󰁧
筐	⺮匚王󰀘
筑	⺮工几丶
筒	⺮冂一口
筓	⺮一干
答	⺮人一口
筕	⺮彳一丁
策	⺮木冂󰀅
筗	⺮亻口丨
筘	⺮扌口󰀘
筙	⺮二木󰁧
筚	⺮󰁴匕十
筛	⺮リ一丨
筜	⺮⺌彐󰀘
筝	⺮⺈󰁬亅
筞	⺮宀木󰁧
筟	⺮爫子󰀘
筠	⺮土勹冫
筡	⺮人一朩
筢	⺮扌巴󰀅
筣	⺮禾刂󰀬
筤	⺮丶艮󰁧
筥	⺮口口󰀘
筦	⺮宀二儿
筧	⺮目儿󰀅
筨	⺮人丶口
筩	⺮󰁻用󰀬
筪	⺮匚甲󰀬
筫	⺮貝󰁧
筬	⺮戊𠃌󰀅
筭	⺮王廾󰀬
筮	⺮工人人
筯	⺮󰀐󰀞力
筰	⺮亻𠂉二
筱	⺮亻丨攵
筲	⺮⺌月󰀘
筳	⺮丿士廴
筴	⺮大人人
筵	⺮丿󰀥廴
筶	⺮丿土口
筷	⺮忄ユ人
筸	⺮曰干󰀬
筹	⺮三丿寸
筺	⺮匚王丶
筻	⺮一曰乂
筼	⺮口贝󰁧
筽	⺮口一大
签	⺮人一一
筿	⺮夂朩󰁧
简	⺮门日󰀘
箁	⺮立口󰀘
箂	⺮木人人
箃	⺮耳又󰁧
箄	⺮白丿十
箅	⺮田一󰀯
箆	⺮ㄇ人󰁴
箇	⺮囗古󰀘
箈	⺮氵厶口
箉	⺮扌口力
箊	⺮方人󰁦
箋	⺮戈戈󰁧
箌	⺮一厶刂
箍	⺮扌匚丨
箎	⺮虍几󰀅
箏	⺮爫󰁬亅
箐	⺮月󰀘
箑	⺮一󰁬󰁾
箒	⺮彐冖丨
箓	⺮󰁭氺󰁧
箔	⺮氵白󰀘
箕	⺮󰀎八󰁧
箖	⺮木木󰁧
算	⺮目廾󰀬
箘	⺮囗禾󰁧
箙	⺮月卩又
箚	⺮人一刂
箛	⺮孑⺁󰂃
箜	⺮宀八工
箝	⺮扌甘󰀘
箞	⺮丷夫⺋
箟	⺮曰󰁴匕
箠	⺮丿士󰁺
管	⺮宀󰃧󰀘
箢	⺮宀夕⺋
箣	⺮木冂刂
箤	⺮亠人十
箥	⺮氵皮󰁧
箦	⺮贝󰁧
箧	⺮匚一大
箨	⺮扌又󰀟
箩	⺮罒夕󰁧
箪	⺮丷曰十
箫	⺮󰁬丨八
箬	⺮艹口
箭	⺮䒑月刂
箮	⺮宀一一
箯	⺮亻一乂
箰	⺮勹曰子
箱	⺮木目󰀘
箲	⺮氵丿儿
箳	⺮尸䒑廾
箴	⺮戊一口
箵	⺮小丿目
箶	⺮古月󰀘
箷	⺮方𠂉也
箸	⺮土丿曰
箹	⺮糹勹丶
箺	⺮三人日
箻	⺮彳󰁬󰀟
箼	⺮尸一土
箽	⺮丿一土
箾	⺮⺌月刂
箿	⺮口耳󰀘
節	⺮󰁮卩󰀬
篁	⺮白王󰀘
篂	⺮曰丿
篃	⺮󰁅目󰀘
範	⺮車⺋󰀅
篅	⺮山丆〢
篆	⺮彑󰀓󰁧
篇	⺮丶尸艹
篈	⺮土土寸
築	⺮工几木
篊	⺮氵󰁺八
篋	⺮匚大人
篌	⺮亻ユ大
篍	⺮禾火󰁧
篎	⺮目小丿
篏	⺮甘⺈人
篐	⺮木匚丨
篑	⺮口丨贝
篒	⺮人丶艮
篓	⺮米女󰀘
篔	⺮口貝󰁧
篕	⺮土厶皿
篖	⺮广󰁬口
篗	⺮亻󰁷又
篘	⺮勹凵丿
篙	⺮󰁸冂口
篚	⺮匚丨三
篛	⺮弓冫冫
篜	⺮了󰀩灬
篝	⺮󰀀冂土
篞	⺮氵曰土
篟	⺮亻月
篠	⺮亻丨朩
篡	⺮目大厶
篢	⺮工貝󰁧
篣	⺮亠丷方
篤	⺮󰀋灬󰁧
篥	⺮覀木󰁧
篦	⺮丿囗匕
篧	⺮冖亻󰁷
篨	⺮阝人朩
篩	⺮丿󰃧丨
篪	⺮⺁虍几
篫	⺮工几手
篬	⺮人丶口
篭	⺮立曰乚
篮	⺮〢𠂉皿
篯	⺮钅一戈
篰	⺮立口阝
篱	⺮亠乂厶
篲	⺮三丨彐
篳	⺮曰艹󰀟
篴	⺮一󰀓辶
篵	⺮彳人󰁾
篶	⺮一止灬
篷	⺮夂三辶
篸	⺮厶厶彡
篹	⺮目大⺋
篺	⺮扌白十
篻	⺮覀二小
篼	⺮白󰁚儿
篽	⺮彳𠂉卩
篾	⺮罒戈人
篿	⺮一曰寸
簀	⺮貝󰁧
簁	⺮彳止󰁾
簂	⺮囗戈󰀞
簃	⺮禾夕夕
簄	⺮丶尸巴
簅	⺮立丿
簆	⺮宀二攵
簇	⺮方𠂉大
簈	⺮尸丿干
簉	⺮丿土辶
簊	⺮󰀎八土
簋	⺮艮皿󰀘
簌	⺮木口人
簍	⺮󰀻女󰀘
簎	⺮扌󰁺日
簏	⺮󰁙󰁴匕
簐	⺮車⺈人
簑	⺮亠口󰀔
簒	⺮目大厶
簓	⺮󰀼土彡
簔	⺮亠一󰀔
簕	⺮廿󰀜力
簖	⺮米󰄃斤
簗	⺮氵刀木
簘	⺮󰁬米󰀯
簙	⺮十甫寸
簚	⺮罒戈丨
簛	⺮󰀎八斤
簜	⺮氵曰󰁤
簝	⺮大丷小
簞	⺮口口十
簟	⺮覀早󰀬
簠	⺮甫皿󰀘
簡	⺮門日󰀘
簢	⺮門文󰁧
簣	⺮口丨貝
簤	⺮罒貝󰁧
簥	⺮丿大口
簦	⺮癶一䒑
簧	⺮󰁺由八
簨	⺮巳巳八
簩	⺮火火力
簪	⺮󰀄󰁜日
簫	⺮󰁬十󰀲
簬	⺮口止口
簭	⺮工人口
簮	⺮夫夫曰
簯	⺮木󰀎八
簰	⺮丿丨十
簱	⺮方󰀎八
簲	⺮月白十
簳	⺮十早干
簴	⺮虍业八
簵	⺮車夂口
簶	⺮礻󰁶氺
簷	⺮⺈厂言
簸	⺮󰀎八皮
簹	⺮⺌冖田
簺	⺮宀󰀀土
簻	⺮ㄇ󰁈辶
簼	⺮扌󰀀土
簽	⺮人一人
簾	⺮广䒑八
簿	⺮氵甫寸
籀	⺮扌󰁚田
籁	⺮木口贝
籂	⺮人良丨
籃	⺮匚丨皿
籄	⺮匚口貝
籅	⺮󰀗一八
籆	⺮艹亻又
籇	⺮󰁸冖󰀓
籈	⺮覀土丶
籉	⺮士口土
籊	⺮羽亻󰁷
籋	⺮一八乂
籌	⺮士乛寸
籍	⺮二木日
籎	⺮匕𠂉󰁾
籏	⺮方𠂉八
籐	⺮月丷氺
籑	⺮目大艮
籒	⺮扌一田
籓	⺮氵丿田
籔	⺮󰀻女攵
籕	⺮木󰁚田
籖	⺮十戈󰀞
籗	⺮󰀙亻󰁷
籘	⺮月丷小
籙	⺮釒󰁭氺
籚	⺮虍田皿
籛	⺮釒戈戈
籜	⺮扌罒十
籝	⺮󰄹月丶
籞	⺮彳𠂉小
籟	⺮木口貝
籠	⺮立月三
籡	⺮扌人人
籢	⺮人一攵
籣	⺮門木󰀹
籤	⺮人人󰀞
籥	⺮人一艹
籦	⺮釒丿土
籧	⺮虍一辶
籨	⺮人一人
籩	⺮丿目辶
籪	⺮幺幺斤
籫	⺮丿土貝
籬	⺮亠乂󰁷
籭	⺮一ㄇ匕
籮	⺮罒糹󰁷
籯	⺮󰄹月丶
籰	⺮目目又
籱	⺮󰀙亻󰁷
籲	⺮人一貝
米	米丶丿󰂃
籴	丿󰂃米󰁧
籵	米十󰀢
籶	米几󰁀
籷	米丿七󰁀
籸	米⺄十󰀢
籹	米女󰀝
籺	米𠂉乙󰁀
类	米大󰁧
籼	米山󰀢
籽	米子󰀝
籾	米刀丶󰁶
籿	米寸󰁶
粀	米󰂃󰁶
粁	米丿十󰀢
粂	ク󰂃米󰁧
粃	米󰁴匕󰁀
粄	米⺁又󰁶
粅	米勹󰁤󰁥
粆	米小丿󰁥
粇	米亠几󰁀
粈	米󰁈丨一
粉	米八刀󰁥
粊	󰁴匕米󰁧
粋	米九十󰀢
粌	米弓丨󰀢
粍	米毛󰁀
粎	米尸󰂃󰁶
粏	米大丶󰁶
粐	米丶尸󰁥
粑	米巴󰁀
粒	米立󰀝
粓	米甘󰀝
粔	米匚󰁃󰀝
粕	米白󰀝
粖	米一木󰁶
粗	米󰀐一󰀝
粘	米󰀥口󰀝
粙	米由󰀝
粚	米𠂉也󰁀
粛	󰁬米󰀯󰀵
粜	凵山米󰁧
粝	米厂一󰁡
粞	米西󰀝
粟	覀米󰁧
粠	米󰁺八󰁶
粡	米冂一口
粢	冫⺈人米
粣	米冂冂一
粤	丿囗米ㄅ
粥	弓米弓󰁀
粦	米夕㐄󰀬
粧	米广土󰀝
粨	米丆日󰀝
粩	米土丿匕
粪	米󰁺八󰁧
粫	米丆冂〢
粬	米ㄇ󰁺󰀝
粭	米人一口
粮	米丶艮󰁶
粯	米目儿󰁀
粰	米爫子󰀝
粱	氵刀八米
粲	󰀥夕又米
粳	米一曰乂
粴	米曰土󰀝
粵	丿ㄇ丿ㄅ
粶	米󰁭氺󰁶
粷	米勹米󰁶
粸	米󰀎八󰁶
粹	米亠人十
粺	米白丿十
粻	米󰀍󰀖󰁶
粼	米夕㐄巜
粽	米宀二小
精	米月󰀝
粿	米曰木󰁶
糀	米艹亻ヒ
糁	米厶大彡
糂	米󰀎八󰄃
糃	米曰一󰁤
糄	米丶尸艹
糅	米󰁻乛木
糆	米丆囗二
糇	米亻ユ大
糈	米乛󰁾月
糉	米乂凵夂
糊	米古月󰀝
糋	米䒑月刂
糌	米夂卜日
糍	米䒑幺幺
糎	米厂曰土
糏	米尸⺌月
糐	米甫寸󰁶
糑	米弓冫冫
糒	米󰁺丿用
糓	士冖一又
糔	米又丶虫
糕	米丷王灬
糖	米广󰁬口
糗	米丿目犬
糘	米宀一󰀓
糙	米丿土辶
糚	米艹爿士
糛	米⺌冖土
糜	广木木米
糝	米厶厶彡
糞	米田󰁺八
糟	米一ㄇ日
糠	米广󰁬氺
糡	米立曰儿
糢	米艹曰大
糣	米󰀄󰁜日
糤	米󰁺月攵
糥	米丆冂〢
糦	米士口口
糧	米曰一土
糨	米弓口虫
糩	米人一日
糪	尸口辛米
糫	米罒一󰀔
糬	米罒土日
糭	米󰁘凵夂
糮	米匚丨皿
糯	米󰀙丆〢
糰	米囗一寸
糱	凵丿丿米
糲	米厂艹丶
糳	业䒑十米
糴	丿丶米󰁷
糵	艹丿󰃧米
糶	凵山米󰁷
糷	米艹門󰀹
糸	幺小󰁧
糹	糹ㄥㄥ丶
糺	糹乚󰁀
系	丿幺小󰁧
糼	糹力󰁥
糽	糹丁󰀢
糾	糹󰁐丨󰀢
糿	糹刀󰁥
紀	糹己󰁀
紁	糹又丶󰁶
紂	糹寸󰁶
紃	糹川󰀢
約	糹勹丶󰁶
紅	糹工󰀝
紆	糹一󰀛󰀢
紇	糹𠂉乙󰁀
紈	糹九丶󰁶
紉	糹刀丶󰁶
紊	文幺小󰁧
紋	糹文󰁶
紌	糹乚丶
納	糹冂人󰁶
紎	糹犬󰁶
紏	糹󰁦十󰀢
紐	糹󰁈丨一
紑	糹丆卜󰁶
紒	糹人󰀯󰀢
紓	糹󰁻乛亅
純	糹一凵乚
紕	糹󰁴匕󰁀
紖	糹弓丨󰀢
紗	糹小丿󰁥
紘	糹厶󰁶
紙	糹󰁚󰀁󰁀
級	糹乃󰂃󰁶
紛	糹八刀󰁥
紜	糹二厶󰁶
紝	糹丿士󰀝
紞	糹冖󰁜󰁀
紟	糹人丶乛
素	幺小󰁧
紡	糹方󰁥
索	十冖幺小
紣	糹九十󰀢
紤	糹斤󰀢
紥	扌乚幺小
紦	糹巴󰁀
紧	〢又幺小
紨	糹亻寸󰁶
紩	糹丿夫󰁶
紪	糹止匕󰁀
紫	止匕幺小
紬	糹由󰀝
紭	糹弓厶󰁶
紮	木乚幺小
累	田幺小󰁧
細	糹田󰀝
紱	糹又丶
紲	糹廿󰄃󰁀
紳	糹曰丨󰀢
紴	糹皮󰁶
紵	糹宀丁󰀢
紶	糹土厶󰁶
紷	糹人丶󰁻
紸	糹丶王󰀝
紹	糹刀口󰀝
紺	糹甘󰀝
紻	糹ㄇ大󰁶
紼	糹弓󰀯󰀢
紽	糹宀匕󰁀
紾	糹人彡󰁥
紿	糹厶口󰀝
絀	糹凵山󰀢
絁	糹𠂉也󰁀
終	糹夂󰁦󰁶
絃	糹亠幺󰁶
組	糹󰀐一󰀝
絅	糹冂口󰀝
絆	糹丷󰀟󰀢
絇	糹勹口󰀝
絈	糹白󰀝
絉	糹木丶󰁶
絊	糹木一󰀝
絋	糹广厶󰁶
経	糹又土󰀝
絍	糹亻丿士
絎	糹彳一丁
絏	糹曰󰁒丿
結	糹士口󰀝
絑	糹丿未󰁶
絒	糹丶丿丨
絓	糹土土󰀝
絔	糹丆日󰀝
絕	糹刀巴󰁀
絖	糹⺌一儿
絗	糹囗口󰀝
絘	糹冫⺈人
絙	糹一日一
絚	糹一丨一
絛	亻丨夂小
絜	三丨刀小
絝	糹大二ㄅ
絞	糹六乂󰁶
絟	糹人王󰀝
絠	糹月󰀝
絡	糹夂口󰀝
絢	糹勹日󰀝
絣	糹䒑廾󰀢
絤	糹西󰀝
絥	糹亻犬󰁶
給	糹人一口
絧	糹冂一口
絨	糹戈󰁥
絩	糹儿󰀪󰁶
絪	糹囗大󰁶
絫	厶厶厶小
絬	糹丿古󰀝
絭	丷夫幺小
絮	女口幺小
絯	糹亠ㄥ人
絰	糹一厶土
統	糹亠厶儿
絲	糹幺小󰁶
絳	糹夂㐄󰀢
絴	糹羊󰀢
絵	糹人二厶
絶	糹⺈巴󰁀
絷	扌九丶小
絸	糹目儿󰁀
絹	糹口月󰀝
絺	糹乂丨
絻	糹⺈口󰁜
絼	糹豸󰁥
絽	糹口口󰀝
絾	糹戊𠃌󰁀
絿	糹一氺丶
綀	糹木口󰀝
綁	糹三丿阝
綂	糹󰁸儿󰁀
綃	糹⺌月󰀝
綄	糹宀二儿
綅	糹彐冖又
綆	糹一曰乂
綇	糹西一󰀝
綈	糹丷弓丿
綉	糹禾乃󰁥
綊	糹大人人
綋	糹宀厶
綌	糹八人口
綍	糹十冖子
綎	糹丿士廴
綏	糹爫女󰀝
綐	糹丷口儿
綑	糹囗木󰁶
綒	糹爫子󰀝
經	糹一巛工
綔	大二ㄅ小
綕	糹士心󰁶
綖	糹丿󰀥廴
綗	糹冂八口
綘	糹夂三丨
継	糹米󰄃󰁀
続	糹士冖儿
綛	糹刀丶心
綜	糹宀二小
綝	糹木木󰁶
綞	糹丿士󰁺
綟	糹丶尸犬
綠	糹彑氺󰁶
綡	糹󰁸小󰁶
綢	糹󰀼土口
綣	糹丷夫⺋
綤	刀口阝小
綥	糹田一󰀯
綦	󰀎八幺小
綧	糹󰁸子󰀝
綨	糹󰀎八󰁶
綩	糹宀夕⺋
綪	糹月󰀝
綫	糹戈戈󰁶
綬	糹爫冖又
維	糹亻󰁷󰀝
綮	丶尸攵小
綯	糹勹𠂉凵
綰	糹宀󰃧󰀝
綱	糹冂䒑山
網	糹冂䒑󰄃
綳	糹月月󰀝
綴	糹又又又
綵	糹爫木󰁶
綶	糹曰木󰁶
綷	糹亠人十
綸	糹人一艹
綹	糹夂卜口
綺	糹大丁口
綻	糹宀一󰁾
綼	糹白丿十
綽	糹󰀥早󰀢
綾	糹土八夂
綿	糹白冂丨
緀	糹一󰁬女
緁	糹一󰁬󰁾
緂	糹火火󰁶
緃	糹人人󰁾
緄	糹曰󰁴匕
緅	糹耳又󰁶
緆	糹曰勹󰁤
緇	糹巛田󰀝
緈	糹土䒑十
緉	糹一冂丶
緊	匚丨󰁃小
緋	糹丨三三
緌	糹禾女󰀝
緍	糹󰁚󰀁日
緎	糹戈口󰀞
総	糹八厶心
緐	𠂉母丿小
緑	糹󰁭氺󰁶
緒	糹土丿日
緓	糹艹ㄇ大
緔	糹⺌冂口
緕	糹文󰀳󰀝
緖	糹土丿日
緗	糹木目󰀝
緘	糹戊一口
緙	糹廿󰀜󰀢
線	糹白水󰁶
緛	糹丆冂大
緜	白冂丨小
緝	糹口耳󰀝
緞	糹丿丨又
緟	糹丿一土
締	糹亠丷丨
緡	糹󰁂󰀁日
緢	糹艹田󰀝
緣	糹彑󰀓󰁶
緤	糹廿󰄃木
緥	糹亻口木
緦	糹田心󰁶
緧	糹丷西一
編	糹丶尸艹
緩	糹爫一又
緪	糹忄一一
緫	糹勹󰁤心
緬	糹丆囗二
緭	糹田月󰀝
緮	糹𠂉曰夂
緯	糹󰁆口㐄
緰	糹人一刂
緱	糹亻ユ大
緲	糹目小丿
緳	广三丨小
練	糹木󰀹󰀝
緵	糹乂凵夂
緶	糹亻一乂
緷	糹冖車󰀢
緸	糹覀土󰀝
緹	糹日一󰁾
緺	糹ㄇ󰁈口
緻	糹一厶攵
緼	糹曰皿󰀝
緽	糹󰀥貝󰁶
緾	糹厂曰土
緿	糹厶口心
縀	糹󰁃丨又
縁	糹󰁭󰀓󰁶
縂	糹丷口心
縃	糹乛󰁾月
縄	糹曰曰乚
縅	糹戊一女
縆	糹忄一一
縇	糹宀一一
縈	火火冖小
縉	糹一业日
縊	糹䒑八皿
縋	糹丿󰃧辶
縌	糹䒑凵辶
縍	糹亠丷方
縎	糹󰀾月󰀝
縏	丿󰁪几小
縐	糹勹凵丿
縑	糹䒑󰁬八
縒	糹⺶工󰀝
縓	糹厂白小
縔	糹又又木
縕	糹囗人皿
縖	糹宀三口
縗	糹亠口󰀔
縘	糹爫幺大
縙	糹艹耳󰀝
縚	糹爫臼󰀝
縛	糹甫寸󰁶
縜	糹口貝󰁶
縝	糹十󰀣八
縞	糹󰁸冂口
縟	糹厂二寸
縠	士冖一又
縡	糹宀辛󰀢
縢	月丷夫小
縣	󰀣小丿小
縤	糹幺小
縥	糹三人禾
縦	糹彳䒑󰁾
縧	糹亻丨朩
縨	糹日⺌儿
縩	糹󰁯二小
縪	糹曰艹󰀟
縫	糹夂三辶
縬	糹戊上小
縭	糹亠乂厶
縮	糹宀亻日
縯	糹宀一八
縰	糹彳止󰁾
縱	糹彳人󰁾
縲	糹田幺小
縳	糹一曰寸
縴	糹亠幺󰀟
縵	糹曰罒又
縶	土䒑十小
縷	糹󰀻女󰀝
縸	糹艹曰大
縹	糹覀二小
縺	糹車辶󰁶
縻	广木木小
縼	糹方𠂉󰁾
總	糹丿囗心
績	糹貝󰁶
縿	糹厶厶彡
繀	糹山亻󰁷
繁	𠂉母攵小
繂	糹亠幺十
繃	糹山月月
繄	匚𠂉大小
繅	糹巛曰木
繆	糹羽人彡
繇	爫𠂉十小
繈	糹弓厶虫
繉	糹目儿󰀪
繊	糹十戈业
繋	車几又小
繌	糹丿囗夂
繍	糹󰁬米󰀯
繎	糹󰁝犬灬
繏	糹巳巳八
繐	糹一曰心
繑	糹丿大口
繒	糹丷󰀺日
繓	糹曰耳又
織	糹亠丷日
繕	糹羊䒑口
繖	糹󰁺月攵
繗	糹米夕㐄
繘	糹󰁻乛口
繙	糹丿米田
繚	糹大丷小
繛	幺小早
繜	糹丷西寸
繝	糹門月󰀝
繞	糹土土儿
繟	糹口口十
繠	心心心小
繡	糹󰁬十󰀲
繢	糹口丨貝
繣	糹󰁬土一
繤	艹目大小
繥	糹士口口
繦	糹弓口虫
繧	糹󰀙二厶
繨	糹土羊辶
繩	糹黽󰀝
繪	糹人一日
繫	車凵几小
繬	糹土人口
繭	艹冂丨虫
繮	糹一田一
繯	糹罒一󰀔
繰	糹口口木
繱	糹艹勹心
繲	糹⺈用󰀟
繳	糹白方攵
繴	尸口辛小
繵	糹亠囗一
繶	糹立曰心
繷	糹ㄇ󰁺󰀖
繸	糹䒑󰀓辶
繹	糹罒土十
繺	糹⺈彐灬
繻	糹󰀙丆〢
繼	糹幺幺󰄃
繽	糹宀一貝
繾	糹口丨辶
繿	糹匚丨皿
纀	糹亻业夫
纁	糹丿一灬
纂	⺮目大小
纃	糹󰀴󰀳󰀝
纄	糹艹夂辶
纅	糹白幺木
纆	糹󰀹土土
纇	米幺小貝
纈	糹士口貝
纉	糹夫夫貝
纊	糹广󰁺八
纋	糹丆󰀐夂
續	糹士罒貝
纍	田田田小
纎	糹十戈󰀞
纏	糹广曰土
纐	糹六乂貝
纑	糹虍田皿
纒	糹广曰土
纓	糹貝貝女
纔	糹⺈口丶
纕	糹亠口󰀔
纖	糹人人󰀞
纗	糹山亻口
纘	糹丿土貝
纙	糹罒糹󰁷
纚	糹一ㄇ匕
纛	母󰀣小
纜	糹匚丨儿
纝	糹田田小
纞	糹言糹心
纟	纟ㄥㄥ󰀞
纠	纟󰁐丨󰀢
纡	纟一󰀛󰀢
红	纟工󰀝
纣	纟寸󰁶
纤	纟丿十󰀢
纥	纟𠂉乙󰁀
约	纟勹丶󰁶
级	纟乃󰂃󰁶
纨	纟九丶󰁶
纩	纟广󰁥
纪	纟己󰁀
纫	纟刀丶󰁶
纬	纟二𠃌丨
纭	纟二厶󰁶
纮	纟厶󰁶
纯	纟一凵乚
纰	纟󰁴匕󰁀
纱	纟小丿󰁥
纲	纟冂乂󰁶
纳	纟冂人󰁶
纴	纟丿士󰀝
纵	纟人人󰁶
纶	纟人匕󰁀
纷	纟八刀󰁥
纸	纟󰁚󰀁󰁀
纹	纟文󰁶
纺	纟方󰁥
纻	纟宀一󰀝
纼	纟弓丨󰀢
纽	纟󰁈丨一
纾	纟󰁻乛亅
线	纟一戈󰁶
绀	纟甘󰀝
绁	纟廿󰄃󰁀
绂	纟又丶
练	纟󰀂𠃌八
组	纟󰀐一󰀝
绅	纟曰丨󰀢
细	纟田󰀝
织	纟口八󰁶
终	纟夂󰁦󰁶
绉	纟⺈彐󰀝
绊	纟丷󰀟󰀢
绋	纟弓󰀯󰀢
绌	纟凵山󰀢
绍	纟刀口󰀝
绎	纟又󰀟󰀢
经	纟ス工󰀝
绐	纟厶口󰀝
绑	纟三丿阝
绒	纟戈󰁥
结	纟士口󰀝
绔	纟大二ㄅ
绕	纟󰀁丿儿
绖	纟一厶土
绗	纟彳一丁
绘	纟人二厶
给	纟人一口
绚	纟勹日󰀝
绛	纟夂㐄󰀢
络	纟夂口󰀝
绝	纟⺈巴󰁀
绞	纟六乂󰁶
统	纟亠厶儿
绠	纟一曰乂
绡	纟⺌月󰀝
绢	纟口月󰀝
绣	纟禾乃󰁥
绤	纟八人口
绥	纟爫女󰀝
绦	纟夂朩󰁶
继	纟米󰄃󰁀
绨	纟丷弓丿
绩	纟贝󰁶
绪	纟土丿日
绫	纟土八夂
绬	纟艹ㄇ大
续	纟十乛大
绮	纟大丁口
绯	纟丨三三
绰	纟󰀥早󰀢
绱	纟⺌冂口
绲	纟曰󰁴匕
绳	纟口曰乚
维	纟亻󰁷󰀝
绵	纟白冂丨
绶	纟爫冖又
绷	纟月月󰀝
绸	纟󰀼土口
绹	纟勹𠂉凵
绺	纟夂卜口
绻	纟丷夫⺋
综	纟宀二小
绽	纟宀一󰁾
绾	纟宀󰃧󰀝
绿	纟󰁭氺󰁶
缀	纟又又又
缁	纟巛田󰀝
缂	纟廿󰀜󰀢
缃	纟木目󰀝
缄	纟戊一口
缅	纟丆囗二
缆	纟〢𠂉儿
缇	纟曰一󰁾
缈	纟目小丿
缉	纟口耳󰀝
缊	纟曰皿󰀝
缋	纟口丨贝
缌	纟田心󰁶
缍	纟丿士󰁺
缎	纟丿丨又
缏	纟亻一乂
缐	纟白水󰁶
缑	纟亻ユ大
缒	纟丿󰃧辶
缓	纟爫一又
缔	纟亠丷丨
缕	纟米女󰀝
编	纟丶尸艹
缗	纟󰁂󰀁曰
缘	纟彑󰀓󰁶
缙	纟一业日
缚	纟甫寸󰁶
缛	纟厂二寸
缜	纟十󰀣八
缝	纟夂三辶
缞	纟亠口󰀔
缟	纟󰁸冂口
缠	纟广曰土
缡	纟亠乂厶
缢	纟䒑八皿
缣	纟䒑󰁬八
缤	纟宀丘八
缥	纟覀二小
缦	纟曰罒又
缧	纟田幺小
缨	纟贝贝女
缩	纟宀亻日
缪	纟羽人彡
缫	纟巛曰木
缬	纟士口贝
缭	纟大丷小
缮	纟羊䒑口
缯	纟丷󰀺曰
缰	纟一田一
缱	纟口丨辶
缲	纟口口木
缳	纟罒一󰀔
缴	纟白方攵
缵	纟丿土贝
缶	𠂉十凵󰀵
缷	𠂉十凵卩
缸	𠂉十凵工
缹	𠂉十凵灬
缺	𠂉十凵人
缻	𠂉十凵丶
缼	𠂉十凵人
缽	𠂉十凵一
缾	𠂉十凵廾
缿	𠂉十凵口
罀	𠂉十凵󰀪
罁	𠂉十凵冂
罂	贝贝𠂉凵
罃	火火冖凵
罄	士󰁅几凵
罅	𠂉十凵󰀛
罆	𠂉十凵貝
罇	𠂉十凵寸
罈	𠂉十凵早
罉	𠂉十凵手
罊	車凵几凵
罋	亠󰁲丿凵
罌	貝貝𠂉凵
罍	田田田凵
罎	𠂉十凵厶
罏	𠂉十凵皿
罐	𠂉十凵󰁷
网	冂乂乂󰀦
罒	罒丨󰁈一
罓	ㄇ乂󰀦
罔	冂䒑亠󰄃
罕	冖八干󰀬
罖	罒人丶󰁧
罗	罒夕󰁧
罘	罒丆卜󰁧
罙	冖八木󰁧
罚	罒讠刂󰀬
罛	罒⺁厶󰂃
罜	罒丶王󰀘
罝	罒󰀐一󰀘
罞	罒󰁻乛丿
罟	罒古󰀘
罠	罒󰁂󰀁󰀅
罡	罒一止󰀘
罢	罒土厶󰁧
罣	罒土土󰀘
罤	罒丷弓丿
罥	罒口月󰀘
罦	罒爫子󰀘
罧	罒木木󰁧
罨	罒大曰乚
罩	罒󰀥早󰀬
罪	罒丨三三
罫	罒土土卜
罬	罒又又又
罭	罒戈口󰀞
置	罒十󰀣󰀘
罯	罒立日󰀘
罰	罒言刂󰀬
罱	罒十冂十
署	罒土丿日
罳	罒田心󰁧
罴	罒土厶灬
罵	罒󰀋灬󰁧
罶	罒󰁚丶田
罷	罒厶月匕
罸	罒言寸󰁧
罹	罒忄亻󰁷
罺	罒巛曰木
罻	罒尸二寸
罼	罒曰艹󰀟
罽	罒厂火刂
罾	罒丷󰀺曰
罿	罒立曰土
羀	ㄇ乂乂田
羁	罒廿󰀜一
羂	罒糹口月
羃	罒艹曰丨
羄	罒糹󰀥早
羅	罒糹亻󰁷
羆	罒厶月灬
羇	罒廿󰀜口
羈	罒廿󰀜灬
羉	罒言糹小
羊	羊丶丿丨
羋	丨一丨󰀟
羌	⺶乚󰁫
羍	大羊󰀬
美	丷王大󰁧
羏	⺶彡󰁥
羐	丨一󰀥󰂃
羑	丷王ク󰂃
羒	⺶八刀󰁥
羓	⺶巴󰁀
羔	丷王灬󰁧
羕	丷王丶󰀩
羖	⺶几又󰁶
羗	⺶乚厶󰀦
羘	月羊󰀢
羙	丷王火󰁧
羚	⺶人丶󰁻
羛	丷王弓󰀯
羜	⺶宀丁󰀢
羝	⺶󰁚󰀁丶
羞	⺶󰁈丨一
羟	⺶ス工󰀝
羠	⺶一弓人
羡	丷王冫人
羢	⺶戈󰁥
羣	󰁬丿口羊
群	󰁬丿口羊
羥	⺶一巛工
羦	⺶宀二儿
羧	⺶厶八夂
羨	丷王氵人
義	丷王丿丶
羪	⺶丶艮󰁶
羫	⺶宀八工
羬	⺶戊一口
羭	⺶人一刂
羮	丷王灬一
羯	⺶曰勹󰄃
羰	⺶山火
羱	⺶厂白小
羲	丷王禾丶
羳	⺶丿米田
羴	羊⺶羊󰀬
羵	⺶十艹貝
羶	⺶亠囗一
羷	⺶人一人
羸	󰄹月羊丶
羹	丷王灬大
羺	羊󰀙丆〢
羻	⺶󰁙乛夂
羼	尸羊⺶羊
羽	羽𠃌丶󰀞
羾	羽工󰀝
羿	羽廾󰀬
翀	羽口丨󰀢
翁	八厶羽󰀘
翂	羽八刀󰁥
翃	厶羽󰀝
翄	羽十又󰁶
翅	十又羽󰀌
翆	羽九十󰀬
翇	羽又丶
翈	甲羽󰀝
翉	木一羽󰀝
翊	立羽󰀝
翋	羽立󰀝
翌	羽立󰀘
翍	羽皮󰁶
翎	人丶󰁻羽
翏	羽人彡󰁣
翐	羽丿夫󰁶
翑	羽勹口󰀝
習	羽白󰀘
翓	士口羽󰀝
翔	⺶羽󰀝
翕	人一口羽
翖	人一口羽
翗	夕夕羽󰀝
翘	󰀁丿一羽
翙	山夕羽󰀝
翚	羽冖车󰀬
翛	亻丨夂羽
翜	羽大人人
翝	宀厶羽
翞	羽󰁸小󰁶
翟	羽亻󰁷󰀘
翠	羽亠人十
翡	丨三丨羽
翢	󰀼土口羽
翣	羽立女󰀘
翤	口冂艹羽
翥	土丿曰羽
翦	䒑月刂羽
翧	宀一曰羽
翨	羽曰一󰁾
翩	丶尸冂羽
翪	羽乂凵夂
翫	羽白二儿
翬	羽冖車󰀬
翭	羽亻ユ大
翮	一口冂羽
翯	羽󰁸冂口
翰	十早人羽
翱	白大十羽
翲	覀二小羽
翳	匚𠂉大羽
翴	羽車辶󰁶
翵	羽󰁟灬󰁶
翶	白󰀪十羽
翷	米夕㐄羽
翸	十艹貝羽
翹	土土土羽
翺	丿目󰀪羽
翻	丿米田羽
翼	羽田󰁺八
翽	止戊一羽
翾	罒一口羽
翿	士乛工羽
耀	⺌一儿󰁷
老	土丿匕󰀅
耂	土丿󰀏
考	土丿一ㄅ
耄	土丿匕毛
者	土丿曰󰀘
耆	土丿匕曰
耇	土丿勹口
耈	土丿匕口
耉	土丿丿口
耊	土丿一土
耋	土丿匕土
而	丆冂〢󰀬
耍	丆冂〢女
耎	丆冂〢大
耏	丆冂〢彡
耐	丆冂〢寸
耑	山丆冂〢
耒	二木󰀦
耓	二木丁󰀢
耔	二木子󰀝
耕	二木二󰀯
耖	二木小丿
耗	二木毛󰁀
耘	二木二厶
耙	二木巴󰁀
耚	二木皮󰁶
耛	二木厶口
耜	二木󰃧󰀝
耝	二木󰀐一
耞	二木力口
耟	二木匚󰁃
耠	二木人口
耡	二木󰀐力
耢	二木艹力
耣	二木人艹
耤	二木󰁺日
耥	二木⺌口
耦	二木曰丶
耧	二木米女
耨	二木厂寸
耩	二木󰀀土
耪	二木亠方
耫	二木貝
耬	二木󰀻女
耭	二木幺人
耮	二木火力
耯	二木艹又
耰	二木丆夂
耱	二木广石
耲	二木亠󰀔
耳	耳一丨一
耴	耳乚󰁀
耵	耳丁󰀢
耶	耳阝󰀢
耷	大耳󰀘
耸	人人耳󰀘
耹	耳人丶乛
耺	耳二厶󰁶
耻	耳止󰀝
耼	耳冂二󰀝
耽	耳冖󰁜󰁀
耾	耳厶󰁶
耿	耳火󰁶
聀	耳戈󰁶
聁	耳八刀󰁥
聂	耳又又󰁧
聃	耳冂土󰀝
聄	耳人彡󰁥
聅	耳𠂉大󰁶
聆	耳人丶󰁻
聇	耳一止󰀝
聈	耳幺力󰁥
聉	耳凵山󰀢
聊	耳󰁚丿卩
聋	ヒ丶耳
职	耳口八󰁶
聍	耳宀丁󰀢
聎	耳儿󰀪󰁶
聏	耳丆冂〢
聐	耳士口󰀝
聑	耳耳󰀝
聒	耳丿古󰀝
聓	工几丶耳
联	耳䒑大󰁶
聕	耳丿土口
聖	耳口王󰀘
聗	耳大人人
聘	耳由一ㄅ
聙	耳月󰀝
聚	耳又乑󰁧
聛	耳白丿十
聜	耳宀八工
聝	耳戈口󰀞
聞	門耳󰀌
聟	𠂉大口耳
聠	耳䒑廾󰀢
聡	耳八厶心
聢	耳宀一󰁾
聣	耳臼儿󰁀
聤	耳󰁸冖丁
聥	耳丿口丶
聦	耳勹󰁤心
聧	耳癶一大
聨	耳幺幺廾
聩	耳口丨贝
聪	耳丷口心
聫	耳幺幺大
聬	耳八厶羽
聭	耳白󰁜厶
聮	耳幺幺灬
聯	耳幺幺一
聰	耳丿囗心
聱	󰁡攵耳
聲	士󰁅几耳
聳	彳人人耳
聴	耳十罒心
聵	耳口丨貝
聶	耳耳耳󰀘
職	耳亠丷日
聸	耳⺈厂言
聹	耳宀心丁
聺	耳宀󰁯小
聻	氵車斤耳
聼	乛耳十心
聽	耳王十心
聾	立月一耳
聿	󰁬󰀟󰀵
肀	󰁬丨󰀵
肁	丶尸󰁬󰀟
肂	一夕󰁬󰀟
肃	󰁬丨󰀯八
肄	匕𠂉大󰀟
肅	󰁬十󰀲󰀵
肆	󰂞󰁬󰀟󰀢
肇	丶尸攵󰀟
肈	丶尸戈󰀟
肉	冂人人󰀦
肊	月乙󰁀
肋	月力󰁥
肌	月几󰁀
肍	月九󰁀
肎	冖月󰀘
肏	丿󰂃冂人
肐	月𠂉乙󰁀
肑	月勹丶󰁶
肒	月九丶󰁶
肓	亠󰄃月󰀘
肔	月也󰁀
肕	月刀丶󰁶
肖	⺌月󰀘
肗	月女󰀝
肘	月寸󰁶
肙	口月󰀘
肚	月土󰀝
肛	月工󰀝
肜	月彡󰁥
肝	月干󰀢
肞	月丶乂󰁶
肟	月二ㄅ󰁀
肠	月ㄋ󰁤󰁥
股	月几又󰁶
肢	月十又󰁶
肣	月人丶乛
肤	月夫󰁶
肥	月巴󰁀
肦	󰀼冫八刀
肧	月丆卜󰁶
肨	月三丨󰀢
肩	丶尸月󰀌
肪	月方󰁥
肫	月一凵乚
肬	月乚丶
肭	月冂人󰁶
肮	月亠几󰁀
肯	止月󰀘
肰	月犬󰁶
肱	月厶󰁶
育	亠厶月󰀘
肳	月勹󰁤󰁥
肴	乂月󰀘
肵	月斤󰀢
肶	月󰁴匕󰁀
肷	月⺈人󰁶
肸	月八十󰀢
肹	月八一ㄅ
肺	月一冂丨
肻	󰀥冖月󰀘
肼	月二󰀯󰀢
肽	月大丶󰁶
肾	〢又月󰀘
肿	月口丨󰀢
胀	月丿七󰂃
胁	月力八󰁶
胂	月曰丨󰀢
胃	田月󰀘
胄	由月󰀘
胅	月丿夫󰁶
胆	月曰一󰀝
胇	月弓󰀯󰀢
胈	月又丶
胉	月白󰀝
胊	󰀼冫勹口
胋	月󰀥口󰀝
背	丬匕月󰀘
胍	月⺁厶󰂃
胎	月厶口󰀝
胏	月丿ㄅ丿
胐	󰀼冫凵山
胑	月口八󰁶
胒	月尸匕󰁀
胓	月一丷十
胔	止匕冂人
胕	月亻寸󰁶
胖	月丷󰀟󰀢
胗	月人彡󰁥
胘	月亠幺󰁶
胙	月𠂉丨二
胚	月丆卜一
胛	月甲󰀢
胜	月丿󰀝
胝	月󰁚󰀁丶
胞	月勹巳󰁀
胟	月母󰁶
胠	月土厶󰁶
胡	古月󰀝
胢	月丁口󰀝
胣	月𠂉也󰁀
胤	丿幺月乚
胥	乛󰁾月󰀘
胦	月ㄇ大󰁶
胧	月ヒ丶
胨	月󰀂小󰁶
胩	月上卜󰁶
胪	月󰀥尸󰁥
胫	月ス工󰀝
胬	女又冂人
胭	月囗大󰁶
胮	月夂㐄󰀢
胯	月大二ㄅ
胰	月一弓人
胱	月⺌一儿
胲	月亠ㄥ人
胳	月夂口󰀝
胴	月冂一口
胵	月一厶土
胶	月六乂󰁶
胷	勹乂凵月
胸	月勹乂凵
胹	月丆冂〢
胺	月宀女󰀝
胻	月彳一丁
胼	月䒑廾󰀢
能	厶月匕匕
胾	十戈冂人
胿	月土土󰀝
脀	了󰀩一月
脁	󰀼冫儿󰀪
脂	月匕日󰀝
脃	月⺈巴󰁀
脄	月火󰁶
脅	力力力月
脆	月⺈厂⺋
脇	月力力力
脈	月⺁󰀕󰁶
脉	月丶𠃌󰀩
脊	󰀪人月󰀘
脋	刀刀刀月
脌	月𠂉㐄󰀢
脍	月人二厶
脎	月乂朩󰁶
脏	月广土󰀝
脐	月文󰀯󰀢
脑	月亠乂凵
脒	月米󰁶
脓	月冖󰀔󰁶
脔	亠󰁗冂人
脕	月⺈口󰁜
脖	月十冖子
脗	月勹󰁤口
脘	月宀二儿
脙	月一氺丶
脚	月土厶卩
脛	月一巛工
脜	月丆目󰀝
脝	月󰁸了󰀢
脞	月人人土
脟	月爫寸󰁶
脠	月丿󰀥廴
脡	月丿士廴
脢	月𠂉母󰁶
脣	厂二󰀖月
脤	月厂二󰀖
脥	月大人人
脦	月󰀁心丶
脧	󰀼冫厶夂
脨	月木口󰀝
脩	亻丨夂月
脪	月乂丨
脫	月八口儿
脬	月爫子󰀝
脭	月口王󰀝
脮	月爫女󰀝
脯	月甫󰁶
脰	月一口䒑
脱	月丷口儿
脲	月尸水󰁶
脳	月󰀧乂凵
脴	月丆卜口
脵	月口一大
脶	月口冂人
脷	月禾刂󰀢
脸	月人一一
脹	月󰀍󰀖󰁶
脺	月亠人十
脻	月一󰁬󰁾
脼	月一冂󰂃
脽	月亻󰁷󰀝
脾	月白丿十
脿	月󰀔󰁶
腀	月人一艹
腁	月丿一干
腂	月曰木󰁶
腃	月丷夫⺋
腄	月丿士󰁺
腅	月火火󰁶
腆	月ㄇ󰁺八
腇	月禾女󰀝
腈	月月󰀝
腉	月臼儿󰁀
腊	月󰁺日󰀝
腋	月亠亻丶
腌	月大曰乚
腍	月人丶心
腎	匚丨󰁃月
腏	月又又又
腐	广亻寸人
腑	月广亻寸
腒	月尸古󰀝
腓	月丨三三
腔	月宀八工
腕	月宀夕⺋
腖	月木曰󰀝
腗	月由一󰀯
腘	月囗王丶
腙	月宀二小
腚	月宀一󰁾
腛	月尸一土
腜	月甘木󰁶
腝	月丆冂大
腞	月彑󰀓󰁶
腟	月宀一土
腠	月三人大
腡	月ㄇ󰁈口
腢	月曰冂丶
腣	月亠丷丨
腤	月立日󰀝
腥	月曰丿
腦	月巛丿乂
腧	月人一刂
腨	月山丆〢
腩	月十冂十
腪	月冖車󰀢
腫	月丿一土
腬	月󰁻乛木
腭	月口口ㄅ
腮	月田心󰁶
腯	月⺁十目
腰	月覀女󰀝
腱	月󰁬󰀟廴
腲	月田一󰀖
腳	月八人卩
腴	月臼人󰁶
腵	月󰁃丨又
腶	月丿丨又
腷	月一口田
腸	月日一󰁤
腹	月𠂉曰夂
腺	月白水󰁶
腻	月󰀁二丶
腼	月丆囗二
腽	月日皿󰀝
腾	月丷夫一
腿	月艮辶󰁶
膀	月亠丷方
膁	月䒑󰁬八
膂	方𠂉󰀕月
膃	月囗人皿
膄	月臼丨又
膅	月广󰁬口
膆	月幺小
膇	月丿󰃧辶
膈	月一口丨
膉	月䒑八皿
膊	月甫寸󰁶
膋	火火冖月
膌	月󰀨人月
膍	月丿囗匕
膎	月爫幺大
膏	󰁸冖口月
膐	方𠂉󰀕人
膑	月宀丘八
膒	月匚口口
膓	月𠂉曰󰁤
膔	月󰁙󰁴匕
膕	月囗戈󰀞
膖	月夂三辶
膗	月山亻󰁷
膘	月覀二小
膙	月弓口虫
膚	虍田月󰀌
膛	月⺌冖土
膜	月艹曰大
膝	月木人氺
膞	月一曰寸
膟	月亠幺十
膠	月羽人彡
膡	月丷夫目
膢	月󰀻女󰀝
膣	月宀八土
膤	月󰀙彐󰀝
膥	一木戊人
膦	月米夕㐄
膧	󰀼冫立土
膨	月士口彡
膩	月󰀁二丶
膪	月亠丷口
膫	月大丷小
膬	月毛毛毛
膭	月口丨貝
膮	月土土儿
膯	月癶一䒑
膰	月丿米田
膱	月亠丷日
膲	月亻󰁷灬
膳	月羊䒑口
膴	月𠂉一灬
膵	月艹亠十
膶	月門王󰀝
膷	月󰁲丿阝
膸	月工辶
膹	月十艹貝
膺	广亻亻月
膻	月亠囗一
膼	月ㄇ󰁈辶
膽	月⺈厂言
膾	月人一日
膿	月ㄇ󰁺󰀖
臀	尸󰁺八月
臁	月广䒑八
臂	尸口辛月
臃	月亠󰁲󰁷
臄	月虍一󰀓
臅	月罒勹虫
臆	月立曰心
臇	月亻󰁷𠃌
臈	月艹曰󰄃
臉	月人一人
臊	月口口木
臋	尸󰁺八几
臌	月士口又
臍	月󰀴󰀳󰀝
臎	月羽亠十
臏	月宀一貝
臐	月丿一灬
臑	月󰀙丆〢
臒	月艹亻又
臓	月艹戊丨
臔	月匚丨貝
臕	月󰁙󰁴灬
臖	󰀗冂一月
臗	月宀艹丶
臘	月巛囗󰁒
臙	月廿口灬
臚	月虍田皿
臛	月󰀙亻󰁷
臜	月丿土贝
臝	󰄹月日丶
臞	月目目󰁷
臟	月艹戈丨
臠	言糹糹人
臡	廿口夫人
臢	月丿土貝
臣	匚丨󰁃丨
臤	匚丨󰁃又
臥	匚丨󰁃人
臦	󰁃丨匚丨
臧	戈爿匚丨
臨	匚丨󰁃口
臩	󰁃丨匚󰀯
自	丿目󰀌
臫	丿目乚󰁀
臬	丿目木󰁧
臭	丿目犬󰁧
臮	丿目亻丶
臯	丿目󰀪十
臰	丿目一匕
臱	丿目宀方
臲	丿目木⺋
至	一厶土󰀘
致	一厶土攵
臵	一厶土口
臶	一厶土子
臷	十戈一土
臸	一厶土土
臹	一厶土𠃌
臺	士口冖土
臻	一厶土禾
臼	臼丿丨一
臽	⺈臼󰀘
臾	臼人󰀦
臿	丿十臼󰀌
舀	爫臼󰀘
舁	臼廾󰀬
舂	三人臼󰀘
舃	臼一ㄅ灬
舄	臼勹灬󰁧
舅	臼田力󰁣
舆	󰀗车一八
與	󰀗一󰁕八
興	󰀗ㄇ一八
舉	󰀗一󰁕󰀟
舊	艹亻󰁷臼
舋	󰀗ㄇ一一
舌	丿古󰀌
舍	人干口󰀘
舎	人土口󰀘
舏	丿古󰁐丨
舐	丿古󰁚󰀁
舑	丿古冂土
舒	人干口亅
舓	丿古日󰁤
舔	丿古一⺗
舕	丿古火火
舖	人干口甫
舗	人土口甫
舘	人干口󰃧
舙	丿古丿古
舚	丿古⺈言
舛	夕㐄󰀢
舜	爫冖夕㐄
舝	󰁆巛冖㐄
舞	𠂉一󰀷㐄
舟	丿󰁪󰀦
舠	丿󰁪刀󰁥
舡	丿󰁪工󰀝
舢	丿󰁪山󰀢
舣	丿󰁪丶乂
舤	丿󰁪几丶
舥	丿󰁪巴󰁀
舦	丿󰁪大丶
舧	丿󰁪丿丶
舨	丿󰁪⺁又
舩	丿󰁪八厶
航	丿󰁪亠几
舫	丿󰁪方󰁥
般	丿󰁪几又
舭	丿󰁪󰁴匕
舮	丿󰁪丶尸
舯	丿󰁪口丨
舰	丿󰁪ㄇ儿
舱	丿󰁪人⺋
舲	丿󰁪人󰁻
舳	丿󰁪由󰀝
舴	丿󰁪𠂉二
舵	丿󰁪宀匕
舶	丿󰁪白󰀝
舷	丿󰁪亠幺
舸	丿󰁪丁口
船	丿󰁪几口
舺	丿󰁪甲󰀢
舻	丿󰁪󰀥尸
舼	丿󰁪󰁺八
舽	丿󰁪夂㐄
舾	丿󰁪西󰀝
舿	丿󰁪大ㄅ
艀	丿󰁪爫子
艁	丿󰁪丿口
艂	丿󰁪夂丨
艃	丿󰁪曰土
艄	丿󰁪⺌月
艅	丿󰁪人朩
艆	丿󰁪丶艮
艇	丿󰁪丿廴
艈	丿󰁪亠󰀸
艉	丿󰁪尸毛
艊	丿󰁪白丨
艋	丿󰁪子皿
艌	丿󰁪人心
艍	丿󰁪尸古
艎	丿󰁪白王
艏	丿󰁪䒑目
艐	丿󰁪乂夂
艑	丿󰁪丶艹
艒	丿󰁪󰀰目
艓	丿󰁪廿木
艔	丿󰁪广又
艕	丿󰁪亠方
艖	丿󰁪⺶工
艗	丿󰁪䒑皿
艘	丿󰁪臼又
艙	丿󰁪人口
艚	丿󰁪一日
艛	丿󰁪󰀻女
艜	丿󰁪廿丨
艝	丿󰁪󰀙彐
艞	丿󰁪⺮󰀪
艟	丿󰁪立土
艠	丿󰁪癶䒑
艡	丿󰁪⺌田
艢	丿󰁪土口
艣	丿󰁪虍力
艤	丿󰁪丷丶
艥	丿󰁪口丶
艦	丿󰁪匚皿
艧	丿󰁪艹又
艨	丿󰁪艹󰀓
艩	丿󰁪󰀴󰀳
艪	丿󰁪󰁢日
艫	丿󰁪虍皿
艬	丿󰁪⺈丶
艭	丿󰁪亻又
艮	艮󰁈一󰂃
良	丶艮󰀦
艰	又艮󰁶
艱	廿口夫艮
色	⺈巴󰀅
艳	三丨⺈巴
艴	弓󰀯⺈巴
艵	䒑廾⺈巴
艶	ㄇ󰁺一巴
艷	山三丨巴
艸	凵丿凵丨
艹	艹一丨丨
艺	艹乙󰀅
艻	艹力󰁣
艼	艹丁󰀬
艽	艹九󰀅
艾	艹乂󰁧
艿	艹乃󰁣
芀	艹刀󰁣
芁	艹几󰀅
节	艹ㄗ󰀬
芃	艹几丶󰁧
芄	艹九丶󰁧
芅	艹󰀁丶󰁧
芆	艹又丶󰁧
芇	艹冂丨󰀬
芈	丨一󰀥󰀟
芉	艹干󰀬
芊	艹丿十󰀬
芋	艹一󰀛󰀬
芌	艹二ㄅ󰀅
芍	艹勹丶󰁧
芎	艹弓󰀅
芏	艹土󰀘
芐	艹一卜󰁧
芑	艹己󰀅
芒	艹亠󰄃󰀅
芓	艹子󰀘
芔	凵丨凵丨
芕	艹夕󰁧
芖	艹大󰁧
芗	艹󰁲丿󰁣
芘	艹󰁴匕󰀅
芙	艹夫󰁧
芚	艹一凵乚
芛	艹󰁬丿󰁣
芜	艹二󰁜󰀅
芝	艹之󰁧
芞	艹气󰀅
芟	艹几又󰁧
芠	艹文󰁧
芡	艹⺈人󰁧
芢	艹亻二󰀘
芣	艹丆卜󰁧
芤	艹孑乚󰀅
芥	艹人󰀯󰀬
芦	艹丶尸󰁣
芧	艹󰁻乛亅
芨	艹乃󰂃󰁧
芩	艹人丶乛
芪	艹󰁚󰀁󰀅
芫	艹二儿󰀅
芬	艹八刀󰁣
芭	艹巴󰀅
芮	艹冂人󰁧
芯	艹心󰁧
芰	艹十又󰁧
花	艹亻ヒ󰀅
芲	艹人ヒ󰀅
芳	艹方󰁣
芴	艹勹󰁤󰁣
芵	艹ユ人󰁧
芶	艹勹厶󰁧
芷	艹止󰀘
芸	艹二厶󰁧
芹	艹斤󰀬
芺	艹丿大󰁧
芻	勹凵丿丿
芼	艹毛󰀅
芽	艹󰀄亅丿
芾	艹一冂丨
芿	艹亻乃󰁣
苀	艹亠几󰀅
苁	艹人人󰁧
苂	艹火󰁧
苃	艹又󰁧
苄	艹亠卜󰁧
苅	艹乂刂󰀬
苆	艹七刀󰁣
苇	艹二𠃌丨
苈	艹厂力󰁣
苉	艹匚儿󰀅
苊	艹厂⺋󰀅
苋	艹ㄇ󰁜󰀅
苌	艹丿七󰂃
苍	艹人⺋󰀅
苎	艹宀一󰀘
苏	艹力八󰁧
苐	艹弓丨丿
苑	艹夕⺋󰀅
苒	艹冂土󰀘
苓	艹人丶󰁻
苔	艹厶口󰀘
苕	艹刀口󰀘
苖	艹由󰀘
苗	艹田󰀘
苘	艹冂口󰀘
苙	艹立󰀘
苚	艹用󰀬
苛	艹丁口󰀘
苜	艹目󰀘
苝	艹丬匕󰀅
苞	艹勹巳󰀅
苟	艹勹口󰀘
苠	艹󰁂󰀁󰀅
苡	艹󰁐丶人
苢	艹󰃧󰀘
苣	艹匚󰁃󰀘
苤	艹丆卜一
若	艹口󰀘
苦	艹古󰀘
苧	艹宀丁󰀬
苨	艹尸匕󰀅
苩	艹白󰀘
苪	艹一冂人
苫	艹󰀥口󰀘
苬	艹囗人󰁧
苭	艹幺力󰁣
苮	艹亻山󰀬
苯	艹木一󰀘
苰	艹弓厶󰁧
英	艹ㄇ大󰁧
苲	艹𠂉丨二
苳	艹夂󰁦󰁧
苴	艹󰀐一󰀘
苵	艹丿夫󰁧
苶	艹人小󰁧
苷	艹甘󰀘
苸	艹丿丷󰀛
苹	艹一丷十
苺	艹母󰁧
苻	艹亻寸󰁧
苼	艹丿󰀘
苽	艹⺁厶󰂃
苾	艹心丿󰁣
苿	艹未󰁧
茀	艹弓󰀯󰀬
茁	艹凵山󰀬
茂	艹戊󰁧
范	艹氵⺋󰀅
茄	艹力口󰀘
茅	艹󰁻乛丿
茆	艹󰁚丿卩
茇	艹又丶
茈	艹止匕󰀅
茉	艹一木󰁧
茊	艹丘󰀘
茋	艹󰁚󰀁丶
茌	艹亻士󰀘
茍	丨一󰀥口
茎	艹ス工󰀘
茏	艹ヒ丶
茐	艹勹󰁤󰂃
茑	艹󰁠一󰀘
茒	艹夕阝󰀬
茓	艹宀八󰁧
茔	艹冖土󰀘
茕	艹冖⺄十
茖	艹夂口󰀘
茗	艹夕口󰀘
茘	艹刀刀刀
茙	艹戈󰁣
茚	艹󰁚一卩
茛	艹艮󰁧
茜	艹西󰀘
茝	艹匚丨丨
茞	艹匚丨丨
茟	艹󰁬󰀟󰀬
茠	艹亻木󰁧
茡	艹宀子󰀘
茢	艹一夕刂
茣	艹口一大
茤	艹夕夕󰁧
茥	艹土土󰀘
茦	艹木冂󰀅
茧	艹虫󰁧
茨	艹冫⺈人
茩	艹⺁一口
茪	艹⺌一儿
茫	艹氵亠󰄃
茬	艹丨土
茭	艹六乂󰁧
茮	艹上小󰁧
茯	艹亻犬󰁧
茰	艹曰乂󰁧
茱	艹丿未󰁧
茲	艹幺幺󰁧
茳	艹氵工󰀘
茴	艹囗口󰀘
茵	艹囗大󰁧
茶	艹人朩󰁧
茷	艹亻戈󰁧
茸	艹耳󰀘
茹	艹女口󰀘
茺	艹亠厶儿
茻	凵丿凵丨
茼	艹冂一口
茽	艹亻口丨
茾	艹一廾󰀬
茿	艹工几丶
荀	艹勹日󰀘
荁	艹一曰一
荂	艹大二ㄅ
荃	艹人王󰀘
荄	艹亠ㄥ人
荅	艹人一口
荆	艹一廾刂
荇	艹彳一丁
荈	艹夕㐄󰀬
草	艹早󰀬
荊	艹一廾刂
荋	艹丆冂〢
荌	艹宀女󰀘
荍	艹󰁐丨攵
荎	艹一厶土
荏	艹亻丿士
荐	艹丨子
荑	艹一弓人
荒	艹亠󰄃󰀸
荓	艹䒑廾󰀬
荔	艹力力力
荕	艹月力󰁣
荖	艹土丿匕
荗	艹戈人󰁧
荘	艹丬士󰀘
荙	艹大辶󰁧
荚	艹一丷大
荛	艹󰀁丿儿
荜	艹󰁴匕十
荝	艹贝刂󰀬
荞	艹丿大󰀯
荟	艹人二厶
荠	艹文󰀯󰀬
荡	艹氵ㄋ󰁤
荢	艹宀一󰀛
荣	艹冖木󰁧
荤	艹冖车󰀬
荥	艹冖水󰁧
荦	艹冖丿󰀟
荧	艹冖火󰁧
荨	艹彐寸󰁧
荩	艹尸󰂃󰁦
荪	艹孑小󰁧
荫	艹阝月󰀘
荬	艹乛󰁦大
荭	艹纟工󰀘
荮	艹纟寸󰁧
药	艹纟勹丶
荰	艹木土󰀘
荱	艹尸毛󰀅
荲	艹曰土󰀘
荳	艹一口䒑
荴	艹扌夫󰁧
荵	艹刀丶心
荶	艹口人乛
荷	艹亻丁口
荸	艹十冖子
荹	艹止󰀤󰁣
荺	艹土勹冫
荻	艹犭󰁥火
荼	艹人一朩
荽	艹爫女󰀘
荾	艹厶八夂
荿	艹戊𠃌󰀅
莀	艹厂二󰀖
莁	艹工人人
莂	艹口力刂
莃	艹乂丨
莄	艹一曰乂
莅	艹亻立󰀘
莆	艹甫󰁧
莇	艹󰀐󰀞力
莈	艹氵几又
莉	艹禾刂󰀬
莊	艹爿士󰀘
莋	艹亻𠂉二
莌	艹丷口儿
莍	艹一氺丶
莎	艹氵小丿
莏	艹扌小丿
莐	艹氵冖󰁜
莑	艹夂三丨
莒	艹口口󰀘
莓	艹𠂉母󰁧
莔	艹囗八ㄇ
莕	艹木口󰀘
莖	艹一巛工
莗	艹車󰀬
莘	艹辛󰀬
莙	艹󰁬丿口
莚	艹丿󰀥廴
莛	艹丿士廴
莜	艹亻丨攵
莝	艹人人土
莞	艹宀二儿
莟	艹人丶口
莠	艹禾乃󰁣
莡	艹口󰁾󰁧
莢	艹大人人
莣	艹亠󰄃心
莤	艹西一󰀘
莥	艹犭󰁥一
莦	艹⺌月󰀘
莧	艹目儿󰀅
莨	艹丶艮󰁧
莩	艹爫子󰀘
莪	艹丿扌丶
莫	艹曰大󰁧
莬	艹⺈口󰁜
莭	艹󰁮卩󰀬
莮	艹田力󰁣
莯	艹氵木󰁧
莰	艹土⺈人
莱	艹一丷木
莲	艹车辶󰁧
莳	艹日寸󰁧
莴	艹口冂人
莵	艹丿口丶
莶	艹人一一
获	艹犭󰁥犬
莸	艹犭󰁥丶
莹	艹冖王丶
莺	艹冖󰁠一
莻	艹乃口匕
莼	艹纟一乚
莽	艹犬廾󰀬
莾	艹大十廾
莿	艹木冂刂
菀	艹宀夕⺋
菁	艹月󰀘
菂	艹白勹丶
菃	艹氵匚󰁃
菄	艹木曰󰀘
菅	艹宀󰃧󰀘
菆	艹耳又󰁧
菇	艹女古󰀘
菈	艹扌立󰀘
菉	艹󰁭氺󰁧
菊	艹勹米󰁧
菋	艹口未󰁧
菌	艹囗禾󰁧
菍	艹人丶乛
菎	艹曰󰁴匕
菏	艹氵丁口
菐	业䒑夫󰁧
菑	艹巛田󰀘
菒	艹曰木󰁧
菓	艹曰木󰁧
菔	艹月卩又
菕	艹人一艹
菖	艹曰曰󰀘
菗	艹扌由󰀘
菘	艹木八厶
菙	艹丿士󰁺
菚	艹戈戈󰁧
菛	艹門󰀘
菜	艹爫木󰁧
菝	艹扌丶
菞	艹禾勹丿
菟	艹⺈口丶
菠	艹氵皮󰁧
菡	艹了󰀪凵
菢	艹扌勹巳
菣	艹匚丨又
菤	艹丷夫⺋
菥	艹木斤󰀬
菦	艹斤辶󰁧
菧	艹广󰁚丶
菨	艹立女󰀘
菩	艹立口󰀘
菪	艹宀石󰀘
菫	艹一口
菬	艹氵刀口
菭	艹氵厶口
菮	艹广󰁬人
華	艹一艹󰀟
菰	艹孑⺁󰂃
菱	艹土八夂
菲	艹丨三三
菳	艹金󰀘
菴	艹大曰乚
菵	艹冂䒑󰄃
菶	艹三人󰀟
菷	艹彐冖丨
菸	艹方人󰁦
菹	艹氵󰀐一
菺	艹丶尸月
菻	艹木木󰁧
菼	艹火火󰁧
菽	艹上小又
菾	艹一大⺗
菿	艹一厶刂
萀	艹虍几󰀅
萁	艹󰀎八󰁧
萂	艹禾口󰀘
萃	艹亠人十
萄	艹勹𠂉凵
萅	艹一凵日
萆	艹白丿十
萇	艹󰀍󰀖󰁧
萈	艹目儿丶
萉	艹月巴󰀅
萊	艹木人人
萋	艹一󰁬女
萌	艹日月󰀘
萍	艹氵一十
萎	艹禾女󰀘
萏	艹⺈臼󰀘
萐	艹一󰁬󰁾
萑	艹亻󰁷󰀘
萒	艹六厶儿
萓	艹宀󰀐一
萔	艹扌刀口
萕	艹文󰀳󰀘
萖	艹臼儿󰀅
萗	艹宀二小
萘	艹大二小
萙	艹木冖󰁜
萚	艹扌又󰀟
萛	艹目廾󰀬
萜	艹冂丨口
萝	艹罒夕󰁧
萞	艹ㄇ人󰁴
萟	艹禾九丶
萠	艹月月󰀘
萡	艹氵白󰀘
萢	艹氵勹巳
萣	艹宀一󰁾
萤	艹冖虫󰁧
营	艹冖口口
萦	艹冖幺小
萧	艹󰁬丨八
萨	艹阝立丿
萩	艹禾火󰁧
萪	艹禾󰁦十
萫	艹禾日󰀘
萬	艹曰冂丶
萭	艹丿口丶
萮	艹人一刂
萯	艹⺈貝󰁧
萰	艹木󰀹󰀘
萱	艹宀一一
萲	艹爫一又
萳	艹十冂十
萴	艹貝刂󰀬
萵	艹ㄇ󰁈口
萶	艹三人日
萷	艹⺌月刂
萸	艹臼人󰁧
萹	艹丶尸艹
萺	艹󰀰目󰀘
萻	艹立曰󰀘
萼	艹口口ㄅ
落	艹氵夂口
萾	艹乃又皿
萿	艹氵丿古
葀	艹扌丿古
葁	艹丷王女
葂	艹⺈口力
葃	艹日𠂉二
葄	艹月𠂉二
葅	艹人人一
葆	艹亻口木
葇	艹󰁻乛木
葈	艹厶口木
葉	艹廿󰄃木
葊	艹人一廾
葋	艹月勹口
葌	艹女女女
葍	艹一口田
葎	艹彳󰁬󰀟
葏	艹氵󰁬󰀟
葐	艹八刀皿
葑	艹土土寸
葒	艹糹工󰀘
葓	艹氵󰁺八
葔	艹亻ユ大
葕	艹彳氵丁
葖	艹宀八犬
著	艹土丿曰
葘	艹巛一田
葙	艹木目󰀘
葚	艹󰀎八󰄃
葛	艹曰勹󰄃
葜	艹三丨大
葝	艹一巛力
葞	艹弓耳󰀘
葟	艹白王󰀘
葠	艹亻彐又
葡	艹勹甫󰁧
葢	艹大丶皿
董	艹丿一土
葤	艹糹寸󰁧
葥	艹䒑月刂
葦	艹󰁆口㐄
葧	艹十冖力
葨	艹田一󰀖
葩	艹白巴󰀅
葪	艹⺈用刂
葫	艹古月󰀘
葬	艹一夕廾
葭	艹󰁃丨又
葮	艹丿丨又
葯	艹糹勹丶
葰	艹亻厶夂
葱	艹勹󰁤心
葲	艹白水󰁧
葳	艹戊一女
葴	艹戊一口
葵	艹癶一大
葶	艹󰁸冖丁
葷	艹冖車󰀬
葸	艹田心󰁧
葹	艹方𠂉也
葺	艹口耳󰀘
葻	艹几丿虫
葼	艹乂凵夂
葽	艹覀女󰀘
葾	艹夕⺋心
葿	艹󰁅目󰀘
蒀	艹曰皿󰀘
蒁	艹木丶辶
蒂	艹亠丷丨
蒃	艹彑󰀓󰁧
蒄	艹冖二寸
蒅	艹氵九木
蒆	艹工几女
蒇	艹戊贝󰁧
蒈	艹󰁴匕白
蒉	艹口丨贝
蒊	艹亻ヒ匕
蒋	艹丬夕寸
蒌	艹米女󰀘
蒍	艹丶丿灬
蒎	艹氵⺁󰀕
蒏	艹冖西一
蒐	艹白󰁜厶
蒑	艹⺁彐又
蒒	艹丿󰃧丨
蒓	艹糹一乚
蒔	艹日土寸
蒕	艹囗人皿
蒖	艹十󰀣八
蒗	艹氵丶艮
蒘	艹女口手
蒙	艹冖二󰀓
蒚	艹一口丨
蒛	艹𠂉十人
蒜	艹二小小
蒝	艹厂白小
蒞	艹氵亻立
蒟	艹立勹口
蒠	艹丿目心
蒡	艹亠丷方
蒢	艹阝人朩
蒣	艹彳人朩
蒤	艹氵人朩
蒥	艹󰁚丶田
蒦	艹亻󰁷又
蒧	艹戊󰀥口
蒨	艹亻月
蒩	艹禾󰀐一
蒪	艹甫寸󰁧
蒫	艹⺶工󰀘
蒬	艹冖⺈丶
蒭	艹勹凵丿
蒮	艹冖亻󰁷
蒯	艹月月刂
蒰	艹丿󰁪又
蒱	艹扌甫󰁧
蒲	艹氵甫󰁧
蒳	艹糹冂人
蒴	艹䒑凵月
蒵	艹爫幺大
蒶	艹糹八刀
蒷	艹口貝󰁧
蒸	艹了󰀩灬
蒹	艹䒑󰁬八
蒺	艹疒𠂉大
蒻	艹弓冫冫
蒼	艹人丶口
蒽	艹囗大心
蒾	艹米辶󰁧
蒿	艹󰁸冂口
蓀	艹孑丿小
蓁	艹三人禾
蓂	艹冖曰六
蓃	艹臼丨又
蓄	艹亠幺田
蓅	艹氵亠󰀸
蓆	艹广廿丨
蓇	艹󰀾月󰀘
蓈	艹丶󰁮阝
蓉	艹宀八口
蓊	艹八厶羽
蓋	艹土厶皿
蓌	艹人人夂
蓍	艹土丿曰
蓎	艹广󰁬口
蓏	艹⺁厶󰂃
蓐	艹厂二寸
蓑	艹亠口󰀔
蓒	艹車干󰀬
蓓	艹亻立口
蓔	艹丷王灬
蓕	艹木土土
蓖	艹丿囗匕
蓗	艹彳土󰁾
蓘	艹六厶󰀔
蓙	艹广人土
蓚	艹亻丨彡
蓛	艹木冂攵
蓜	艹西一己
蓝	艹〢𠂉皿
蓞	艹爫臼󰀘
蓟	艹󰁢󰀞刂
蓠	艹亠乂厶
蓡	艹氵彐又
蓢	艹丶󰁮月
蓣	艹󰁻乛贝
蓤	艹冫土夂
蓥	艹冖金󰀘
蓦	艹曰大一
蓧	艹亻丨朩
蓨	艹亻丨月
蓩	艹󰁻乛力
蓪	艹󰁻用辶
蓫	艹一󰀓辶
蓬	艹夂三辶
蓭	艹广大乚
蓮	艹車辶󰁧
蓯	艹彳人󰁾
蓰	艹彳止󰁾
蓱	艹氵䒑廾
蓲	艹匚口口
蓳	艹廿口
蓴	艹一曰寸
蓵	艹扌一󰁾
蓶	艹口亻󰁷
蓷	艹扌亻󰁷
蓸	艹一ㄇ日
蓹	艹彳𠂉卩
蓺	艹土八丶
蓻	艹土䒑丶
蓼	艹羽人彡
蓽	艹曰艹󰀟
蓾	艹󰀥囗󰁘
蓿	艹宀亻日
蔀	艹立口阝
蔁	艹立早󰀬
蔂	艹田幺小
蔃	艹弓口虫
蔄	艹門口󰀘
蔅	艹門女󰀘
蔆	艹氵土夂
蔇	艹󰁮󰀄󰁜
蔈	艹覀二小
蔉	艹六口󰀔
蔊	艹火曰干
蔋	艹氵上又
蔌	艹木口人
蔍	艹󰁙󰁴匕
蔎	艹言几又
蔏	艹亠丷口
蔐	艹亠丷古
蔑	艹罒戈人
蔒	艹󰁬丿灬
蔓	艹曰罒又
蔔	艹勹一田
蔕	艹廿儿丨
蔖	艹虍󰀐一
蔗	艹广廿灬
蔘	艹厶厶彡
蔙	艹方𠂉󰁾
蔚	艹尸二寸
蔛	艹⺈用十
蔜	艹󰁡攵
蔝	艹目米󰁧
蔞	艹󰀻女󰀘
蔟	艹方𠂉大
蔠	艹糹夂󰁦
蔡	艹󰁯二小
蔢	艹氵皮女
蔣	艹爿󰁝寸
蔤	艹宀心山
蔥	艹丿囗心
蔦	艹󰁟灬󰁧
蔧	艹三丨彐
蔨	艹囗丷⺋
蔩	艹宀一八
蔪	艹車斤󰀬
蔫	艹一止灬
蔬	艹乛止󰀸
蔭	艹阝人厶
蔮	艹囗戈󰀞
蔯	艹阝木曰
蔰	艹丶尸巴
蔱	艹乂朩又
蔲	艹宀二攵
蔳	艹氵月
蔴	艹广木木
蔵	艹戊匚丨
蔶	艹貝󰁧
蔷	艹十䒑口
蔸	艹白󰁚儿
蔹	艹人一攵
蔺	艹门亻󰁷
蔻	艹宀二又
蔼	艹讠曰󰄃
蔽	艹㡀攵󰁧
蔾	艹禾勹木
蔿	艹爫丿灬
蕀	艹木冂冂
蕁	艹彐工寸
蕂	艹月丷力
蕃	艹丿米田
蕄	艹門心󰁧
蕅	艹氵曰丶
蕆	艹戊貝󰁧
蕇	艹口口十
蕈	艹覀早󰀬
蕉	艹亻󰁷灬
蕊	艹心心心
蕋	艹止止止
蕌	艹日日日
蕍	艹氵人刂
蕎	艹丿大口
蕏	艹犭󰁥日
蕐	艹一人󰀟
蕑	艹門月󰀘
蕒	艹罒貝󰁧
蕓	艹󰀙二厶
蕔	艹土䒑又
蕕	艹犭󰁥一
蕖	艹氵匚木
蕗	艹口止口
蕘	艹土土儿
蕙	艹一曰心
蕚	艹口口ㄅ
蕛	艹禾丷丿
蕜	艹丨三心
蕝	艹糹⺈巴
蕞	艹曰耳又
蕟	艹癶弓又
蕠	艹女口小
蕡	艹十艹貝
蕢	艹口丨貝
蕣	艹爫冖㐄
蕤	艹一󰀓
蕥	艹󰀄亅󰁷
蕦	艹彡丆貝
蕧	艹彳𠂉夂
蕨	艹厂䒑人
蕩	艹氵曰󰁤
蕪	艹𠂉一灬
蕫	艹立曰土
蕬	艹糹幺小
蕭	艹󰁬十󰀲
蕮	艹臼勹灬
蕯	艹阝夂一
蕰	艹氵曰皿
蕱	艹禾⺌月
蕲	艹丷曰斤
蕳	艹門日󰀘
蕴	艹纟曰皿
蕵	艹夕人艮
蕶	艹󰀙人󰁻
蕷	艹󰁻乛貝
蕸	艹󰁃丨辶
蕹	艹亠󰁲󰁷
蕺	艹口耳丶
蕻	艹󰂞󰁺八
蕼	艹󰂞󰁬󰀟
蕽	艹ㄇ󰁺󰀖
蕾	艹󰀙田󰀘
蕿	艹火爫又
薀	艹氵囗皿
薁	艹丿ㄇ大
薂	艹白方攵
薃	艹氵󰁸口
薄	艹氵甫寸
薅	艹女厂寸
薆	艹爫冖夂
薇	艹彳山攵
薈	艹人一日
薉	艹止戊󰀤
薊	艹󰁢灬刂
薋	艹冫⺈貝
薌	艹󰁲丿阝
薍	艹爫󰁻乚
薎	艹罒冖戈
薏	艹立曰心
薐	艹禾土夂
薑	艹一田一
薒	艹󰀥夕米
薓	艹氵彐又
薔	艹土人口
薕	艹广䒑八
薖	艹ㄇ󰁈辶
薗	艹囗土󰀔
薘	艹土羊辶
薙	艹𠂉大󰁷
薚	艹一夕󰁤
薛	艹丿󰃧辛
薜	艹尸口辛
薝	艹⺈厂言
薞	艹一夕艮
薟	艹人一人
薠	艹火丆貝
薡	艹目󰁕󰁈
薢	艹⺈用󰀟
薣	艹士口又
薤	艹一夕一
薥	艹罒勹虫
薦	艹󰁙一灬
薧	艹󰁸冖匕
薨	艹罒冖匕
薩	艹阝立
薪	艹立木斤
薫	艹丿一灬
薬	艹白󰀪木
薭	艹禾白十
薮	艹米女攵
薯	艹罒土曰
薰	艹丿一灬
薱	艹业丷寸
薲	艹宀一貝
薳	艹土口辶
薴	艹宀心丁
薵	艹士乛寸
薶	艹豸曰土
薷	艹󰀙丆〢
薸	艹氵覀小
薹	艹士口土
薺	艹󰀴󰀳󰀘
薻	艹氵巛木
薼	艹󰁙󰁴土
薽	艹覀土丶
薾	艹一八乂
薿	艹匕𠂉󰁾
藀	艹火火火
藁	艹󰁸冂木
藂	艹耳又乑
藃	艹󰁸冂人
藄	艹󰀎八小
藅	艹罒言刂
藆	艹宀󰀀手
藇	艹󰀗一八
藈	艹目癶大
藉	艹二木日
藊	艹禾丶艹
藋	艹羽亻󰁷
藌	艹宀心虫
藍	艹匚丨皿
藎	艹󰁬丨皿
藏	艹戈爿丨
藐	艹豸白儿
藑	艹⺈ㄇ夂
藒	艹禾曰󰄃
藓	艹󰁢󰀞羊
藔	艹宀大小
藕	艹二木丶
藖	艹匚丨貝
藗	艹木口辶
藘	艹虍田心
藙	艹立󰀓又
藚	艹士罒貝
藛	艹宀臼灬
藜	艹禾勹氺
藝	艹土八厶
藞	艹石石石
藟	艹田田田
藠	艹白白白
藡	艹亠丷辶
藢	艹彳山攵
藣	艹罒厶匕
藤	艹月丷氺
藥	艹白幺木
藦	艹广木手
藧	艹糹爫又
藨	艹󰁙󰁴灬
藩	艹氵丿田
藪	艹󰀻女攵
藫	艹氵覀早
藬	艹阝口貝
藭	艹宀八弓
藮	艹木亻灬
藯	艹尸二心
藰	艹󰁚丶刂
藱	艹疒白厶
藲	艹木匚口
藳	艹󰁸冂禾
藴	艹糹曰皿
藵	艹亻口󰀔
藶	艹厂禾止
藷	艹言土日
藸	艹一󰀓日
藹	艹言曰󰄃
藺	艹門亻󰁷
藻	艹氵口木
藼	艹宀三心
藽	艹立朩儿
藾	艹木口貝
藿	艹󰀙亻󰁷
蘀	艹扌罒十
蘁	艹王口口
蘂	艹心心木
蘃	艹止止木
蘄	艹口口斤
蘅	艹彳󰁢丁
蘆	艹虍田皿
蘇	艹󰁢灬禾
蘈	艹禾几貝
蘉	艹罒冖又
蘊	艹糹囗皿
蘋	艹止󰀤貝
蘌	艹彳𠂉小
蘍	艹丿一力
蘎	艹󰀙月巴
蘏	艹匕二貝
蘐	艹言爫又
蘑	艹广木石
蘒	艹禾⺈乚
蘓	艹禾󰁢灬
蘔	艹匕禾貝
蘕	艹糹夂辶
蘖	艹丿󰃧木
蘗	艹尸口木
蘘	艹亠口󰀔
蘙	艹匚𠂉羽
蘚	艹󰁢灬羊
蘛	艹󰀎八月
蘜	艹廿󰀜米
蘝	艹人一人
蘞	艹人一攵
蘟	艹阝爫心
蘠	艹爿土口
蘡	艹貝貝女
蘢	艹立月三
蘣	艹󰁺由王
蘤	艹白爫灬
蘥	艹人一艹
蘦	艹󰀙口口
蘧	艹虍一辶
蘨	艹爫𠂉小
蘩	艹𠂉母小
蘪	艹󰁙󰁴米
蘫	艹氵匚皿
蘬	艹丿󰃧丨
蘭	艹門木󰀹
蘮	艹罒厂刂
蘯	艹氵日皿
蘰	艹糹曰又
蘱	艹米犬貝
蘲	艹田田土
蘳	艹󰁺由土
蘴	艹山三䒑
蘵	艹耳亠日
蘶	艹禾女厶
蘷	艹丆日夂
蘸	艹西一灬
蘹	艹忄亠󰀔
蘺	艹亠乂󰁷
蘻	艹車凵小
蘼	艹广木三
蘽	艹田田木
蘾	艹土亠󰀔
蘿	艹罒糹󰁷
虀	艹󰀴丨一
虁	艹䒑丿夂
虂	艹󰀙口口
虃	艹氵人󰀞
虄	艹虫夂
虅	艹月丷灬
虆	艹田田小
虇	艹弓艹󰁷
虈	艹口口口
虉	艹一口灬
虊	艹言糹木
虋	艹󰀗ㄇ刀
虌	艹㡀攵黽
虍	虍丨一乚
虎	虍几󰁫
虏	虍力󰀏
虐	虍匚一󰀌
虑	虍心󰀦
虒	⺁虍几󰁫
虓	九虍几󰁀
虔	虍文󰀦
處	虍夂几󰁫
虖	虍丿丷󰀛
虗	虍丘󰀌
虘	虍󰀐一󰀌
虙	虍心丿󰀏
虚	虍业󰀌
虛	虍〢󰄃一
虜	虍田力󰀏
虝	虍几勹󰁤
虞	虍口一大
號	口一ㄅ几
虠	六乂虍几
虡	虍业八󰀦
虢	爫寸虍几
虣	一󰀁止几
虤	虍几虍几
虥	虍几戈戈
虦	戈戈虍几
虧	虍亻󰁷ㄅ
虨	虍木木彡
虩	⺌曰小几
虪	虍几亻灬
虫	虫丨󰁈丶
虬	虫乚󰁀
虭	虫刀󰁥
虮	虫几󰁀
虯	虫󰁐丨󰀢
虰	虫丁󰀢
虱	⺄丿虫󰀦
虲	虫卜󰁶
虳	虫勹丶󰁶
虴	虫丿七󰁀
虵	虫也󰁀
虶	虫一󰀛󰀢
虷	虫干󰀢
虸	虫子󰀝
虹	虫工󰀝
虺	一儿虫󰀦
虻	虫亠󰄃󰁀
虼	虫𠂉乙󰁀
虽	口虫󰁧
虾	虫一卜󰁶
虿	一󰁡虫󰁧
蚀	⺈󰁐虫󰁶
蚁	虫丶乂󰁶
蚂	虫󰀊一󰀝
蚃	󰁲丿虫󰁧
蚄	虫方󰁥
蚅	虫厂⺋󰁀
蚆	虫巴󰁀
蚇	虫尸󰂃󰁶
蚈	虫一廾󰀢
蚉	文虫󰁧
蚊	虫文󰁶
蚋	虫冂人󰁶
蚌	虫三丨󰀢
蚍	虫󰁴匕󰁀
蚎	虫日󰀝
蚏	虫月󰀝
蚐	虫勹冫󰀝
蚑	虫十又󰁶
蚒	虫󰀼亠󰀝
蚓	虫弓丨󰀢
蚔	虫󰁚󰀁󰁀
蚕	一大虫󰁧
蚖	虫二儿󰁀
蚗	虫ユ人󰁶
蚘	虫乚丶
蚙	虫人丶乛
蚚	虫斤󰀢
蚛	虫口丨󰀢
蚜	虫󰀄亅丿
蚝	虫毛󰁀
蚞	虫木󰁶
蚟	虫王󰀝
蚠	八刀虫󰁧
蚡	虫八刀󰁥
蚢	虫亠几󰁀
蚣	虫八厶󰁶
蚤	又丶虫󰁧
蚥	虫八乂󰁶
蚦	虫冂二󰀝
蚧	虫人󰀯󰀢
蚨	虫夫󰁶
蚩	凵丨一虫
蚪	虫󰁦十󰀢
蚫	虫勹巳󰁀
蚬	虫ㄇ󰁜󰁀
蚭	虫尸匕󰁀
蚮	虫亻󰀁丶
蚯	虫丘󰀝
蚰	虫由󰀝
蚱	虫𠂉丨二
蚲	虫一丷十
蚳	虫󰁚󰀁丶
蚴	虫幺力󰁥
蚵	虫丁口󰀝
蚶	虫甘󰀝
蚷	虫匚󰁃󰀝
蚸	虫斤丶󰁶
蚹	虫亻寸󰁶
蚺	虫冂土󰀝
蚻	木乚虫󰁧
蚼	虫勹口󰀝
蚽	虫丆卜一
蚾	虫皮󰁶
蚿	虫亠幺󰁶
蛀	虫丶王󰀝
蛁	虫刀口󰀝
蛂	虫又丶
蛃	虫一冂人
蛄	虫古󰀝
蛅	虫󰀥口󰀝
蛆	虫󰀐一󰀝
蛇	虫宀匕󰁀
蛈	虫丿夫󰁶
蛉	虫人丶󰁻
蛊	虫皿󰀘
蛋	乛󰁾虫󰁧
蛌	虫⺁厶󰂃
蛍	󰀧冖虫󰁧
蛎	虫厂一󰁡
蛏	虫又土󰀝
蛐	虫ㄇ󰁺󰀝
蛑	虫厶丿󰀟
蛒	虫夂口󰀝
蛓	十戈虫󰀦
蛔	虫囗口󰀝
蛕	虫月󰀝
蛖	虫乚丶
蛗	丿󰃧虫󰁧
蛘	虫羊󰀢
蛙	虫土土󰀝
蛚	虫一夕刂
蛛	虫丿未󰁶
蛜	虫亻󰁬丿
蛝	虫艮󰁶
蛞	虫丿古󰀝
蛟	虫六乂󰁶
蛠	虫力力力
蛡	虫羽󰀝
蛢	虫䒑廾󰀢
蛣	虫士口󰀝
蛤	虫人一口
蛥	虫夕夕󰁶
蛦	虫一弓人
蛧	虫冂乂乂
蛨	虫丆日󰀝
蛩	工几丶虫
蛪	三丨刀虫
蛫	虫⺈厂⺋
蛬	󰁺八虫󰁧
蛭	虫一厶土
蛮	亠󰁗虫󰁧
蛯	虫土丿匕
蛰	扌九丶虫
蛱	虫一丷大
蛲	虫󰀁丿儿
蛳	虫リ一丨
蛴	虫文󰀯󰀢
蛵	虫一巛工
蛶	虫爫寸󰁶
蛷	虫一氺丶
蛸	虫⺌月󰀝
蛹	虫󰁻用󰀢
蛺	虫大人人
蛻	虫八口儿
蛼	虫車󰀢
蛽	虫貝󰁶
蛾	虫丿扌丶
蛿	虫人丶口
蜀	罒勹虫󰁧
蜁	虫𠂉乛󰁾
蜂	虫夂三丨
蜃	厂二󰀖虫
蜄	虫厂二󰀖
蜅	虫甫󰁶
蜆	虫目儿󰁀
蜇	扌斤虫󰁧
蜈	虫口一大
蜉	虫爫子󰀝
蜊	虫禾刂󰀢
蜋	虫丶艮󰁶
蜌	虫󰁴匕土
蜍	虫人一朩
蜎	虫口月󰀝
蜏	虫禾乃󰁥
蜐	虫土厶力
蜑	丿󰀥󰄃虫
蜒	虫丿󰀥廴
蜓	虫丿士廴
蜔	虫勹田󰀝
蜕	虫丷口儿
蜖	虫囗〢二
蜗	虫口冂人
蜘	虫𠂉大口
蜙	虫木八厶
蜚	丨三丨虫
蜛	虫尸古󰀝
蜜	宀心丿虫
蜝	󰀎八虫󰁧
蜞	虫󰀎八󰁶
蜟	虫亠厶月
蜠	虫囗禾󰁶
蜡	虫󰁺日󰀝
蜢	虫子皿󰀝
蜣	虫⺶乚󰁀
蜤	木斤虫󰁧
蜥	虫木斤󰀢
蜦	虫人一艹
蜧	虫丶尸犬
蜨	虫一󰁬󰁾
蜩	虫󰀼土口
蜪	虫勹𠂉凵
蜫	虫曰󰁴匕
蜬	虫了󰀪凵
蜭	虫⺈臼󰀝
蜮	虫戈口󰀞
蜯	虫三人󰀟
蜰	月巴虫󰁧
蜱	虫白丿十
蜲	虫禾女󰀝
蜳	虫󰁸子󰀝
蜴	虫曰勹󰁤
蜵	虫󰀲一󰀝
蜶	虫亠人十
蜷	虫丷夫⺋
蜸	匚丨󰁃虫
蜹	虫艹冂人
蜺	虫臼儿󰁀
蜻	虫月󰀝
蜼	虫亻󰁷󰀝
蜽	虫一冂丶
蜾	虫曰木󰁶
蜿	虫宀夕⺋
蝀	虫木曰󰀝
蝁	一󰀚一虫
蝂	虫丿丨又
蝃	虫又又又
蝄	虫冂䒑󰄃
蝅	一大一虫
蝆	虫丨一干
蝇	虫口曰乚
蝈	虫囗王丶
蝉	虫丷曰十
蝊	虫宀一󰁾
蝋	虫󰀧几󰀟
蝌	虫禾󰁦十
蝍	虫󰁮卩󰀢
蝎	虫曰勹󰄃
蝏	虫󰁸冖丁
蝐	虫󰀰目󰀝
蝑	虫乛󰁾月
蝒	虫丆囗二
蝓	虫人一刂
蝔	虫󰁴匕白
蝕	人良虫󰁶
蝖	虫宀一一
蝗	虫白王󰀝
蝘	虫匚曰女
蝙	虫丶尸艹
蝚	虫󰁻乛木
蝛	虫戊一女
蝜	虫⺈貝󰁶
蝝	虫彑󰀓󰁶
蝞	虫󰁅目󰀝
蝟	虫田月󰀝
蝠	虫一口田
蝡	虫丆冂大
蝢	虫丆貝󰁶
蝣	虫方𠂉子
蝤	虫丷西一
蝥	󰁻乛亅虫
蝦	虫󰁃丨又
蝧	虫艹ㄇ大
蝨	⺄十虫虫
蝩	虫丿一土
蝪	虫曰一󰁤
蝫	虫土丿日
蝬	虫乂凵夂
蝭	虫曰一󰁾
蝮	虫𠂉曰夂
蝯	虫爫一又
蝰	虫大土土
蝱	亠󰄃虫虫
蝲	虫木口刂
蝳	虫母󰁶
蝴	虫古月󰀝
蝵	禾火虫󰁧
蝶	虫廿󰄃木
蝷	虫广䒑丿
蝸	虫ㄇ󰁈口
蝹	虫曰皿󰀝
蝺	虫丿口丶
蝻	虫十冂十
蝼	虫米女󰀝
蝽	虫三人日
蝾	虫艹冖木
蝿	虫曰曰乚
螀	丬夕寸虫
螁	虫艮辶󰁶
螂	虫丶󰁮阝
螃	虫亠丷方
螄	虫丿󰃧丨
螅	虫丿目心
螆	虫䒑幺幺
螇	虫爫幺大
螈	虫厂白小
螉	虫八厶羽
螊	虫䒑󰁬八
螋	虫臼丨又
螌	丿󰁪几虫
融	一口冂虫
螎	虫一口丨
螏	虫疒𠂉大
螐	虫󰁞灬󰁶
螑	虫丿目犬
螒	十早人虫
螓	虫三人禾
螔	虫⺁虍几
螕	虫丿囗匕
螖	虫󰀾月󰀝
螗	虫广󰁬口
螘	虫山一䒑
螙	木虫虫󰁧
螚	厶月匕虫
螛	虫宀三口
螜	士冖一虫
螝	虫白󰁜厶
螞	虫󰀋灬󰁶
螟	虫冖曰六
螠	虫䒑八皿
螡	文虫虫󰁧
螢	火火冖虫
螣	月丷夫虫
螤	文虫曰人
螥	虫人丶口
螦	虫幺小
螧	虫土丿日
螨	虫艹一人
螩	虫亻丨朩
螪	虫亠丷口
螫	土󰁖攵虫
螬	虫一ㄇ日
螭	虫亠乂厶
螮	虫廿儿丨
螯	󰁡攵虫
螰	虫󰁙󰁴匕
螱	尸二小虫
螲	虫宀八土
螳	虫⺌冖土
螴	阝木曰虫
螵	虫覀二小
螶	匚󰁃虫虫
螷	广白丿虫
螸	八人口虫
螹	虫車斤󰀢
螺	虫田幺小
螻	虫󰀻女󰀝
螼	虫廿口
螽	夂󰁦虫虫
螾	虫宀一八
螿	爿󰁝寸虫
蟀	虫亠幺十
蟁	󰁂󰀁虫虫
蟂	虫󰁟木󰁶
蟃	虫曰罒又
蟄	土䒑十虫
蟅	虫广廿灬
蟆	虫艹曰大
蟇	艹曰大虫
蟈	虫囗戈󰀞
蟉	虫羽人彡
蟊	󰁻乛亅虫
蟋	虫丿米心
蟌	虫丿囗心
蟍	虫禾刂木
蟎	虫廿冂丶
蟏	虫艹󰁬八
蟐	虫⺌冖丨
蟑	虫立早󰀢
蟒	虫艹犬廾
蟓	虫⺈口󰀓
蟔	虫󰀹土灬
蟕	虫止匕用
蟖	虫󰀎八斤
蟗	一口丨虫
蟘	虫亻󰀁貝
蟙	虫亠丷日
蟚	士口䒑虫
蟛	虫士口彡
蟜	虫丿大口
蟝	虫氵匚木
蟞	㡀攵虫󰁧
蟟	虫大丷小
蟠	虫丿米田
蟡	虫爫丿灬
蟢	虫士口口
蟣	虫幺幺人
蟤	虫巳巳八
蟥	虫󰁺由八
蟦	虫十艹貝
蟧	虫火火力
蟨	厂䒑凵虫
蟩	虫厂䒑人
蟪	虫一曰心
蟫	虫覀早󰀢
蟬	虫口口十
蟭	虫亻󰁷灬
蟮	虫羊䒑口
蟯	虫土土儿
蟰	虫󰁬十󰀲
蟱	虫𠂉一灬
蟲	虫虫虫󰁧
蟳	虫󰁬工寸
蟴	󰀎八斤虫
蟵	虫厂一寸
蟶	虫耳口王
蟷	虫⺌冖田
蟸	一󰀓虫虫
蟹	⺈用刀虫
蟺	虫亠囗一
蟻	虫丷王丶
蟼	艹勹口虫
蟽	虫土羊辶
蟾	虫⺈厂言
蟿	車凵几虫
蠀	虫冫⺈貝
蠁	󰁲丿丶虫
蠂	虫艹廿木
蠃	󰄹月虫丶
蠄	虫人亠厶
蠅	虫黽󰀝
蠆	艹曰冂虫
蠇	虫艹曰丶
蠈	貝戈虫
蠉	虫罒一󰀔
蠊	虫广䒑八
蠋	虫罒勹虫
蠌	虫罒土十
蠍	虫日勹人
蠎	虫艹大廾
蠏	虫⺈用󰀟
蠐	虫󰀴󰀳󰀝
蠑	虫火火木
蠒	一八冂虫
蠓	虫艹冖󰀓
蠔	虫󰁸冖󰀓
蠕	虫󰀙丆〢
蠖	虫艹亻又
蠗	虫羽亻󰁷
蠘	虫十戈󰁷
蠙	虫宀一貝
蠚	艹口虫
蠛	虫艹罒人
蠜	木乂乂虫
蠝	虫田田田
蠞	⺮󰁮卩虫
蠟	虫巛囗󰁒
蠠	丆囗〢虫
蠡	彑󰀓虫虫
蠢	三人日虫
蠣	虫厂艹丶
蠤	丷西一虫
蠥	凵丿丿虫
蠦	虫虍田皿
蠧	士冖石虫
蠨	虫艹󰁬󰀲
蠩	虫言土日
蠪	立月一虫
蠫	豸刂虫虫
蠬	虫立月三
蠭	夂三丨虫
蠮	虫匚𠂉羽
蠯	广白丿虫
蠰	虫亠口󰀔
蠱	虫虫虫皿
蠲	䒑八皿虫
蠳	虫貝貝女
蠴	虫艹罒日
蠵	虫山亻口
蠶	󰀄󰁜󰀄虫
蠷	虫目目󰁷
蠸	虫艹口󰁷
蠹	一口丨虫
蠺	一大一虫
蠻	言糹糹虫
蠼	虫目目又
蠽	小亻󰁷虫
蠾	虫尸氺虫
蠿	󰁃幺幺虫
血	丿皿󰀌
衁	亠󰄃丿皿
衂	丿皿刀丶
衃	丿皿丆卜
衄	丿皿󰁈一
衅	丿皿丷󰀟
衆	丿皿乑󰁧
衇	丿皿⺁󰀕
衈	丿皿耳󰀝
衉	丿皿夂口
衊	丿皿艹人
衋	󰁬󰀟丆皿
行	彳一丁󰀢
衍	彳氵一丁
衎	彳干一丁
衏	彳二儿丁
衐	彳匚󰁃丁
衑	彳人丶丁
衒	彳亠幺丁
術	彳木丶丁
衔	彳钅一丁
衕	彳冂一丁
衖	彳󰁺八丁
街	彳土土丁
衘	彳𠂉一丁
衙	彳五口丁
衚	彳古月丁
衛	彳󰁆口丁
衜	彳䒑丿丁
衝	彳丿一丁
衞	彳󰁆口丁
衟	彳巛丆丁
衠	彳十󰀣丁
衡	彳󰁢大丁
衢	彳目目丁
衣	亠󰀔󰁧
衤	衤󰁧丶丶
补	衤󰁧卜󰁶
衦	衤󰁧干󰀢
衧	衤󰁧一󰀛
表	󰀔󰁧
衩	衤󰁧又丶
衪	衤󰁧也󰁀
衫	衤󰁧彡󰁥
衬	衤󰁧寸󰁶
衭	衤󰁧夫󰁶
衮	六厶󰀔󰁧
衯	衤󰁧八刀
衰	亠口一󰀔
衱	衤󰁧乃󰂃
衲	衤󰁧冂人
衳	衤󰁧八厶
衴	衤󰁧冖󰁜
衵	衤󰁧日󰀝
衶	衤󰁧口丨
衷	亠口丨󰀔
衸	衤󰁧人󰀯
衹	衤󰁧󰁚󰀁
衺	亠󰀄亅󰀔
衻	衤󰁧冂二
衼	衤󰁧十又
衽	衤󰁧丿士
衾	人丶乛󰀔
衿	衤󰁧人乛
袀	衤󰁧勹冫
袁	土口󰀔󰁧
袂	衤󰁧ユ人
袃	七刀亠󰀔
袄	衤󰁧丿大
袅	󰁠亠󰀔󰁧
袆	衤󰁧二丨
袇	衤󰁧󰀼亠
袈	力口亠󰀔
袉	衤󰁧宀匕
袊	衤󰁧人󰁻
袋	亻󰀁丶󰀔
袌	亠勹巳󰀔
袍	衤󰁧勹巳
袎	衤󰁧幺力
袏	衤󰁧工
袐	衤󰁧心丿
袑	衤󰁧刀口
袒	衤󰁧曰一
袓	衤󰁧󰀐一
袔	衤󰁧丁口
袕	衤󰁧宀八
袖	衤󰁧由󰀝
袗	衤󰁧人彡
袘	衤󰁧𠂉也
袙	衤󰁧白󰀝
袚	衤󰁧丶
袛	衤󰁧󰁚丶
袜	衤󰁧一木
袝	衤󰁧亻寸
袞	六口󰀔󰁧
袟	衤󰁧丿夫
袠	亠丿夫󰀔
袡	衤󰁧冂土
袢	衤󰁧丷󰀟
袣	衤󰁧廿󰄃
袤	亠󰁻乛󰀔
袥	衤󰁧石󰀝
袦	衤󰁧凵山
袧	衤󰁧勹口
袨	衤󰁧亠幺
袩	衤󰁧󰀥口
袪	衤󰁧土厶
被	衤󰁧皮󰁶
袬	亠厶口󰀔
袭	ヒ丶󰀔
袮	衤󰁧𠂉小
袯	衤󰁧ㄥ丶
袰	母亠󰀔󰁧
袱	衤󰁧亻犬
袲	亠夕夕󰀔
袳	衤󰁧夕夕
袴	衤󰁧大ㄅ
袵	衤󰁧亻士
袶	衤󰁧夂㐄
袷	衤󰁧人口
袸	衤󰁧子
袹	衤󰁧丆日
袺	衤󰁧士口
袻	衤󰁧丆〢
袼	衤󰁧夂口
袽	衤󰁧女口
袾	衤󰁧丿未
袿	衤󰁧土土
裀	衤󰁧囗大
裁	十戈亠󰀔
裂	一夕刂󰀔
裃	衤󰁧上卜
裄	衤󰁧彳丁
装	丬士亠󰀔
裆	衤󰁧⺌彐
裇	衤󰁧丿皿
裈	衤󰁧冖车
裉	衤󰁧艮󰁶
裊	󰁟亠󰀔󰁧
裋	衤󰁧一䒑
裌	衤󰁧大人
裍	衤󰁧囗木
裎	衤󰁧口王
裏	亠曰土󰀔
裐	衤󰁧口月
裑	衤󰁧丿丿
裒	亠臼󰀔󰁧
裓	衤󰁧戈廾
裔	亠󰀔冂口
裕	衤󰁧八口
裖	衤󰁧厂󰀖
裗	衤󰁧亠󰀸
裘	一氺丶󰀔
裙	衤󰁧󰁬口
裚	扌斤亠󰀔
裛	󰁸巴󰀔󰁧
補	衤󰁧甫󰁶
裝	爿士亠󰀔
裞	衤󰁧丷儿
裟	氵小丿󰀔
裠	󰁬丿口󰀔
裡	衤󰁧曰土
裢	衤󰁧车辶
裣	衤󰁧人一
裤	衤󰁧广车
裥	衤󰁧门日
裦	亠亻二󰀔
裧	衤󰁧火火
裨	衤󰁧白十
裩	衤󰁧曰󰁴
裪	衤󰁧勹凵
裫	衤󰁧󰀲一
裬	衤󰁧土夂
裭	衤󰁧虍几
裮	衤󰁧日曰
裯	衤󰁧󰀼口
裰	衤󰁧又又
裱	衤󰁧󰀔
裲	衤󰁧一丶
裳	⺌冖口󰀔
裴	丨三丨󰀔
裵	亠丨三󰀔
裶	衤󰁧丨三
裷	衤󰁧丷⺋
裸	衤󰁧曰木
裹	亠曰木󰀔
裺	衤󰁧大乚
裻	上小又󰀔
裼	衤󰁧曰󰁤
製	𠂉一冂󰀔
裾	衤󰁧尸古
裿	衤󰁧大口
褀	衤󰁧󰀎八
褁	曰木󰀔󰁧
褂	衤󰁧土卜
褃	衤󰁧止月
褄	衤󰁧一󰁬
褅	衤󰁧亠丨
褆	衤󰁧日󰁾
複	衤󰁧𠂉夂
褈	衤󰁧丿土
褉	衤󰁧三大
褊	衤󰁧丶艹
褋	衤󰁧廿木
褌	衤󰁧冖車
褍	衤󰁧山〢
褎	亠亻二󰀔
褏	亠亻二󰀔
褐	衤󰁧曰󰄃
褑	衤󰁧爫又
褒	亠亻口󰀔
褓	衤󰁧亻木
褔	衤󰁧一田
褕	衤󰁧人刂
褖	衤󰁧彑󰀓
褗	衤󰁧匚女
褘	衤󰁧󰁆㐄
褙	衤󰁧丬月
褚	衤󰁧土日
褛	衤󰁧米女
褜	月勹巳󰀔
褝	衤󰁧󰀧十
褞	衤󰁧曰皿
褟	衤󰁧曰羽
褠	衤󰁧󰀀土
褡	衤󰁧艹口
褢	亠白󰁜󰀔
褣	衤󰁧宀口
褤	衤󰁧土󰀔
褥	衤󰁧厂寸
褦	衤󰁧厶匕
褧	耳火亠󰀔
褨	衤󰁧⺶工
褩	丿󰁪几󰀔
褪	衤󰁧艮辶
褫	衤󰁧⺁几
褬	衤󰁧又木
褭	亠󰀋灬󰀔
褮	火火冖󰀔
褯	衤󰁧广丨
褰	宀󰀀八󰀔
褱	亠罒氺󰀔
褲	衤󰁧广車
褳	衤󰁧車辶
褴	衤󰁧〢皿
褵	衤󰁧亠厶
褶	衤󰁧羽白
褷	衤󰁧彳󰁾
褸	衤󰁧󰀻女
褹	衤󰁧土丶
褺	土䒑十󰀔
褻	亠土八󰀔
褼	衤󰁧覀巳
褽	尸二小󰀔
褾	衤󰁧覀小
褿	衤󰁧一日
襀	衤󰁧貝
襁	衤󰁧弓虫
襂	衤󰁧厶彡
襃	亠亻二󰀔
襄	亠口口󰀔
襅	衤󰁧曰󰀟
襆	衤󰁧业夫
襇	衤󰁧門日
襈	衤󰁧巳八
襉	衤󰁧門月
襊	衤󰁧曰又
襋	衤󰁧木冂
襌	衤󰁧口十
襍	衤󰁧亻木
襎	衤󰁧丿田
襏	衤󰁧癶又
襐	衤󰁧⺈󰀓
襑	衤󰁧彐寸
襒	衤󰁧㡀攵
襓	衤󰁧土儿
襔	衤󰁧廿丶
襕	衤󰁧门󰀹
襖	衤󰁧丿大
襗	衤󰁧罒十
襘	衤󰁧人日
襙	衤󰁧口木
襚	衤󰁧䒑辶
襛	衤󰁧ㄇ󰀖
襜	衤󰁧⺈言
襝	衤󰁧人人
襞	尸口辛󰀔
襟	衤󰁧木小
襠	衤󰁧⺌田
襡	衤󰁧罒虫
襢	衤󰁧亠一
襣	衤󰁧丿󰀯
襤	衤󰁧匚皿
襥	衤󰁧亻夫
襦	衤󰁧󰀙〢
襧	衤󰁧一乂
襨	衤󰁧业寸
襩	衤󰁧士貝
襪	衤󰁧艹人
襫	衤󰁧大日
襬	衤󰁧罒匕
襭	衤󰁧士貝
襮	衤󰁧曰氺
襯	衤󰁧立儿
襰	衤󰁧木貝
襱	衤󰁧立三
襲	立月一󰀔
襳	衤󰁧人󰀞
襴	衤󰁧門󰀹
襵	衤󰁧耳耳
襶	衤󰁧十八
襷	衤󰁧󰀗手
襸	衤󰁧丿貝
襹	衤󰁧一匕
襺	衤󰁧艹虫
襻	衤󰁧木手
襼	衤󰁧艹厶
襽	衤󰁧艹󰀹
襾	一ㄇ凵󰀵
西	西一丨一
覀	覀一丨一
要	覀女󰀘
覂	覀丿之󰁧
覃	覀早󰀬
覄	覀亻犬󰁧
覅	覀女勹󰁤
覆	覀彳𠂉夂
覇	覀廿󰀜月
覈	覀白方攵
覉	覀廿󰀜口
覊	覀廿󰀜灬
見	目儿󰀅
覌	又目儿󰁀
覍	小目儿󰀅
覎	目儿子󰀌
規	夫目儿󰁀
覐	目儿乂乂
覑	丿丨一儿
覒	毛目儿󰁀
覓	爫目儿󰀅
覔	丆卜目儿
覕	心丿目儿
視	礻󰁶目儿
覗	𠃌一口儿
覘	󰀥口目儿
覙	⺈小目儿
覚	󰀧冖目儿
覛	⺁󰀕目儿
覜	儿󰀪目儿
覝	干火目儿
覞	目儿目儿
覟	士心目儿
覠	󰁬丿口儿
覡	工人人儿
覢	火火目儿
覣	禾女目儿
覤	虍几目儿
覥	ㄇ󰁺八儿
覦	人一月儿
覧	匚丨󰁃儿
覨	口口二儿
覩	土丿日儿
親	立朩目儿
覫	亠丷冖儿
覬	山一口儿
覭	冖曰六儿
覮	火火冖儿
覯	󰀀冂土儿
覰	虍󰀐󰀞儿
覱	車斤目儿
覲	廿口儿
観	𠂉一亻儿
覴	癶一口儿
覵	門月目儿
覶	爫󰁻冂儿
覷	虍业目儿
覸	門日目儿
覹	目儿彳攵
覺	󰀗乂乂儿
覻	虍一口儿
覼	一八冂儿
覽	匚丨󰁃儿
覾	宀丿米儿
覿	士罒貝儿
觀	艹口口儿
见	ㄇ󰁜󰀅
观	又ㄇ󰁜󰁀
觃	冂󰁜子󰀌
规	夫ㄇ󰁜󰁀
觅	爫ㄇ󰁜󰀅
视	礻󰁶ㄇ󰁜
觇	󰀥口ㄇ󰁜
览	〢𠂉丶󰁜
觉	󰀧冖ㄇ󰁜
觊	山󰁁ㄇ󰁜
觋	工人人󰁜
觌	十乛󰁦󰁜
觍	ㄇ󰁺八󰁜
觎	人一月儿
觏	󰀀ㄇ土󰁜
觐	廿口󰁜
觑	虍业ㄇ󰁜
角	⺈用󰀬
觓	⺈用󰁐丨
觔	⺈用力󰁥
觕	牜⺈用󰀢
觖	⺈用ユ人
觗	⺈用󰁚󰀁
觘	⺈用小丿
觙	⺈用乃󰂃
觚	⺈用⺁󰂃
觛	⺈用日一
觜	止匕⺈用
觝	⺈用󰁚丶
觞	⺈用𠂉󰁤
觟	⺈用土土
觠	丷夫⺈用
觡	⺈用夂口
觢	三丨刀用
解	⺈用刀󰀟
觤	⺈用⺈⺋
觥	⺈用⺌儿
触	⺈用虫󰁶
觧	⺈用羊󰀢
觨	⺈用工水
觩	⺈用一丶
觪	⺈用辛󰀢
觫	⺈用木口
觬	⺈用臼儿
觭	⺈用大口
觮	⺈用󰁭氺
觯	⺈用丷十
觰	⺈用土日
觱	戊一口用
觲	⺈用丷󰀟
觳	士冖一又
觴	⺈用𠂉󰁤
觵	⺈用󰁺八
觶	⺈用口十
觷	󰀗乂乂用
觸	⺈用罒虫
觹	⺈用亻𠃌
觺	匕𠂉大用
觻	⺈用白木
觼	⺈用⺈夂
觽	⺈用山𠃌
觾	⺈用廿灬
觿	⺈用山口
言	言言言言
訁	言丶一一
訂	言丁󰀢
訃	言卜󰁶
訄	九言󰀌
訅	言九󰁀
訆	言󰁐丨󰀢
訇	勹言󰀌
計	言十󰀢
訉	言几丶󰁶
訊	言⺄十󰀢
訋	言勹丶󰁶
訌	言工󰀝
訍	言又丶󰁶
討	言寸󰁶
訏	言一󰀛󰀢
訐	言干󰀢
訑	言也󰁀
訒	言刀丶󰁶
訓	言川󰀢
訔	山言󰀘
訕	言山󰀢
訖	言𠂉乙󰁀
託	言丿七󰁀
記	言己󰁀
訙	言九丶󰁶
訚	门言󰀌
訛	言亻ヒ󰁀
訜	言八刀󰁥
訝	言󰀄亅丿
訞	言丿大󰁶
訟	言八厶󰁶
訠	言弓丨󰀢
訡	言人丶乛
訢	言斤󰀢
訣	言ユ人󰁶
訤	言乂乂󰁶
訥	言冂人󰁶
訦	言冖󰁜󰁀
訧	言乚丶
訨	言止󰀝
訩	言乂凵󰀢
訪	言方󰁥
訫	言心󰁶
訬	言小丿󰁥
設	言几又󰁶
訮	言一廾󰀢
訯	言乃󰂃󰁶
訰	言一凵乚
許	言𠂉十󰀢
訲	言口丨󰀢
訳	言尸󰂃󰁶
訴	言斤丶󰁶
訵	言四󰀝
訶	言丁口󰀝
訷	言曰丨󰀢
訸	言禾󰁶
訹	言木丶󰁶
診	言人彡󰁥
註	言丶王󰀝
証	言一止󰀝
訽	言勹口󰀝
訾	止匕言󰀘
訿	言止匕󰁀
詀	言󰀥口󰀝
詁	言古󰀝
詂	言亻寸󰁶
詃	言亠幺󰁶
詄	言丿夫󰁶
詅	言人丶󰁻
詆	言󰁚󰀁丶
詇	言ㄇ大󰁶
詈	罒言󰀘
詉	言女又󰁶
詊	言丷󰀟󰀢
詋	言口儿󰁀
詌	言甘󰀝
詍	言廿󰄃󰁀
詎	言匚󰁃󰀝
詏	言幺力󰁥
詐	言𠂉丨二
詑	言宀匕󰁀
詒	言厶口󰀝
詓	言土厶󰁶
詔	言刀口󰀝
評	言一丷十
詖	言皮󰁶
詗	言冂口󰀝
詘	言凵山󰀢
詙	言又丶
詚	言日一󰀝
詛	言󰀐一󰀝
詜	言凵丨又
詝	言宀丁󰀢
詞	言𠃌一口
詟	ヒ丶言
詠	言丶𠃌󰀩
詡	言羽󰀝
詢	言勹日󰀝
詣	言匕日󰀝
詤	言人󰄃󰀸
詥	言人一口
試	言󰀁工丶
詧	󰁯言󰀘
詨	言六乂󰁶
詩	言土寸󰁶
詪	言艮󰁶
詫	言宀丿七
詬	言⺁一口
詭	言⺈厂⺋
詮	言人王󰀝
詯	言丿目󰀝
詰	言士口󰀝
話	言丿古󰀝
該	言亠ㄥ人
詳	言羊󰀢
詴	言月󰀝
詵	言丿土儿
詶	言丶丿丨
詷	言冂一口
詸	言米󰁶
詹	⺈厂八言
詺	言夕口󰀝
詻	言夂口󰀝
詼	言火󰁶
詽	言一干
詾	言勹乂凵
詿	言土土󰀝
誀	言耳󰀝
誁	言䒑廾󰀢
誂	言儿󰀪󰁶
誃	言夕夕󰁶
誄	言二木󰁶
誅	言丿未󰁶
誆	言匚王󰀝
誇	言大二ㄅ
誈	言一厶土
誉	󰀧一八言
誊	丷夫言󰀘
誋	言己心󰁶
誌	言士心󰁶
認	言刀丶心
誎	言木口󰀝
誏	言丶艮󰁶
誐	言丿扌丶
誑	言犭󰁥王
誒	言厶𠂉大
誓	扌斤言󰀘
誔	言丿士廴
誕	言丿󰀥廴
誖	言十冖子
誗	言禾刂󰀢
誘	言禾乃󰁥
誙	言一巛工
誚	言⺌月󰀝
誛	言彐冖又
誜	言厶八夂
誝	言人丶口
語	言五口󰀝
誟	言土丿子
誠	言戊𠃌󰁀
誡	言戈廾󰀢
誢	言目儿󰁀
誣	言工人人
誤	言口一大
誥	言丿土口
誦	言󰁻用󰀢
誧	言甫󰁶
誨	言𠂉母󰁶
誩	言言󰀝
說	言八口儿
誫	言厂二󰀖
説	言丷口儿
読	言士冖儿
誮	言艹亻ヒ
誯	言日曰󰀝
誰	言亻󰁷󰀝
誱	言一󰁬󰁾
課	言曰木󰁶
誳	言尸凵山
誴	言宀二小
誵	言乂月
誶	言亠人十
誷	言冂䒑󰄃
誸	言弓亠幺
誹	言丨三三
誺	言木人人
誻	言水日󰀝
誼	言宀󰀐一
誽	言臼儿󰁀
誾	門言󰀌
調	言󰀼土口
諀	言白丿十
諁	言又又又
諂	言⺈臼󰀝
諃	言木木󰁶
諄	言󰁸子󰀝
諅	󰀎八言󰀘
諆	言󰀎八󰁶
談	言火火󰁶
諈	言丿士󰁺
諉	言禾女󰀝
諊	言勹米󰁶
請	言月󰀝
諌	言木曰󰀝
諍	言⺈󰁬亅
諎	言󰁺日󰀝
諏	言耳又󰁶
諐	亻口󰀸言
諑	言一󰀓丶
諒	言󰁸小󰁶
諓	言戈戈󰁶
諔	言上小又
諕	言虍几󰁀
論	言人一艹
諗	言人丶心
諘	言󰀔󰁶
諙	言󰁚󰀁日
諚	言宀一󰁾
諛	言臼人󰁶
諜	言廿󰄃木
諝	言乛󰁾月
諞	言丶尸艹
諟	言日一󰁾
諠	言宀一一
諡	言八一皿
諢	言冖車󰀢
諣	言ㄇ󰁈口
諤	言口口ㄅ
諥	言丿一土
諦	言亠丷丨
諧	言󰁴匕白
諨	言一口田
諩	言䒑业󰀝
諪	言󰁸冖丁
諫	言木󰀹󰀝
諬	禾乚丶
諭	言人一刂
諮	言冫⺈口
諯	言山丆〢
諰	言田心󰁶
諱	言󰁆口㐄
諲	言覀土󰀝
諳	言立日󰀝
諴	言戊一口
諵	言十冂十
諶	言󰀎八󰄃
諷	言几丿虫
諸	言土丿日
諹	言曰一󰁤
諺	言立丿彡
諻	言白王󰀝
諼	言爫一又
諽	言廿󰀜󰀢
諾	言艹口
諿	言口耳󰀝
謀	言甘木󰁶
謁	言曰勹󰄃
謂	言田月󰀝
謃	言曰丿
謄	月丷夫言
謅	言勹凵丿
謆	言丶尸羽
謇	宀󰀀八言
謈	曰󰁺八言
謉	言白󰁜厶
謊	言艹亠󰀸
謋	言夕㐄木
謌	言丁口口
謍	火火冖言
謎	言米辶󰁶
謏	言臼丨又
謐	言心丿皿
謑	言爫幺大
謒	言人丶口
謓	言十󰀣八
謔	言虍匚一
謕	言⺁虍几
謖	言田八夂
謗	言亠丷方
謘	言尸辛󰀢
謙	言䒑󰁬八
謚	言䒑八皿
講	言󰀀冂土
謜	言厂白小
謝	言丿󰀽寸
謞	言󰁸冂口
謟	言爫臼󰀝
謠	言󰁝𠂉凵
謡	言爫𠂉凵
謢	言亻󰁷又
謣	言󰀙二ㄅ
謤	言覀二小
謥	言丿囗心
謦	士󰁅几言
謧	言亠乂厶
謨	言艹曰大
謩	艹曰大言
謪	言亠丷口
謫	言亠丷古
謬	言羽人彡
謭	言䒑月刀
謮	言貝󰁶
謯	言虍󰀐一
謰	言車辶󰁶
謱	言󰀻女󰀝
謲	言厶厶彡
謳	言匚口口
謴	言毌貝󰁶
謵	言羽白󰀝
謶	言广廿灬
謷	󰁡攵言
謸	言󰁡攵
謹	言廿口
謺	土䒑十言
謻	言禾夕夕
謼	言虍丿󰀛
謽	弓口虫言
謾	言曰罒又
謿	言十早月
譀	言乛耳攵
譁	言艹一󰀟
譂	言口口十
譃	言虍业󰀝
譄	言丷󰀺日
譅	言刀丶止
譆	言士口口
譇	言大土日
譈	言󰁸孑攵
證	言癶一䒑
譊	言土土儿
譋	言門月󰀝
譌	言爫丿灬
譍	广亻亻󰁷
譎	言󰁻乛口
譏	言幺幺人
譐	言丷西寸
譑	言丿大口
譒	言丿米田
譓	言一曰心
譔	言巳巳八
譕	言𠂉一灬
譖	言󰀄󰁜日
譗	言⺮人口
識	言亠丷日
譙	言亻󰁷灬
譚	言覀早󰀢
譛	言夫夫日
譜	言䒑业日
譝	言黽󰀝
譞	言罒一󰀔
譟	言口口木
譠	言亠囗一
譡	言⺌冖田
譢	言䒑󰀓辶
譣	言人一人
譤	言白方攵
譥	白方攵言
警	艹勹口言
譧	言广䒑八
譨	言ㄇ󰁺󰀖
譩	言立曰心
譪	言艹曰󰄃
譫	言⺈厂言
譬	尸口辛言
譭	言臼工又
譮	言人一日
譯	言罒土十
議	言丷王丶
譱	羊言言󰀌
譲	言六󰀀󰀔
譳	言󰀙丆〢
譴	言口丨辶
譵	言业丷寸
譶	言言言󰀘
護	言艹亻又
譸	言士乛寸
譹	言󰁸冖󰀓
譺	言匕𠂉󰁾
譻	貝貝言󰀘
譼	匚丨󰁃言
譽	󰀗一󰁕言
譾	言䒑月羽
譿	言三丨心
讀	言士罒貝
讁	言亠丷辶
讂	言⺈ㄇ夂
讃	言夫夫貝
讄	言田田田
讅	言宀丿田
讆	彳󰁆口言
讇	言門⺈臼
讈	言厂禾止
讉	言口丨辶
變	言糹糹攵
讋	立月一言
讌	言廿口灬
讍	言王口口
讎	亻󰁷言󰁷
讏	彳󰁆口言
讐	亻󰁷亻󰁷
讑	言人一艹
讒	言⺈口丶
讓	言亠口󰀔
讔	言阝爫心
讕	言門木󰀹
讖	言人人󰀞
讗	言山亻口
讘	言耳耳耳
讙	言艹口󰁷
讚	言丿土貝
讛	言艹土厶
讜	言⺌冖灬
讝	言口口攵
讞	言虍一犬
讟	言士罒言
讠	讠丶󰁉
计	讠十󰀢
订	讠丁󰀢
讣	讠卜󰁶
认	讠人󰁶
讥	讠几󰁀
讦	讠干󰀢
讧	讠工󰀝
讨	讠寸󰁶
让	讠上󰀝
讪	讠山󰀢
讫	讠𠂉乙󰁀
讬	讠丿七󰁀
训	讠川󰀢
议	讠丶乂󰁶
讯	讠⺄十󰀢
记	讠己󰁀
讱	讠刀丶󰁶
讲	讠二󰀯󰀢
讳	讠二𠃌丨
讴	讠匚乂󰁶
讵	讠匚󰁃󰀝
讶	讠󰀄亅丿
讷	讠冂人󰁶
许	讠𠂉十󰀢
讹	讠亻ヒ󰁀
论	讠人匕󰁀
讻	讠乂凵󰀢
讼	讠八厶󰁶
讽	讠几乂󰁶
设	讠几又󰁶
访	讠方󰁥
诀	讠ユ人󰁶
证	讠一止󰀝
诂	讠古󰀝
诃	讠丁口󰀝
评	讠一丷十
诅	讠󰀐一󰀝
识	讠口八󰁶
诇	讠冂口󰀝
诈	讠𠂉丨二
诉	讠斤丶󰁶
诊	讠人彡󰁥
诋	讠󰁚󰀁丶
诌	讠⺈彐󰀝
词	讠𠃌一口
诎	讠凵山󰀢
诏	讠刀口󰀝
诐	讠皮󰁶
译	讠又󰀟󰀢
诒	讠厶口󰀝
诓	讠匚王󰀝
诔	讠二木󰁶
试	讠󰀁工丶
诖	讠土土󰀝
诗	讠土寸󰁶
诘	讠士口󰀝
诙	讠火󰁶
诚	讠戊𠃌󰁀
诛	讠丿未󰁶
诜	讠丿土儿
话	讠丿古󰀝
诞	讠丿󰀥廴
诟	讠⺁一口
诠	讠人王󰀝
诡	讠⺈厂⺋
询	讠勹日󰀝
诣	讠匕日󰀝
诤	讠⺈󰁬亅
该	讠亠ㄥ人
详	讠羊󰀢
诧	讠宀丿七
诨	讠冖车󰀢
诩	讠羽󰀝
诪	讠三丿寸
诫	讠戈廾󰀢
诬	讠工人人
语	讠五口󰀝
诮	讠⺌月󰀝
误	讠口一大
诰	讠丿土口
诱	讠禾乃󰁥
诲	讠𠂉母󰁶
诳	讠犭󰁥王
说	讠丷口儿
诵	讠󰁻用󰀢
诶	讠厶𠂉大
请	讠月󰀝
诸	讠土丿日
诹	讠耳又󰁶
诺	讠艹口
读	讠十乛大
诼	讠一󰀓丶
诽	讠丨三三
课	讠曰木󰁶
诿	讠禾女󰀝
谀	讠臼人󰁶
谁	讠亻󰁷󰀝
谂	讠人丶心
调	讠󰀼土口
谄	讠⺈臼󰀝
谅	讠󰁸小󰁶
谆	讠󰁸子󰀝
谇	讠亠人十
谈	讠火火󰁶
谉	讠宀曰丨
谊	讠宀󰀐一
谋	讠甘木󰁶
谌	讠󰀎八󰄃
谍	讠廿󰄃木
谎	讠艹亠󰀸
谏	讠木󰀹󰀝
谐	讠󰁴匕白
谑	讠虍匚一
谒	讠曰勹󰄃
谓	讠田月󰀝
谔	讠口口ㄅ
谕	讠人一刂
谖	讠爫一又
谗	讠⺈口󰁦
谘	讠冫⺈口
谙	讠立曰󰀝
谚	讠立丿彡
谛	讠亠丷丨
谜	讠米辶󰁶
谝	讠丶尸艹
谞	讠乛󰁾月
谟	讠艹曰大
谠	讠⺌冖儿
谡	讠田八夂
谢	讠丿󰀽寸
谣	讠爫𠂉凵
谤	讠亠丷方
谥	讠䒑八皿
谦	讠䒑󰁬八
谧	讠心丿皿
谨	讠廿口
谩	讠曰罒又
谪	讠亠丷古
谫	讠䒑月刀
谬	讠羽人彡
谭	讠覀早󰀢
谮	讠󰀄󰁜曰
谯	讠亻󰁷灬
谰	讠门木󰀹
谱	讠䒑业日
谲	讠󰁻乛口
谳	讠十冂犬
谴	讠口丨辶
谵	讠⺈厂言
谶	讠人人󰀞
谷	八人口󰀘
谸	丿八口
谹	八人口厶
谺	八人口丿
谻	八人口󰀠
谼	八人口八
谽	八人口口
谾	八人口工
谿	爫幺大口
豀	八人口大
豁	宀三丨口
豂	八人口彡
豃	八人口攵
豄	八人口貝
豅	八人口三
豆	一口䒑󰀘
豇	一口䒑工
豈	山一口䒑
豉	一口䒑又
豊	ㄇ󰁺一䒑
豋	󰁯一口䒑
豌	一口䒑⺋
豍	一口䒑十
豎	匚丨󰁃䒑
豏	一口䒑八
豐	山三丨䒑
豑	ㄇ󰁺一丿
豒	山三丨丿
豓	山三丨皿
豔	山三丨皿
豕	一󰀓󰀦
豖	一󰀓丶󰀦
豗	一儿一󰀓
豘	一󰀓一乚
豙	立󰀓󰁧
豚	月一󰀓󰁶
豛	一󰀓几又
豜	一󰀓一廾
豝	一󰀓巴󰁀
豞	一󰀓勹口
豟	一󰀓丶乙
豠	一󰀓󰀐一
象	⺈口󰀓󰁧
豢	丷夫一󰀓
豣	一󰀓一干
豤	一󰀓艮󰁶
豥	一󰀓亠人
豦	虍一󰀓󰀦
豧	一󰀓甫󰁶
豨	一󰀓乂丨
豩	一󰀓一󰀓
豪	󰁸冖一󰀓
豫	󰁻乛亅󰀓
豬	一󰀓土日
豭	一󰀓󰁃又
豮	一󰀓十贝
豯	一󰀓爫大
豰	士冖二又
豱	一󰀓日皿
豲	一󰀓厂小
豳	山一󰀓󰀓
豴	一󰀓亠古
豵	一󰀓彳󰁾
豶	一󰀓十貝
豷	一󰀓土䒑
豸	豸丿丶丿
豹	豸勹丶󰁶
豺	豸󰀛丿󰁥
豻	豸干󰀢
豼	豸󰁴匕󰁀
豽	豸冂人󰁶
豾	豸丆卜一
豿	豸勹口󰀝
貀	豸凵山󰀢
貁	豸宀八󰁶
貂	豸刀口󰀝
貃	豸白󰀝
貄	豸󰁬󰀟󰀢
貅	豸亻木󰁶
貆	豸一曰一
貇	豸艮󰁶
貈	豸丿󰁪󰁶
貉	豸夂口󰀝
貊	豸丆日󰀝
貋	豸曰干󰀢
貌	豸白儿󰁀
貍	豸曰土󰀝
貎	豸臼儿󰁀
貏	豸白丿十
貐	豸人一刂
貑	豸󰁃丨又
貒	豸山丆〢
貓	豸艹田󰀝
貔	豸丿囗匕
貕	豸爫幺大
貖	豸䒑八皿
貗	豸󰀻女󰀝
貘	豸艹曰大
貙	豸匚口口
貚	豸口口十
貛	豸艹口󰁷
貜	豸目目又
貝	貝丨󰁈丶
貞	󰀥貝󰁧
貟	厶貝󰁧
負	⺈貝󰁧
財	貝󰀛丿󰁥
貢	工貝󰁧
貣	󰀁丶貝󰁧
貤	貝也󰁀
貥	貝亠几󰁀
貦	貝二儿󰁀
貧	八刀貝󰁧
貨	亻ヒ貝󰁧
販	貝⺁又󰁶
貪	人丶乛貝
貫	毌貝󰁧
責	貝󰁧
貭	⺁十貝󰀦
貮	一󰀁貝丶
貯	貝宀丁󰀢
貰	廿󰄃貝󰁧
貱	貝皮󰁶
貲	止匕貝󰁧
貳	󰀁二貝丶
貴	口丨一貝
貵	厶大貝󰁧
貶	貝丿之󰁶
買	罒貝󰁧
貸	亻󰀁丶貝
貹	貝丿󰀝
貺	貝口儿󰁀
費	弓󰀯貝󰁧
貼	貝󰀥口󰀝
貽	貝厶口󰀝
貾	貝󰁚󰀁丶
貿	󰁚丶刀貝
賀	力口貝󰁧
賁	十艹貝󰁧
賂	貝夂口󰀝
賃	亻丿士貝
賄	貝月󰀝
賅	貝亠ㄥ人
賆	貝䒑廾󰀢
資	冫⺈人貝
賈	覀貝󰁧
賉	貝丿皿󰀝
賊	貝戈󰁥
賋	貝六乂󰁶
賌	亠ㄥ丿貝
賍	貝广土󰀝
賎	貝二戈󰁶
賏	貝貝󰁶
賐	貝厶八夂
賑	貝厂二󰀖
賒	貝人二小
賓	宀一󰀤貝
賔	宀󰁅貝󰁧
賕	貝一氺丶
賖	貝人一朩
賗	貝口口丨
賘	貝广土丶
賙	貝󰀼土口
賚	木人人貝
賛	夫夫貝󰁧
賜	貝曰勹󰁤
賝	貝冖八木
賞	⺌冖口貝
賟	貝ㄇ󰁺八
賠	貝立口󰀝
賡	广󰁬人貝
賢	匚丨󰁃貝
賣	士罒貝󰁧
賤	貝戈戈󰁶
賥	貝亠人十
賦	貝一󰀁丶
賧	貝火火󰁶
賨	宀二小貝
賩	貝宀二小
質	斤斤貝󰁧
賫	十人人貝
賬	貝󰀍󰀖󰁶
賭	貝土丿日
賮	󰁬丨一貝
賯	貝勹日子
賰	貝三人日
賱	貝冖車󰀢
賲	亻口木貝
賳	貝十戈口
賴	木口⺈貝
賵	貝󰀰目󰀝
賶	貝人丶口
賷	十口口貝
賸	月丷夫貝
賹	貝䒑八皿
賺	貝䒑󰁬八
賻	貝甫寸󰁶
購	貝󰀀冂土
賽	宀󰀀八貝
賾	匚丨口貝
賿	貝羽人彡
贀	匚𠂉大貝
贁	貝貝攵󰁶
贂	貝厶厶彡
贃	貝口口心
贄	土䒑十貝
贅	󰁡攵貝
贆	貝犬犬犬
贇	文一󰀁貝
贈	貝丷󰀺日
贉	貝覀早󰀢
贊	丿土󰁜貝
贋	厂亻亻貝
贌	貝业䒑夫
贍	貝⺈厂言
贎	貝艹曰丶
贏	󰄹月貝丶
贐	貝󰁬丨皿
贑	立早工貝
贒	匚丨󰁃貝
贓	貝戈爿丨
贔	貝貝貝󰁧
贕	󰁚丶丿貝
贖	貝士罒貝
贗	厂亻󰁟貝
贘	貝⺌冖貝
贙	虍几虍貝
贚	貝立月三
贛	立早夂貝
贜	貝艹戈丨
贝	贝丨󰁈丶
贞	󰀥贝󰁧
负	⺈贝󰁧
贠	厶贝󰁧
贡	工贝󰁧
财	贝󰀛丿󰁥
责	贝󰁧
贤	〢又贝󰁧
败	贝攵󰁶
账	贝丿七󰂃
货	亻ヒ贝󰁧
质	⺁十贝󰀦
贩	贝⺁又󰁶
贪	人丶乛贝
贫	八刀贝󰁧
贬	贝丿之󰁶
购	贝勹厶󰁶
贮	贝宀一󰀝
贯	毌贝󰁧
贰	󰀁二贝丶
贱	贝一戈󰁶
贲	十艹贝󰁧
贳	廿󰄃贝󰁧
贴	贝󰀥口󰀝
贵	口丨一贝
贶	贝口儿󰁀
贷	亻󰀁丶贝
贸	󰁚丶刀贝
费	弓󰀯贝󰁧
贺	力口贝󰁧
贻	贝厶口󰀝
贼	贝戈󰁥
贽	扌九丶贝
贾	覀贝󰁧
贿	贝月󰀝
赀	止匕贝󰁧
赁	亻丿士贝
赂	贝夂口󰀝
赃	贝广土󰀝
资	冫⺈人贝
赅	贝亠ㄥ人
赆	贝尸󰂃󰁦
赇	贝一氺丶
赈	贝厂二󰀖
赉	一丷木贝
赊	贝人二小
赋	贝一󰀁丶
赌	贝土丿日
赍	十人人贝
赎	贝十乛大
赏	⺌冖口贝
赐	贝曰勹󰁤
赑	贝贝贝󰁧
赒	贝󰀼土口
赓	广󰁬人贝
赔	贝立口󰀝
赕	贝火火󰁶
赖	木口⺈贝
赗	贝󰀰目󰀝
赘	󰁡攵贝
赙	贝甫寸󰁶
赚	贝䒑󰁬八
赛	宀󰀀八贝
赜	匚丨口贝
赝	厂亻亻贝
赞	丿土儿贝
赟	文一󰀁贝
赠	贝丷󰀺日
赡	贝⺈厂言
赢	󰄹月贝丶
赣	立早夂贝
赤	土󰁖󰁧
赥	土󰁖⺈人
赦	土󰁖攵󰁶
赧	土󰁖卩又
赨	土󰁖虫󰁶
赩	土󰁖⺈巴
赪	土󰁖󰀥贝
赫	土󰁖土󰁖
赬	土󰁖󰀥貝
赭	土󰁖土曰
赮	土󰁖󰁃又
赯	土󰁖广口
走	土󰁾󰁧
赱	土丷󰂃󰁧
赲	土󰁾力󰀏
赳	土󰁾󰁐丨
赴	土󰁾卜󰀦
赵	土󰁾乂󰀦
赶	土󰁾干󰀵
起	土󰁾己󰁫
赸	土󰁾山󰀵
赹	土󰁾勹冫
赺	土󰁾人乛
赻	土󰁾小丿
赼	土󰁾⺈人
赽	土󰁾ユ人
赾	土󰁾斤󰀵
赿	土󰁾󰁚󰀁
趀	土󰁾丿丿
趁	土󰁾人彡
趂	土󰁾⺈小
趃	土󰁾丿夫
趄	土󰁾󰀐一
超	土󰁾刀口
趆	土󰁾󰁚丶
趇	土󰁾立󰀌
趈	土󰁾󰀥口
趉	土󰁾凵山
越	土󰁾戈󰁐
趋	土󰁾⺈彐
趌	土󰁾士口
趍	土󰁾夕夕
趎	土󰁾丿未
趏	土󰁾丿古
趐	土󰁾羽󰀌
趑	土󰁾冫人
趒	土󰁾儿󰀪
趓	土󰁾几木
趔	土󰁾一刂
趕	土󰁾曰干
趖	土󰁾人土
趗	土󰁾口󰁾
趘	土󰁾尸毛
趙	土󰁾⺌月
趚	土󰁾木口
趛	土󰁾金󰀌
趜	土󰁾勹米
趝	土󰁾人心
趞	土󰁾󰁺日
趟	土󰁾⺌口
趠	土󰁾󰀥早
趡	土󰁾亻󰁷
趢	土󰁾󰁭氺
趣	土󰁾耳又
趤	土󰁾宀石
趥	土󰁾丷一
趦	土󰁾冫口
趧	土󰁾日󰁾
趨	土󰁾勹丿
趩	土󰁾田八
趪	土󰁾󰁺八
趫	土󰁾丿口
趬	土󰁾土儿
趭	土󰁾亻灬
趮	土󰁾口木
趯	土󰁾羽󰁷
趰	土󰁾一乂
趱	土󰁾丿贝
趲	土󰁾丿貝
足	口󰁾󰁧
趴	口止八󰁶
趵	口止勹丶
趶	口止一󰀛
趷	口止𠂉乙
趸	一󰁡口󰁾
趹	口止ユ人
趺	口止夫󰁶
趻	口止人乛
趼	口止一廾
趽	口止方󰁥
趾	口止止󰀝
趿	口止乃󰂃
跀	口止月󰀝
跁	口止巴󰁀
跂	口止十又
跃	口止丿大
跄	口止人⺋
跅	口止斤丶
跆	口止厶口
跇	口止廿󰄃
跈	口止人彡
跉	口止人󰁻
跊	口止未󰁶
跋	口止丶
跌	口止丿夫
跍	口止古󰀝
跎	口止宀匕
跏	口止力口
跐	口止止匕
跑	口止勹巳
跒	口止丁口
跓	口止丶王
跔	口止勹口
跕	口止󰀥口
跖	口止石󰀝
跗	口止亻寸
跘	口止丷󰀟
跙	口止󰀐一
跚	口止󰀼一
跛	口止皮󰁶
跜	口止尸匕
距	口止匚󰁃
跞	口止丿小
跟	口止艮󰁶
跠	口止一人
跡	口止亠󰁖
跢	口止夕夕
跣	口止丿儿
跤	口止六乂
跥	口止乃木
跦	口止丿未
跧	口止人王
跨	口止大ㄅ
跩	口止曰丿
跪	口止⺈⺋
跫	工几丶󰁾
跬	口止土土
跭	口止夂㐄
跮	口止一土
路	口止夂口
跰	口止䒑廾
跱	口止土寸
跲	口止人口
跳	口止儿󰀪
跴	口止西󰀝
践	口止一戈
跶	口止大辶
跷	口止󰀁儿
跸	口止󰁴十
跹	口止丿辶
跺	口止几木
跻	口止文󰀯
跼	口止尸口
跽	口止己心
跾	亻丨攵󰁾
跿	口止土󰁾
踀	口止口󰁾
踁	口止一工
踂	口止耳乚
踃	口止⺌月
踄	口止止󰀤
踅	扌斤口󰁾
踆	口止厶夂
踇	口止𠂉母
踈	口止木口
踉	口止丶艮
踊	口止󰁻用
踋	口止土卩
踌	口止三寸
踍	口止土子
踎	口止丆口
踏	口止水曰
踐	口止戈戈
踑	口止󰀎八
踒	口止禾女
踓	口止亻󰁷
踔	口止󰀥早
踕	口止一󰁾
踖	口止󰁺日
踗	口止人心
踘	口止勹米
踙	口止耳又
踚	口止人艹
踛	口止土土
踜	口止土夂
踝	口止曰木
踞	口止尸古
踟	口止𠂉口
踠	口止宀⺋
踡	口止丷⺋
踢	口止曰󰁤
踣	口止立口
踤	口止亠十
踥	口止立女
踦	口止大口
踧	口止上又
踨	口止人󰁾
踩	口止爫木
踪	口止宀小
踫	口止䒑业
踬	口止⺁贝
踭	口止⺈亅
踮	口止广口
踯	口止䒑阝
踰	口止人刂
踱	口止广又
踲	口止⺁目
踳	口止三日
踴	口止󰁻力
踵	口止丿土
踶	口止日󰁾
踷	口止土日
踸	口止󰀎󰄃
踹	口止山〢
踺	口止󰁬廴
踻	口止ㄇ口
踼	口止日󰁤
踽	口止丿丶
踾	口止一田
踿	口止禾火
蹀	口止廿木
蹁	口止丶艹
蹂	口止󰁻木
蹃	口止艹口
蹄	口止亠丨
蹅	口止木一
蹆	口止艮辶
蹇	宀󰀀八󰁾
蹈	口止爫臼
蹉	口止⺶工
蹊	口止爫大
蹋	口止曰羽
蹌	口止人口
蹍	口止尸󰀖
蹎	口止十八
蹏	口止⺁几
蹐	口止󰀪月
蹑	口止耳又
蹒	口止艹人
蹓	口止󰁚田
蹔	車斤口󰁾
蹕	口止曰󰀟
蹖	口止三臼
蹗	口止󰁙匕
蹘	口止羽彡
蹙	戊上小󰁾
蹚	口止⺌土
蹛	口止廿丨
蹜	口止宀日
蹝	口止彳󰁾
蹞	口止󰁴貝
蹟	口止貝
蹠	口止广灬
蹡	口止爿寸
蹢	口止亠古
蹣	口止廿丶
蹤	口止彳󰁾
蹥	口止車辶
蹦	口止山月
蹧	口止一日
蹨	口止󰁝灬
蹩	㡀攵口󰁾
蹪	口止口貝
蹫	口止󰁻口
蹬	口止癶䒑
蹭	口止丷日
蹮	口止覀巳
蹯	口止丿田
蹰	口止厂寸
蹱	口止立土
蹲	口止丷寸
蹳	口止癶又
蹴	口止󰁸丶
蹵	󰁸小󰁾
蹶	口止厂人
蹷	厂䒑凵󰁾
蹸	口止米㐄
蹹	口止人羽
蹺	口止土儿
蹻	口止丿口
蹼	口止业夫
蹽	口止大小
蹾	口止󰁸攵
蹿	口止宀丨
躀	口止毌貝
躁	口止口木
躂	口止土辶
躃	口止尸辛
躄	尸口辛󰁾
躅	口止罒虫
躆	口止虍󰀓
躇	口止艹日
躈	口止白攵
躉	艹曰冂󰁾
躊	口止士寸
躋	口止󰀴󰀳
躌	口止𠂉㐄
躍	口止羽󰁷
躎	口止一乂
躏	口止艹󰁷
躐	口止巛󰁒
躑	口止丷阝
躒	口止白木
躓	口止斤貝
躔	口止广土
躕	口止广寸
躖	口止幺丨
躗	彳󰁆口󰁾
躘	口止立三
躙	口止門󰁷
躚	口止覀辶
躛	彳󰁆口󰁾
躜	口止丿贝
躝	口止門󰀹
躞	口止言又
躟	口止亠󰀔
躠	艹丿󰃧󰁾
躡	口止耳耳
躢	口止門羽
躣	口止目󰁷
躤	口止艹日
躥	口止宀󰁒
躦	口止丿貝
躧	口止一匕
躨	口止䒑夂
躩	口止目又
躪	口止艹󰁷
身	丿󰀽三丿
躬	丿󰀽三弓
躭	丿󰀽三󰁜
躮	丿󰀽三刀
躯	丿󰀽三乂
躰	丿󰀽三一
躱	丿󰀽三木
躲	丿󰀽三木
躳	丿󰀽三口
躴	丿󰀽三艮
躵	丿󰀽三心
躶	丿󰀽三木
躷	丿󰀽三女
躸	丿󰀽三口
躹	丿󰀽三米
躺	丿󰀽三口
躻	丿󰀽三工
躼	丿󰀽三󰀖
躽	丿󰀽三女
躾	丿󰀽三大
躿	丿󰀽三氺
軀	丿󰀽三口
軁	丿󰀽三女
軂	丿󰀽三力
軃	丿󰀽三十
軄	丿󰀽三日
軅	丿󰀽三󰁷
軆	丿󰀽三䒑
軇	丿󰀽三寸
軈	丿󰀽三心
軉	丿󰀽三貝
車	車一丨丨
軋	車乚󰁀
軌	車九󰁀
軍	冖車󰀬
軎	車口󰀘
軏	車一儿󰁀
軐	車⺄十󰀢
軑	車大󰁶
軒	車干󰀢
軓	車几丶󰁶
軔	車刀丶󰁶
軕	車山󰀢
軖	車王󰀝
軗	車几又󰁶
軘	車一凵乚
軙	車󰀥又󰁶
軚	車大丶󰁶
軛	車厂⺋󰁀
軜	車冂人󰁶
軝	車󰁚󰀁󰁀
軞	車毛󰁀
軟	車⺈人󰁶
軠	車丿士󰀝
軡	車人丶乛
転	車二厶󰁶
軣	車󰀪󰁧
軤	車丿丷󰀛
軥	車勹口󰀝
軦	車口儿󰁀
軧	車󰁚󰀁丶
軨	車人丶󰁻
軩	車厶口󰀝
軪	車幺力󰁥
軫	車人彡󰁥
軬	厶大車󰀬
軭	車匚王󰀝
軮	車ㄇ大󰁶
軯	車一丷十
軰	丬匕車󰀬
軱	車⺁厶󰂃
軲	車古󰀝
軳	車勹巳󰁀
軴	車丶王󰀝
軵	車亻寸󰁶
軶	車丶尸乙
軷	車又丶
軸	車由󰀝
軹	車口八󰁶
軺	車刀口󰀝
軻	車丁口󰀝
軼	車丿夫󰁶
軽	車又土󰀝
軾	車󰀁工丶
軿	車䒑廾󰀢
輀	車丆冂〢
輁	車󰁺八󰁶
輂	󰁺八車󰀬
較	車六乂󰁶
輄	車⺌一儿
輅	車夂口󰀝
輆	車亠ㄥ人
輇	車人王󰀝
輈	車丿󰁪󰁶
載	十戈車󰀵
輊	車一厶土
輋	山大車󰀬
輌	車一冂山
輍	車八人口
輎	車⺌月󰀝
輏	車西一󰀝
輐	車宀二儿
輑	車󰁬丿口
輒	車耳乚󰁀
輓	車⺈口󰁜
輔	車甫󰁶
輕	車一巛工
輖	車󰀼土口
輗	車臼儿󰁀
輘	車土八夂
輙	車耳又󰁶
輚	車戈戈󰁶
輛	車一冂丶
輜	車巛田󰀝
輝	⺌一儿車
輞	車冂䒑󰄃
輟	車又又又
輠	車曰木󰁶
輡	車⺈臼󰀝
輢	車大丁口
輣	車月月󰀝
輤	車月󰀝
輥	車曰󰁴匕
輦	夫夫車󰀬
輧	車丿一干
輨	車宀󰃧󰀝
輩	丨三丨車
輪	車人一艹
輫	車丨三三
輬	車󰁸小󰁶
輭	車丆冂大
輮	車󰁻乛木
輯	車口耳󰀝
輰	車曰一󰁤
輱	車戊一口
輲	車山丆〢
輳	車三人大
輴	車⺁十目
輵	車曰勹󰄃
輶	車丷西一
輷	車勹言󰀝
輸	車人一刂
輹	車𠂉日夂
輺	車巛一田
輻	車一口田
輼	車曰皿󰀝
輽	車厶大田
輾	車尸󰁺󰀖
輿	󰀗車一八
轀	車囗人皿
轁	車爫臼󰀝
轂	士冖一又
轃	車三人禾
轄	車宀三口
轅	車土口󰀔
轆	車󰁙󰁴匕
轇	車羽人彡
轈	車巛曰木
轉	車一曰寸
轊	車三丨彐
轋	車車辶󰁶
轌	車󰀙彐󰀝
轍	車亠厶攵
轎	車丿大口
轏	車尸子子
轐	車业䒑夫
轑	車大丷小
轒	車十艹貝
轓	車丿米田
轔	車米夕㐄
轕	車艹曰󰄃
轖	車土人口
轗	車戊一心
轘	車罒一󰀔
轙	車丷王丶
轚	車凵几車
轛	車业丷寸
轜	車󰀙丆〢
轝	󰀗一󰁕車
轞	車匚丨皿
轟	車車車󰀬
轠	車田田田
轡	糹車糹口
轢	車白幺木
轣	車厂禾止
轤	車虍田皿
轥	車艹門󰁷
车	车一ㄥ丨
轧	车乚󰁀
轨	车九󰁀
轩	车干󰀢
轪	车大󰁶
轫	车刀丶󰁶
转	车二󰁓丶
轭	车厂⺋󰁀
轮	车人匕󰁀
软	车⺈人󰁶
轰	车又又󰁧
轱	车古󰀝
轲	车丁口󰀝
轳	车󰀥尸󰁥
轴	车由󰀝
轵	车口八󰁶
轶	车丿夫󰁶
轷	车丿丷󰀛
轸	车人彡󰁥
轹	车丿󰄃小
轺	车刀口󰀝
轻	车ス工󰀝
轼	车󰀁工丶
载	十戈车󰀌
轾	车一厶土
轿	车丿大󰀯
辀	车丿󰁪󰁶
辁	车人王󰀝
辂	车夂口󰀝
较	车六乂󰁶
辄	车耳乚󰁀
辅	车甫󰁶
辆	车一冂人
辇	夫夫车󰀬
辈	丨三丨车
辉	⺌一儿车
辊	车曰󰁴匕
辋	车冂䒑󰄃
辌	车󰁸小󰁶
辍	车又又又
辎	车巛田󰀝
辏	车三人大
辐	车一口田
辑	车口耳󰀝
辒	车曰皿󰀝
输	车人一刂
辔	车纟纟口
辕	车土口󰀔
辖	车宀三口
辗	车尸󰁺󰀖
辘	车󰁙󰁴匕
辙	车亠厶攵
辚	车米夕㐄
辛	辛丶一丨
辜	古辛󰀬
辝	厶口辛󰀢
辞	丿古辛󰀢
辟	尸口辛󰀢
辠	丿目辛󰀬
辡	辛辛󰀢
辢	木口辛󰀢
辣	辛木口󰀝
辤	爫冖又辛
辥	凵丿丿辛
辦	辛力辛󰀢
辧	辛刀辛󰀢
辨	辛丶丿辛
辩	辛讠辛󰀢
辪	止丿󰃧辛
辫	辛纟辛󰀢
辬	辛文辛󰀢
辭	爫󰁻冂辛
辮	辛幺小辛
辯	辛言辛󰀢
辰	厂二󰀖󰀦
辱	厂二󰀖寸
農	ㄇ󰁺厂󰀖
辳	木木厂󰀖
辴	口口曰󰀖
辵	彡󰁾󰁧
辶	辶丶󰁈󰂃
辷	一辶󰀌
辸	乃辶󰀏
边	力辶󰀏
辺	刀辶󰀏
辻	十辶󰀵
込	丿󰂃辶󰀦
辽	了辶󰀵
达	大辶󰀦
辿	山辶󰀵
迀	干辶󰀵
迁	丿十辶󰀵
迂	一󰀛辶󰀵
迃	二ㄅ辶󰁫
迄	𠂉乙辶󰁫
迅	⺄十辶󰀵
迆	也辶󰁫
过	寸辶󰀦
迈	一󰁡辶󰀏
迉	尸辶󰀏
迊	一冂丨辶
迋	王辶󰀌
迌	月辶󰀌
迍	一凵乚辶
迎	󰁚卩辶󰀵
迏	大丶辶󰀦
运	二厶辶󰀦
近	斤辶󰀵
迒	亠几辶󰁫
迓	󰀄亅丿辶
返	⺁又辶󰀦
迕	𠂉十辶󰀵
迖	犬辶󰀦
迗	一大辶󰀦
还	丆卜辶󰀦
这	文辶󰀦
迚	口丨辶󰀵
进	二󰀯辶󰀵
远	二儿辶󰁫
违	二𠃌丨辶
连	车辶󰀵
迟	尸󰂃辶󰀦
迠	󰀥口辶󰀌
迡	尸匕辶󰁫
迢	刀口辶󰀌
迣	廿󰄃辶󰁫
迤	𠂉也辶󰁫
迥	冂口辶󰀌
迦	力口辶󰀌
迧	曰丨辶󰀵
迨	厶口辶󰀌
迩	⺈小辶󰀦
迪	由辶󰀌
迫	白辶󰀌
迬	丶王辶󰀌
迭	丿夫辶󰀦
迮	𠂉丨二辶
迯	夕卜辶󰀦
述	木丶辶󰀦
迱	宀匕辶󰁫
迲	土厶辶󰀦
迳	ス工辶󰀌
迴	囗口辶󰀌
迵	冂一口辶
迶	月辶󰀌
迷	米辶󰀦
迸	䒑廾辶󰀵
迹	亠󰁖辶󰀦
迺	西辶󰀌
迻	夕夕辶󰀦
迼	士口辶󰀌
追	丿󰃧辶󰀌
迾	一夕刂辶
迿	勹日辶󰀌
退	艮辶󰀦
送	䒑大辶󰀦
适	丿古辶󰀌
逃	儿󰀪辶󰀦
逄	夂㐄辶󰀵
逅	⺁一口辶
逆	䒑凵丿辶
逇	土也辶󰁫
逈	丿冂口辶
选	丿土儿辶
逊	孑小辶󰀦
逋	甫辶󰀦
逌	󰀥囗󰁃辶
逍	⺌月辶󰀌
逎	西一辶󰀌
透	禾乃辶󰀏
逐	一󰀓辶󰀦
逑	一氺丶辶
递	丷弓丨辶
逓	⺁二冂辶
途	人一朩辶
逕	一巛工辶
逖	犭󰁥火辶
逗	一口䒑辶
逘	厶𠂉大辶
這	言辶󰀌
通	󰁻用辶󰀵
逛	犭󰁥王辶
逜	五口辶󰀌
逝	扌斤辶󰀵
逞	口王辶󰀌
速	木口辶󰀌
造	丿土口辶
逡	厶八夂辶
逢	夂三丨辶
連	車辶󰀵
逤	氵小丿辶
逥	囗〢二辶
逦	一冂丶辶
逧	八人口辶
逨	木人人辶
逩	大十廾辶
逪	󰁺曰辶󰀌
逫	又又又辶
逬	丿一辶
逭	宀󰃧辶󰀌
逮	󰁬氺辶󰀦
逯	󰁭氺辶󰀦
逰	扌𠂉子辶
週	󰀼土口辶
進	亻󰁷辶󰀌
逳	亠厶月辶
逴	󰀥早辶󰀵
逵	土八土辶
逶	禾女辶󰀌
逷	日勹󰁤辶
逸	⺈口󰁜辶
逹	土䒑十辶
逺	土ㄥ󰀔辶
逻	罒夕辶󰀦
逼	一口田辶
逽	艹口辶
逾	人一月辶
逿	曰一勹辶
遀	工月辶
遁	⺁十目辶
遂	䒑󰀓辶󰀦
遃	立丿彡辶
遄	山丆冂辶
遅	尸羊辶󰀵
遆	亠丷冖辶
遇	曰冂丨辶
遈	日一󰁾辶
遉	󰀥貝辶󰀦
遊	方𠂉子辶
運	冖車辶󰀵
遌	口口二辶
遍	丶尸冂辶
過	ㄇ󰁈冂辶
遏	日勹人辶
遐	󰁃丨二辶
遑	白王辶󰀌
遒	丷西一辶
道	䒑丿目辶
達	土羊辶󰀵
違	󰁆口㐄辶
遖	十冂䒑辶
遗	口丨一辶
遘	󰀀冂土辶
遙	󰁝𠂉十辶
遚	臼丨又辶
遛	󰁚丶刀辶
遜	孑丿幺辶
遝	罒󰀫辶󰀦
遞	⺁虍几辶
遟	尸辛辶󰀵
遠	土口󰀔辶
遡	䒑凵丿辶
遢	曰羽辶󰀌
遣	口丨一辶
遤	󰀋灬辶󰀦
遥	爫𠂉十辶
遦	毌貝辶󰀦
遧	立早辶󰀵
遨	󰁡攵辶
適	亠丷冂辶
遪	厶厶厶辶
遫	木口攵辶
遬	木口⺈辶
遭	一ㄇ󰁺辶
遮	广廿灬辶
遯	月一󰀓辶
遰	廿儿冖辶
遱	󰀻女辶󰀌
遲	尸氺丿辶
遳	艹人人辶
遴	米夕㐄辶
遵	丷西一辶
遶	土土土辶
遷	覀大巳辶
選	巳巳󰁺辶
遹	󰁻乛亅辶
遺	口丨一辶
遻	口口䒑辶
遼	大丷日辶
遽	虍一󰀓辶
遾	⺮工人辶
避	尸口辛辶
邀	白方攵辶
邁	艹曰冂辶
邂	⺈用刀辶
邃	宀八䒑辶
還	罒一口辶
邅	亠囗口辶
邆	癶一口辶
邇	一八冂辶
邈	豸白儿辶
邉	丿目宀辶
邊	丿目宀辶
邋	巛囗乂辶
邌	禾勹丿辶
邍	夂田󰁭辶
邎	󰁝言丿辶
邏	罒糹亻辶
邐	一冂丶辶
邑	口巴󰀅
邒	丁阝󰀢
邓	又阝󰀢
邔	󰁁阝󰀢
邕	巛口巴󰀅
邖	山阝󰀢
邗	干阝󰀢
邘	一󰀛阝󰀢
邙	亠󰄃阝󰀢
邚	女阝󰀢
邛	工阝󰀢
邜	夕阝󰀢
邝	广阝󰀢
邞	夫阝󰀢
邟	亠几阝󰀢
邠	八刀阝󰀢
邡	方阝󰀢
邢	一廾阝󰀢
那	𠃌󰀠阝󰀢
邤	斤阝󰀢
邥	冖󰁜阝󰀢
邦	三丿阝󰀢
邧	二儿阝󰀢
邨	一凵󰁐阝
邩	火阝󰀢
邪	󰀄亅丿阝
邫	三丿口巴
邬	丿𠃌ㄅ阝
邭	勹口阝󰀢
邮	由阝󰀢
邯	甘阝󰀢
邰	厶口阝󰀢
邱	丘阝󰀢
邲	心丿阝󰀢
邳	丆卜󰀞阝
邴	一冂人阝
邵	刀口阝󰀢
邶	丬󰁴阝󰀢
邷	一󰁐⺄阝
邸	󰁚󰀁丶阝
邹	⺈彐阝󰀢
邺	业阝󰀢
邻	人丶󰁻阝
邼	匚王阝󰀢
邽	土土阝󰀢
邾	丿未阝󰀢
邿	土寸阝󰀢
郀	大二ㄅ阝
郁	月阝󰀢
郂	亠ㄥ丿阝
郃	人一口阝
郄	乂厶阝
郅	一厶土阝
郆	士口阝󰀢
郇	勹日阝󰀢
郈	⺁一口阝
郉	一干阝
郊	六乂阝󰀢
郋	丿目阝󰀢
郌	土土口巴
郍	丿󰁪阝󰀢
郎	丶󰁮阝󰀢
郏	一丷大阝
郐	人二厶阝
郑	䒑大阝󰀢
郒	丶󰁮口巴
郓	冖车阝󰀢
郔	丿󰀥󰄃阝
郕	戊𠃌阝󰀢
郖	一口䒑阝
郗	乂冂阝
郘	口口阝󰀢
郙	甫阝󰀢
郚	五口阝󰀢
郛	爫孑阝󰀢
郜	丿土口阝
郝	土󰁖阝󰀢
郞	丶艮阝󰀢
郟	大人人阝
郠	一曰乂阝
郡	󰁬丿口阝
郢	口王阝󰀢
郣	十冖孑阝
郤	八人口阝
郥	貝阝󰀢
郦	一冂丶阝
郧	口贝阝󰀢
部	立口阝󰀢
郩	乂月阝
郪	一󰁬丨阝
郫	白丿十阝
郬	月阝󰀢
郭	󰁸孑阝󰀢
郮	󰀼土口阝
郯	火火阝󰀢
郰	耳又阝󰀢
郱	䒑廾阝󰀢
郲	木人人阝
郳	臼儿阝󰀢
郴	木木阝󰀢
郵	丿士󰁺阝
郶	立口口巴
郷	󰁲丿󰁮阝
郸	丷曰十阝
郹	目犬阝󰀢
郺	夕夕巛巴
郻	目󰄃巛阝
郼	󰁆口㐄阝
都	土丿日阝
郾	匚曰女阝
郿	󰁅目阝󰀢
鄀	艹口阝
鄁	丬匕月阝
鄂	口口二阝
鄃	人一月阝
鄄	覀土阝󰀢
鄅	丿口冂阝
鄆	冖車阝󰀢
鄇	亻ユ𠂉阝
鄈	癶一大阝
鄉	󰁲丿丶阝
鄊	󰁲丿耳阝
鄋	臼丨又阝
鄌	广󰁬丨阝
鄍	冖曰六阝
鄎	丿目心阝
鄏	厂二󰀖阝
鄐	亠幺田阝
鄑	一业日阝
鄒	勹凵丿阝
鄓	丿目犬阝
鄔	󰁞灬阝󰀢
鄕	󰁲丿白阝
鄖	口貝阝󰀢
鄗	󰁸冂口阝
鄘	广󰁬月阝
鄙	口十囗阝
鄚	艹曰大阝
鄛	巛曰木阝
鄜	󰁙󰁴匕阝
鄝	羽人彡阝
鄞	廿口阝
鄟	一曰丨阝
鄠	󰀙二ㄅ阝
鄡	󰁟木阝󰀢
鄢	一止一阝
鄣	立早阝󰀢
鄤	曰罒又阝
鄥	󰁟灬阝󰀢
鄦	𠂉一󰀷阝
鄧	癶一口阝
鄨	㡀攵口巴
鄩	彐工口阝
鄪	弓󰀯貝阝
鄫	丷󰀺日阝
鄬	爫丿乛阝
鄭	丷西一阝
鄮	󰁚丶刀阝
鄯	羊䒑口阝
鄰	米夕㐄阝
鄱	丿米田阝
鄲	口口曰阝
鄳	黽阝󰀢
鄴	业䒑未阝
鄵	口口口阝
鄶	人一󰀺阝
鄷	ㄇ󰁺一阝
鄸	艹罒冖阝
鄹	耳又乑阝
鄺	广󰁺由阝
鄻	夫夫車阝
鄼	夫夫貝阝
鄽	广曰土阝
鄾	丆󰀐冖阝
鄿	艹口口阝
酀	廿口丬阝
酁	⺈口󰁴阝
酂	丿土儿阝
酃	󰀙口口阝
酄	艹口口阝
酅	山亻󰁷阝
酆	山三丨阝
酇	丿土󰁜阝
酈	一冂丶阝
酉	西一󰀌
酊	西一丁󰀢
酋	丷西一󰀘
酌	西一勹丶
配	西一己󰁀
酎	西一寸󰁶
酏	西一也󰁀
酐	西一干󰀢
酑	西一一󰀛
酒	氵西一󰀝
酓	人丶乛一
酔	西一九十
酕	西一毛󰁀
酖	西一冖󰁜
酗	西一乂凵
酘	西一几又
酙	西一󰁦十
酚	西一八刀
酛	西一二儿
酜	西一夫󰁶
酝	西一二厶
酞	西一大丶
酟	西一󰀥口
酠	西一丁口
酡	西一宀匕
酢	西一𠂉二
酣	西一甘󰀝
酤	西一古󰀝
酥	西一禾󰁶
酦	西一ㄥ丶
酧	西一宀寸
酨	十戈西一
酩	西一夕口
酪	西一夂口
酫	西一人王
酬	西一丶丨
酭	西一月
酮	西一冂口
酯	西一匕曰
酰	西一丿儿
酱	丬夕西一
酲	西一口王
酳	西一幺月
酴	西一人朩
酵	西一土子
酶	西一𠂉母
酷	西一丿口
酸	西一厶夂
酹	西一爫寸
酺	西一甫󰁶
酻	西一爫子
酼	西一亠󰀸
酽	西一一丿
酾	西一一丶
酿	西一丶艮
醀	西一亻󰁷
醁	西一󰁭氺
醂	西一木木
醃	西一大乚
醄	西一勹凵
醅	西一立口
醆	西一戈戈
醇	西一󰁸子
醈	西一火火
醉	西一亠十
醊	西一又又
醋	西一󰁺日
醌	西一曰匕
醍	西一日󰁾
醎	西一戊口
醏	西一土日
醐	西一古月
醑	西一乛月
醒	西一曰
醓	西一冖皿
醔	禾火西一
醕	西一󰁸曰
醖	西一日皿
醗	西一癶儿
醘	西一土皿
醙	西一臼又
醚	西一米辶
醛	西一艹王
醜	西一白厶
醝	西一⺶工
醞	西一囗皿
醟	火火冖一
醠	西一ㄇ皿
醡	西一宀二
醢	西一皿
醣	西一广口
醤	丬爫寸一
醥	西一覀小
醦	西一厶彡
醧	西一匚口
醨	西一亠厶
醩	西一一日
醪	西一羽彡
醫	匚𠂉大一
醬	爿󰁝寸一
醭	西一业夫
醮	西一亻灬
醯	西一亠皿
醰	西一覀早
醱	西一癶又
醲	西一ㄇ󰀖
醳	西一罒十
醴	西一ㄇ䒑
醵	西一虍󰀓
醶	西一人人
醷	西一立心
醸	西一六󰀔
醹	西一󰀙〢
醺	西一丿灬
醻	西一士寸
醼	西一廿灬
醽	西一󰀙口
醾	西一广米
醿	西一广小
釀	西一亠󰀔
釁	󰀗ㄇ一刀
釂	西一爫寸
釃	西一一匕
釄	西一广三
釅	西一口攵
釆	丿米󰀦
采	爫木󰁧
釈	丿米尸󰂃
釉	丿米由󰀝
释	丿米又󰀟
釋	丿米罒十
里	曰土󰀌
重	丿一曰土
野	曰土󰁻亅
量	曰一曰土
釐	未攵厂土
金	金金金金
釒	釒丿丶一
釓	釒乚󰁀
釔	釒乙󰁀
釕	釒了󰀢
釖	釒刀󰁥
釗	釒刂󰀢
釘	釒丁󰀢
釙	釒卜󰁶
釚	釒九󰁀
釛	釒力󰁥
釜	八乂干䒑
針	釒十󰀢
釞	釒丿󰂃󰁶
釟	釒八󰁶
釠	釒几󰁀
釡	八金󰀘
釢	釒乃󰁥
釣	釒勹丶󰁶
釤	釒彡󰁥
釥	釒小󰁶
釦	釒口󰀝
釧	釒川󰀢
釨	釒子󰀝
釩	釒几丶󰁶
釪	釒一󰀛󰀢
釫	釒二ㄅ󰁀
釬	釒干󰀢
釭	釒工󰀝
釮	釒󰀛丿󰁥
釯	釒亠󰄃󰁀
釰	釒刀丶󰁶
釱	釒大󰁶
釲	釒巳󰁀
釳	釒𠂉乙󰁀
釴	釒󰀁丶󰁶
釵	釒又丶󰁶
釶	釒也󰁀
釷	釒土󰀝
釸	釒夕󰁶
釹	釒女󰀝
釺	釒丿十󰀢
釻	釒九丶󰁶
釼	釒刀󰂃󰁶
釽	釒⺁丨󰂃
釾	釒󰀄亅丿
釿	釒斤󰀢
鈀	釒巴󰁀
鈁	釒方󰁥
鈂	釒冖󰁜󰁀
鈃	釒一廾󰀢
鈄	釒󰁦十󰀢
鈅	釒月󰀝
鈆	釒八厶󰁶
鈇	釒夫󰁶
鈈	釒丆卜󰁶
鈉	釒冂人󰁶
鈊	釒心󰁶
鈋	釒亻ヒ󰁀
鈌	釒ユ人󰁶
鈍	釒一凵乚
鈎	釒勹厶󰁶
鈏	釒弓丨󰀢
鈐	釒人丶乛
鈑	釒⺁又󰁶
鈒	釒乃󰂃󰁶
鈓	釒丿士󰀝
鈔	釒小丿󰁥
鈕	釒󰁈丨一
鈖	釒八刀󰁥
鈗	釒厶儿󰁀
鈘	釒十又󰁶
鈙	釒󰀥又󰁶
鈚	釒󰁴匕󰁀
鈛	釒戈󰁶
鈜	釒厶󰁶
鈝	釒丿󰀟󰀢
鈞	釒勹冫󰀝
鈟	釒弓丨󰀢
鈠	釒几又󰁶
鈡	釒口丨󰀢
鈢	釒木󰁶
鈣	釒一󰀥ㄅ
鈤	釒日󰀝
鈥	釒火󰁶
鈦	釒大丶󰁶
鈧	釒亠几󰁀
鈨	釒二儿󰁀
鈩	釒丶尸󰁥
鈪	釒厂⺋󰁀
鈫	釒文󰁶
鈬	釒尸󰂃󰁶
鈭	止匕金󰀘
鈮	釒尸匕󰁀
鈯	釒凵山󰀢
鈰	釒亠冂丨
鈱	釒󰁂󰀁󰁀
鈲	釒⺁厶󰂃
鈳	釒丁口󰀝
鈴	釒人丶󰁻
鈵	釒一冂人
鈶	釒厶口󰀝
鈷	釒古󰀝
鈸	釒又丶
鈹	釒皮󰁶
鈺	釒王丶󰁶
鈻	釒󰃧󰀝
鈼	釒𠂉丨二
鈽	釒冂丨
鈾	釒由󰀝
鈿	釒田󰀝
鉀	釒甲󰀢
鉁	釒人彡󰁥
鉂	釒口乂󰁶
鉃	釒𠂉大󰁶
鉄	釒丿夫󰁶
鉅	釒匚󰁃󰀝
鉆	釒󰀥口󰀝
鉇	釒𠂉也󰁀
鉈	釒宀匕󰁀
鉉	釒亠幺󰁶
鉊	釒刀口󰀝
鉋	釒勹巳󰁀
鉌	釒禾󰁶
鉍	釒心丿󰁥
鉎	釒丿󰀝
鉏	釒󰀐一󰀝
鉐	釒石󰀝
鉑	釒白󰀝
鉒	釒丶王󰀝
鉓	釒𠂉冂丨
鉔	釒匚冂丨
鉕	釒匚口󰀝
鉖	釒夂󰁦󰁶
鉗	釒甘󰀝
鉘	釒弓󰀯󰀢
鉙	釒口八󰁶
鉚	釒󰁚丿卩
鉛	釒几口󰀝
鉜	釒亻寸󰁶
鉝	釒立󰀝
鉞	釒戈󰁐󰁀
鉟	釒丆卜一
鉠	釒ㄇ大󰁶
鉡	釒丷󰀟󰀢
鉢	釒木一󰀝
鉣	釒土厶󰁶
鉤	釒勹口󰀝
鉥	釒木丶󰁶
鉦	釒一止󰀝
鉧	釒母󰁶
鉨	釒⺈小󰁶
鉩	釒人小󰁶
鉪	釒廿󰄃󰁀
鉫	釒力口󰀝
鉬	釒目󰀝
鉭	釒日一󰀝
鉮	釒曰丨󰀢
鉯	釒󰁐丶人
鉰	釒𠃌一口
鉱	釒广厶󰁶
鉲	釒上卜󰁶
鉳	釒丬匕󰁀
鉴	〢𠂉丶金
鉵	釒虫󰁶
鉶	釒一廾刂
鉷	釒󰁺八󰁶
鉸	釒六乂󰁶
鉹	釒夕夕󰁶
鉺	釒耳󰀝
鉻	釒夂口󰀝
鉼	釒䒑廾󰀢
鉽	釒󰀁工丶
鉾	釒厶丿󰀟
鉿	釒人一口
銀	釒艮󰁶
銁	釒勹日󰀝
銂	釒丶丿丨
銃	釒亠厶儿
銄	釒丿冂口
銅	釒冂一口
銆	釒丆日󰀝
銇	釒二木󰁶
銈	釒土土󰀝
銉	釒󰁬󰀟󰀢
銊	釒戊一󰀝
銋	釒亻丿士
銌	釒丨子
銍	釒一厶土
銎	工几丶金
銏	釒󰀼󰀼一
銐	一夕刂金
銑	釒丿土儿
銒	釒一干
銓	釒人王󰀝
銔	釒丆卜十
銕	釒一弓人
銖	釒丿未󰁶
銗	釒⺁一口
銘	釒夕口󰀝
銙	釒大二ㄅ
銚	釒儿󰀪󰁶
銛	釒丿古󰀝
銜	彳釒一丁
銝	釒亻木󰁶
銞	勹曰金󰀘
銟	釒山冂丨
銠	釒土丿匕
銡	釒士口󰀝
銢	釒二水󰁶
銣	釒女口󰀝
銤	釒米󰁶
銥	釒亠󰀔󰁶
銦	釒囗大󰁶
銧	釒⺌一儿
銨	釒宀女󰀝
銩	釒丿土厶
銪	釒月󰀝
銫	釒⺈巴󰁀
銬	釒土丿ㄅ
銭	釒二戈󰁶
銮	亠󰁗金󰀘
銯	釒幺小󰁶
銰	釒艹乂󰁶
銱	釒口冂丨
銲	釒曰干󰀢
銳	釒八口儿
銴	扌斤金󰀘
銵	釒丿󰀽丿
銶	釒一氺丶
銷	釒⺌月󰀝
銸	釒耳乚󰁀
銹	釒禾乃󰁥
銺	爿士金󰀘
銻	釒丷弓丿
銼	釒人人土
銽	釒󰁚󰀁口
銾	釒工水󰁶
銿	釒󰁻用󰀢
鋀	釒一口䒑
鋁	釒口口󰀝
鋂	釒𠂉母󰁶
鋃	釒丶艮󰁶
鋄	釒一火又
鋅	釒辛󰀢
鋆	土勹冫金
鋇	釒貝󰁶
鋈	氵丿大金
鋉	釒木口󰀝
鋊	釒八人口
鋋	釒丿󰀥廴
鋌	釒丿士廴
鋍	釒十冖子
鋎	釒宀二儿
鋏	釒大人人
鋐	釒宀厶
鋑	釒厶八夂
鋒	釒夂三丨
鋓	釒禾刂󰀢
鋔	釒⺈口󰁜
鋕	釒士心󰁶
鋖	釒爫女󰀝
鋗	釒口月󰀝
鋘	釒口一大
鋙	釒五口󰀝
鋚	亻丨攵金
鋛	釒口口丨
鋜	釒口󰁾󰁶
鋝	釒爫寸󰁶
鋞	釒一巛工
鋟	釒彐冖又
鋠	釒厂二󰀖
鋡	釒人丶口
鋢	釒爫子󰀝
鋣	釒󰀄亅阝
鋤	釒󰀐󰀞力
鋥	釒口王󰀝
鋦	釒尸𠃌口
鋧	釒目儿󰁀
鋨	釒丿扌丶
鋩	釒艹亠󰄃
鋪	釒甫󰁶
鋫	禾刂金󰀘
鋬	扌⺁又金
鋭	釒丷口儿
鋮	釒戊𠃌󰁀
鋯	釒丿土口
鋰	釒曰土󰀝
鋱	釒󰀁心丶
鋲	釒丘八󰁶
鋳	釒三丿寸
鋴	釒古儿󰁀
鋵	釒禾几󰁀
鋶	釒亠厶󰀸
鋷	釒耳又󰁶
鋸	釒尸古󰀝
鋹	釒󰀍󰀖󰁶
鋺	釒宀夕⺋
鋻	匚丨󰁃金
鋼	釒冂䒑山
鋽	釒󰀥早󰀢
鋾	釒勹𠂉凵
鋿	釒⺌冂口
錀	釒人一艹
錁	釒曰木󰁶
錂	釒土八夂
錃	氵皮金󰀘
錄	釒彑氺󰁶
錅	禾勹丿金
錆	釒月󰀝
錇	釒立口󰀝
錈	釒丷夫⺋
錉	釒󰁚󰀁日
錊	釒亠人十
錋	釒月月󰀝
錌	釒山厂干
錍	釒白丿十
錎	釒⺈臼󰀝
錏	釒一󰀚一
錐	釒亻󰁷󰀝
錑	釒丶尸犬
錒	釒阝丁口
錓	釒⺶乚󰁀
錔	釒水日󰀝
錕	釒日󰁴匕
錖	上小又金
錗	釒禾女󰀝
錘	釒丿士󰁺
錙	釒巛田󰀝
錚	釒⺈󰁬亅
錛	釒大十廾
錜	釒人丶乛
錝	釒宀二小
錞	釒󰁸子󰀝
錟	釒火火󰁶
錠	釒宀一󰁾
錡	釒大丁口
錢	釒戈戈󰁶
錣	釒又又又
錤	釒󰀎八󰁶
錥	釒亠厶月
錦	釒白冂丨
錧	釒宀󰃧󰀝
錨	釒艹田󰀝
錩	釒日曰󰀝
錪	釒ㄇ󰁺八
錫	釒日勹󰁤
錬	釒木曰󰀝
錭	釒󰀼土口
錮	釒囗古󰀝
錯	釒󰁺日󰀝
錰	釒木灬󰁶
錱	金王王󰀘
録	釒󰁭氺󰁶
錳	釒子皿󰀝
錴	釒土八土
錵	釒艹亻ヒ
錶	釒󰀔󰁶
錷	釒車乚󰁀
錸	釒木人人
錹	釒止月󰀝
錺	釒艹方󰁥
錻	釒一󰀁丶
錼	釒大二小
錽	釒一火夂
錾	车斤金󰀘
錿	釒虍几󰁀
鍀	釒曰一寸
鍁	釒斤⺈人
鍂	釒金󰀝
鍃	釒勹󰁤心
鍄	釒󰁸小󰁶
鍅	釒氵土厶
鍆	釒門󰀝
鍇	釒󰁴匕白
鍈	釒艹ㄇ大
鍉	釒日一󰁾
鍊	釒木󰀹󰀝
鍋	釒ㄇ󰁈口
鍌	氵丿土金
鍍	釒广廿又
鍎	釒⺁十目
鍏	釒󰁆口㐄
鍐	釒乂凵夂
鍑	釒𠂉日夂
鍒	釒󰁻乛木
鍓	釒口耳󰀝
鍔	釒口口ㄅ
鍕	釒冖車󰀢
鍖	釒󰀎八󰄃
鍗	釒亠丷丨
鍘	釒貝刂󰀢
鍙	氵󰁺八金
鍚	釒日一󰁤
鍛	釒丿丨又
鍜	釒󰁃丨又
鍝	釒曰冂丶
鍞	釒󰀥貝󰁶
鍟	釒日丿
鍠	釒白王󰀝
鍡	釒田一󰀖
鍢	釒一口田
鍣	釒艹刀口
鍤	釒丿十臼
鍥	釒三丨大
鍦	釒方𠂉也
鍧	釒勹言󰀝
鍨	釒癶一大
鍩	釒艹口
鍪	󰁻乛亅金
鍫	禾火金󰀘
鍬	釒禾火󰁶
鍭	釒亻ユ大
鍮	釒人一刂
鍯	釒勹󰁤心
鍰	釒爫一又
鍱	釒廿󰄃木
鍲	釒󰁂󰀁日
鍳	匚丨󰁃金
鍴	釒山丆〢
鍵	釒󰁬󰀟廴
鍶	釒田心󰁶
鍷	釒大土土
鍸	釒古月󰀝
鍹	釒宀一一
鍺	釒土丿日
鍻	釒曰勹󰄃
鍼	釒戊一口
鍽	釒丶尸艹
鍾	釒丿一土
鍿	釒巛一田
鎀	釒亻丨彡
鎁	釒耳阝󰀢
鎂	釒丷王大
鎃	釒氵⺁󰀕
鎄	釒󰁸󰀔󰁶
鎅	釒田人󰀯
鎆	釒䒑月刂
鎇	釒󰁅目󰀝
鎈	釒⺶工󰀝
鎉	釒曰羽󰀝
鎊	釒亠丷方
鎋	釒宀三口
鎌	釒䒑󰁬八
鎍	釒十冖小
鎎	釒气米󰁶
鎏	氵亠厶金
鎐	釒爫𠂉凵
鎑	釒土厶皿
鎒	釒厂二寸
鎓	釒八厶羽
鎔	釒宀八口
鎕	釒广󰁬口
鎖	釒⺌貝󰁶
鎗	釒人丶口
鎘	釒一口丨
鎙	釒䒑凵月
鎚	釒丿󰃧辶
鎛	釒甫寸󰁶
鎜	丿󰁪几金
鎝	釒艹人口
鎞	釒丿囗匕
鎟	釒又又木
鎠	釒罒一止
鎡	釒䒑幺幺
鎢	釒󰁞灬󰁶
鎣	火火冖金
鎤	釒曰⺌儿
鎥	亻丨夂金
鎦	釒󰁚丶田
鎧	釒山一䒑
鎨	釒亻󰁷十
鎩	釒乂朩又
鎪	釒臼丨又
鎫	釒丿ㄇ夂
鎬	釒󰁸冂口
鎭	釒匕目八
鎮	釒十󰀣八
鎯	釒丶󰁮阝
鎰	釒䒑八皿
鎱	釒土口󰀔
鎲	釒⺌冖儿
鎳	釒丿目木
鎴	釒丿目心
鎵	釒宀一󰀓
鎶	釒丁口口
鎷	釒󰀋灬󰁶
鎸	釒亻󰁷乃
鎹	釒䒑大辶
鎺	釒礻󰁶一
鎻	釒巛貝󰁶
鎼	釒虍手󰀢
鎽	釒山夂丨
鎾	釒曰皿󰀝
鎿	釒人一手
鏀	釒󰀥囗󰁘
鏁	釒巛曰木
鏂	釒匚口口
鏃	釒方𠂉大
鏄	釒一曰寸
鏅	釒亻丨月
鏆	釒毌貝󰁶
鏇	釒方𠂉󰁾
鏈	釒車辶󰁶
鏉	釒木口人
鏊	󰁡攵金
鏋	釒廿冂丶
鏌	釒艹曰大
鏍	釒田幺小
鏎	釒曰艹󰀟
鏏	釒三丨彐
鏐	釒羽人彡
鏑	釒亠丷古
鏒	釒厶厶彡
鏓	釒丿囗心
鏔	釒宀一八
鏕	釒󰁙󰁴匕
鏖	󰁙󰁴匕金
鏗	釒匚丨土
鏘	釒爿󰁝寸
鏙	釒山亻󰁷
鏚	釒戊上小
鏛	釒⺌冖丨
鏜	釒⺌冖土
鏝	釒曰罒又
鏞	釒广󰁬丨
鏟	釒立丿
鏠	釒夂三辶
鏡	釒立曰儿
鏢	釒覀二小
鏣	釒广廿灬
鏤	釒󰀻女󰀝
鏥	釒宀亻日
鏦	釒彳人󰁾
鏧	士󰁅几金
鏨	車斤金󰀘
鏩	釒車斤󰀢
鏪	釒一ㄇ日
鏫	釒禾刂木
鏬	釒虍丿󰀛
鏭	釒丿米心
鏮	釒广󰁬氺
鏯	釒大乂乂
鏰	釒山月月
鏱	釒立早󰀢
鏲	釒亠幺󰀟
鏳	釒丷󰀺日
鏴	釒口止口
鏵	釒艹一󰀟
鏶	釒亻󰁷木
鏷	釒业䒑夫
鏸	釒一曰心
鏹	釒弓口虫
鏺	釒癶弓又
鏻	釒米夕㐄
鏼	釒⺮木冂
鏽	釒󰁬十󰀲
鏾	釒󰁺月攵
鏿	釒⺌冖木
鐀	釒口丨貝
鐁	釒󰀎八斤
鐂	釒一〢田
鐃	釒土土儿
鐄	釒󰁺由八
鐅	㡀攵金󰀘
鐆	阝䒑󰀓金
鐇	釒丿米田
鐈	釒丿大口
鐉	釒巳巳八
鐊	釒阝日󰁤
鐋	釒氵日󰁤
鐌	釒⺈口󰀓
鐍	釒󰁻乛口
鐎	釒亻󰁷灬
鐏	釒丷西寸
鐐	釒大丷小
鐑	釒糹士口
鐒	釒火火力
鐓	釒󰁸孑攵
鐔	釒覀早󰀢
鐕	釒󰀄󰁜日
鐖	釒幺幺人
鐗	釒門月󰀝
鐘	釒立曰土
鐙	釒癶一䒑
鐚	釒一󰀚心
鐛	釒曰󰁸小
鐜	󰁸孑攵金
鐝	釒厂䒑人
鐞	釒彐工寸
鐟	釒夫夫日
鐠	釒䒑业日
鐡	釒十戈䒑
鐢	木乂乂金
鐣	釒⺌冖手
鐤	釒目󰁕󰁈
鐥	釒羊䒑口
鐦	釒門一廾
鐧	釒門日󰀝
鐨	釒弓󰀯貝
鐩	釒䒑󰀓辶
鐪	釒虍田力
鐫	釒亻󰁷𠃌
鐬	釒止戊󰀤
鐭	釒丿ㄇ大
鐮	釒广䒑八
鐯	釒艹土日
鐰	釒口口木
鐱	釒人一人
鐲	釒罒勹虫
鐳	釒󰀙田󰀝
鐴	釒尸口辛
鐵	釒十戈王
鐶	釒罒一󰀔
鐷	釒艹廿木
鐸	釒罒土十
鐹	釒ㄇ󰁈辶
鐺	釒⺌冖田
鐻	釒虍一󰀓
鐼	釒十艹貝
鐽	釒土羊辶
鐾	尸口辛金
鐿	釒立曰心
鑀	釒爫冖夂
鑁	釒󰁘凵夂
鑂	釒丿一灬
鑃	釒羽亻󰁷
鑄	釒士乛寸
鑅	釒火火木
鑆	釒业丷寸
鑇	釒󰀴󰀳󰀝
鑈	釒一八乂
鑉	釒艹土皿
鑊	釒艹亻又
鑋	車一巛金
鑌	釒宀一貝
鑍	貝貝金󰀘
鑎	釒匚口貝
鑏	釒宀心丁
鑐	釒󰀙丆〢
鑑	釒匚丨皿
鑒	匚丨󰁃金
鑓	釒口丨辶
鑔	釒宀󰁯小
鑕	釒斤斤貝
鑖	釒艹罒人
鑗	釒禾勹氺
鑘	釒田田田
鑙	釒禾日
鑚	釒夫夫貝
鑛	釒广󰁺八
鑜	釒⺌冖貝
鑝	釒艹夂辶
鑞	釒巛囗󰁒
鑟	釒士罒貝
鑠	釒白幺木
鑡	釒止󰀆󰀢
鑢	釒虍田心
鑣	釒󰁙󰁴灬
鑤	釒曰󰁺氺
鑥	釒󰁢灬日
鑦	釒匚丨貝
鑧	釒宀艹丶
鑨	釒立月三
鑩	釒王口口
鑪	釒虍田皿
鑫	金釒金󰀘
鑬	釒匚丨儿
鑭	釒門木󰀹
鑮	釒艹氵寸
鑯	釒人人󰀞
鑰	釒人一艹
鑱	釒⺈口丶
鑲	釒亠口󰀔
鑳	釒宀󰀀󰁾
鑴	釒山亻口
鑵	釒艹口󰁷
鑶	釒艹戈丨
鑷	釒耳耳耳
鑸	釒田田土
鑹	釒宀八󰁒
鑺	釒目目󰁷
鑻	釒木乂乂
鑼	釒罒糹󰁷
鑽	釒丿土貝
鑾	言糹糹金
鑿	业䒑十金
钀	釒虍一犬
钁	釒目目又
钂	釒⺌冖灬
钃	釒尸氺虫
钄	釒艹門󰀹
钅	钅丿一󰁐
钆	钅乚󰁀
钇	钅乙󰁀
针	钅十󰀢
钉	钅丁󰀢
钊	钅刂󰀢
钋	钅卜󰁶
钌	钅了󰀢
钍	钅土󰀝
钎	钅丿十󰀢
钏	钅川󰀢
钐	钅彡󰁥
钑	钅乃󰂃󰁶
钒	钅几丶󰁶
钓	钅勹丶󰁶
钔	钅门󰁀
钕	钅女󰀝
钖	钅ㄋ󰁤󰁥
钗	钅又丶󰁶
钘	钅一廾󰀢
钙	钅一󰀥ㄅ
钚	钅丆卜󰁶
钛	钅大丶󰁶
钜	钅匚󰁃󰀝
钝	钅一凵乚
钞	钅小丿󰁥
钟	钅口丨󰀢
钠	钅冂人󰁶
钡	钅贝󰁶
钢	钅冂乂󰁶
钣	钅⺁又󰁶
钤	钅人丶乛
钥	钅月󰀝
钦	钅⺈人󰁶
钧	钅勹冫󰀝
钨	钅丿𠃌一
钩	钅勹厶󰁶
钪	钅亠几󰁀
钫	钅方󰁥
钬	钅火󰁶
钭	钅󰁦十󰀢
钮	钅󰁈丨一
钯	钅巴󰁀
钰	钅王丶󰁶
钱	钅一戈󰁶
钲	钅一止󰀝
钳	钅甘󰀝
钴	钅古󰀝
钵	钅木一󰀝
钶	钅丁口󰀝
钷	钅匚口󰀝
钸	钅冂丨
钹	钅又丶
钺	钅戈󰁐󰁀
钻	钅󰀥口󰀝
钼	钅目󰀝
钽	钅日一󰀝
钾	钅甲󰀢
钿	钅田󰀝
铀	钅由󰀝
铁	钅丿夫󰁶
铂	钅白󰀝
铃	钅人丶󰁻
铄	钅丿󰄃小
铅	钅几口󰀝
铆	钅󰁚丿卩
铇	钅勹巳󰁀
铈	钅亠冂丨
铉	钅亠幺󰁶
铊	钅宀匕󰁀
铋	钅心丿󰁥
铌	钅尸匕󰁀
铍	钅皮󰁶
铎	钅又󰀟󰀢
铏	钅一廾刂
铐	钅土丿ㄅ
铑	钅土丿匕
铒	钅耳󰀝
铓	钅艹亠󰄃
铔	钅一业󰀝
铕	钅月󰀝
铖	钅戊𠃌󰁀
铗	钅一丷大
铘	钅󰀄亅阝
铙	钅󰀁丿儿
铚	钅一厶土
铛	钅⺌彐󰀝
铜	钅冂一口
铝	钅口口󰀝
铞	钅口冂丨
铟	钅囗大󰁶
铠	钅山己󰁀
铡	钅贝刂󰀢
铢	钅丿未󰁶
铣	钅丿土儿
铤	钅丿士廴
铥	钅丿土厶
铦	钅丿古󰀝
铧	钅亻ヒ十
铨	钅人王󰀝
铩	钅乂朩󰁶
铪	钅人一口
铫	钅儿󰀪󰁶
铬	钅夂口󰀝
铭	钅夕口󰀝
铮	钅⺈󰁬亅
铯	钅⺈巴󰁀
铰	钅六乂󰁶
铱	钅亠󰀔󰁶
铲	钅立丿󰁥
铳	钅亠厶儿
铴	钅氵ㄋ󰁤
铵	钅宀女󰀝
银	钅艮󰁶
铷	钅女口󰀝
铸	钅三丿寸
铹	钅艹冖力
铺	钅甫󰁶
铻	钅五口󰀝
铼	钅一丷木
铽	钅󰀁心丶
链	钅车辶󰁶
铿	钅〢又土
销	钅⺌月󰀝
锁	钅⺌贝󰁶
锂	钅曰土󰀝
锃	钅口王󰀝
锄	钅󰀐󰀞力
锅	钅口冂人
锆	钅丿土口
锇	钅丿扌丶
锈	钅禾乃󰁥
锉	钅人人土
锊	钅爫寸󰁶
锋	钅夂三丨
锌	钅辛󰀢
锍	钅亠厶󰀸
锎	钅门一廾
锏	钅门日󰀝
锐	钅丷口儿
锑	钅丷弓丿
锒	钅丶艮󰁶
锓	钅彐冖又
锔	钅尸𠃌口
锕	钅阝丁口
锖	钅月󰀝
锗	钅土丿日
锘	钅艹口
错	钅󰁺日󰀝
锚	钅艹田󰀝
锛	钅大十廾
锜	钅大丁口
锝	钅曰一寸
锞	钅曰木󰁶
锟	钅曰󰁴匕
锠	钅日曰󰀝
锡	钅曰勹󰁤
锢	钅囗古󰀝
锣	钅罒夕󰁶
锤	钅丿士󰁺
锥	钅亻󰁷󰀝
锦	钅白冂丨
锧	钅⺁十贝
锨	钅斤⺈人
锩	钅丷夫⺋
锪	钅勹󰁤心
锫	钅立口󰀝
锬	钅火火󰁶
锭	钅宀一󰁾
键	钅󰁬󰀟廴
锯	钅尸古󰀝
锰	钅子皿󰀝
锱	钅巛田󰀝
锲	钅三丨大
锳	钅艹ㄇ大
锴	钅󰁴匕白
锵	钅丬夕寸
锶	钅田心󰁶
锷	钅口口ㄅ
锸	钅丿十臼
锹	钅禾火󰁶
锺	钅丿一土
锻	钅丿丨又
锼	钅臼丨又
锽	钅白王󰀝
锾	钅爫一又
锿	钅󰁸󰀔󰁶
镀	钅广廿又
镁	钅丷王大
镂	钅米女󰀝
镃	钅䒑幺幺
镄	钅弓󰀯贝
镅	钅󰁅目󰀝
镆	钅艹曰大
镇	钅十󰀣八
镈	钅甫寸󰁶
镉	钅一口丨
镊	钅耳又又
镋	钅⺌冖儿
镌	钅亻󰁷乃
镍	钅丿目木
镎	钅人一手
镏	钅󰁚丶田
镐	钅󰁸冂口
镑	钅亠丷方
镒	钅䒑八皿
镓	钅宀一󰀓
镔	钅宀丘八
镕	钅宀八口
镖	钅覀二小
镗	钅⺌冖土
镘	钅曰罒又
镙	钅田幺小
镚	钅山月月
镛	钅广󰁬丨
镜	钅立曰儿
镝	钅亠丷古
镞	钅方𠂉大
镟	钅方𠂉󰁾
镠	钅羽人彡
镡	钅覀早󰀢
镢	钅厂䒑人
镣	钅大丷小
镤	钅业䒑夫
镥	钅󰁢一日
镦	钅󰁸孑攵
镧	钅门木󰀹
镨	钅䒑业日
镩	钅宀八丨
镪	钅弓口虫
镫	钅癶一䒑
镬	钅艹亻又
镭	钅󰀙田󰀝
镮	钅罒一󰀔
镯	钅罒勹虫
镰	钅广䒑八
镱	钅立曰心
镲	钅宀󰁯小
镳	钅󰁙󰁴灬
镴	钅巛囗󰁒
镵	钅⺈口丶
镶	钅亠口󰀔
長	󰀍󰀖󰁧
镸	󰂞一丨丶
镹	󰂞ク󰂃󰁶
镺	󰂞丿大󰁶
镻	󰂞丿夫󰁶
镼	󰂞尸凵山
镽	󰂞大丷小
镾	󰂞一八乂
长	丿七󰂃󰀦
門	門丨󰁈一
閁	門丿󰀏
閂	門一󰀌
閃	門人󰀦
閄	門人󰁶
閅	門丁󰀵
閆	門三󰀌
閇	門一卜󰀦
閈	門干󰀵
閉	門󰀛丿󰀏
閊	門山󰀵
開	門一廾󰀵
閌	門亠几󰁫
閍	門方󰀏
閎	門厶󰀦
閏	門王󰀌
閐	門毛󰁫
閑	門木󰀦
閒	門月󰀌
間	門日󰀌
閔	門文󰀦
閕	門󰀄亅丿
閖	門水󰀦
閗	門󰁦十󰀵
閘	門甲󰀵
閙	門亠冂丨
閚	門立󰀌
閛	門一丷十
閜	門丁口󰀌
閝	門人丶󰁻
閞	門厶廾󰀵
閟	門心丿󰀏
閠	門王丶󰀦
閡	門亠ㄥ人
関	門䒑大󰀦
閣	門夂口󰀌
閤	門人一口
閥	門亻戈󰀦
閦	門人人人
閧	門󰁺八󰀦
閨	門土土󰀌
閩	門虫󰀦
閪	門西󰀌
閫	門囗木󰀦
閬	門丶艮󰀦
閭	門口口󰀌
閮	門丿士廴
閯	門氵小丿
閰	門臼󰀌
閱	門八口儿
閲	門丷口儿
閳	門車󰀵
閴	門貝󰀦
閵	門亻󰁷󰀌
閶	門日曰󰀌
閷	乂朩門人
閸	門一󰀚一
閹	門大曰乚
閺	門曰文󰀦
閻	門⺈臼󰀌
閼	門方人󰁦
閽	門󰁚󰀁日
閾	門戈口󰀞
閿	門爫冖又
闀	門󰁺八巳
闁	門門󰀌
闂	門丷夫⺋
闃	門目犬󰀦
闄	門覀女󰀌
闅	門目󰀥又
闆	門口口口
闇	門立日󰀌
闈	門󰁆口㐄
闉	門覀土󰀌
闊	門氵丿古
闋	門癶一大
闌	門木󰀹󰀌
闍	門土丿日
闎	門白水󰀦
闏	門几丿虫
闐	門十󰀣八
闑	門丿目木
闒	門曰羽󰀌
闓	門山一䒑
闔	門土厶皿
闕	門䒑凵人
闖	門󰀋灬󰀦
闗	門幺幺灬
闘	門一口寸
闙	門丶尸攵
闚	門夫目儿
闛	門⺌冖土
關	門幺幺一
闝	門貝攵󰀦
闞	門乛耳攵
闟	門人一羽
闠	門口丨貝
闡	門口口十
闢	門尸口辛
闣	門⺌冖田
闤	門罒一󰀔
闥	門土羊辶
闦	門ㄇ󰁺䒑
闧	門土口辶
门	门丶丨𠃌
闩	门一󰀌
闪	门人󰀦
闫	门三󰀌
闬	门干󰀵
闭	门󰀛丿󰀏
问	门口󰀌
闯	门󰀊一󰀌
闰	门王󰀌
闱	门二𠃌丨
闲	门木󰀦
闳	门厶󰀦
间	门日󰀌
闵	门文󰀦
闶	门亠几󰁫
闷	门心󰀦
闸	门甲󰀵
闹	门亠冂丨
闺	门土土󰀌
闻	门耳󰀌
闼	门大辶󰀦
闽	门虫󰀦
闾	门口口󰀌
闿	门山己󰁫
阀	门亻戈󰀦
阁	门夂口󰀌
阂	门亠ㄥ人
阃	门囗木󰀦
阄	门⺈曰乚
阅	门丷口儿
阆	门丶艮󰀦
阇	门土丿日
阈	门戈口󰀞
阉	门大曰乚
阊	门曰曰󰀌
阋	门臼儿󰁫
阌	门爫冖又
阍	门󰁚󰀁日
阎	门⺈臼󰀌
阏	门方人󰁦
阐	门丷曰十
阑	门木󰀹󰀌
阒	门目犬󰀦
阓	门口丨贝
阔	门氵丿古
阕	门癶一大
阖	门土厶皿
阗	门十󰀣八
阘	门曰羽󰀌
阙	门䒑凵人
阚	门乛耳攵
阛	门罒一󰀔
阜	丿󰃧十󰀬
阝	阝󰁋丨
阞	阝力󰁥
队	阝人󰁶
阠	阝⺄十󰀢
阡	阝丿十󰀢
阢	阝一儿󰁀
阣	阝𠂉乙󰁀
阤	阝也󰁀
阥	阝水󰁶
阦	阝火󰁶
阧	阝󰁦十󰀢
阨	阝厂⺋󰁀
阩	阝丿廾󰀢
阪	阝⺁又󰁶
阫	阝丆卜󰁶
阬	阝亠几󰁀
阭	阝厶儿󰁀
阮	阝二儿󰁀
阯	阝止󰀝
阰	阝󰁴匕󰁀
阱	阝二󰀯󰀢
防	阝方󰁥
阳	阝日󰀝
阴	阝月󰀝
阵	阝车󰀢
阶	阝人󰀯󰀢
阷	阝一止󰀝
阸	阝丶尸乙
阹	阝土厶󰁶
阺	阝󰁚󰀁丶
阻	阝󰀐一󰀝
阼	阝𠂉丨二
阽	阝󰀥口󰀝
阾	阝人丶󰁻
阿	阝丁口󰀝
陀	阝宀匕󰁀
陁	阝𠂉也󰁀
陂	阝皮󰁶
陃	阝一冂人
附	阝亻寸󰁶
际	阝二小󰁶
陆	阝󰀟凵󰀢
陇	阝ヒ丶
陈	阝󰀂小󰁶
陉	阝ス工󰀝
陊	阝夕夕󰁶
陋	阝一冂󰄃
陌	阝丆日󰀝
降	阝夂㐄󰀢
陎	阝丿未󰁶
陏	阝月󰀝
限	阝艮󰁶
陑	阝丆冂〢
陒	阝⺈厂⺋
陓	阝大二ㄅ
陔	阝亠ㄥ人
陕	阝一丷大
陖	阝厶八夂
陗	阝⺌月󰀝
陘	阝一巛工
陙	阝厂二󰀖
陚	阝一󰀁丶
陛	阝󰁴匕土
陜	阝大人人
陝	阝大丿丶
陞	阝丿廾土
陟	阝止󰀤󰁥
陠	阝甫󰁶
陡	阝土󰁾󰁶
院	阝宀二儿
陣	阝車󰀢
除	阝人一朩
陥	阝⺈丨日
陦	阝三丿寸
陧	阝曰土󰀝
陨	阝口贝󰁶
险	阝人一一
陪	阝立口󰀝
陫	阝丨三三
陬	阝耳又󰁶
陭	阝大丁口
陮	阝亻󰁷󰀝
陯	阝人一艹
陰	阝人丶厶
陱	阝勹米󰁶
陲	阝丿士󰁺
陳	阝木曰󰀝
陴	阝白丿十
陵	阝土八夂
陶	阝勹𠂉凵
陷	阝⺈臼󰀝
陸	阝土八土
陹	阝丿廾日
険	阝人一人
陻	阝覀土󰀝
陼	阝土丿日
陽	阝日一󰁤
陾	阝丆冂大
陿	阝匚大人
隀	阝丿一土
隁	阝匚日女
隂	阝人󰂞󰁶
隃	阝人一刂
隄	阝日一󰁾
隅	阝曰冂丶
隆	阝夂一
隇	阝戊一女
隈	阝田一󰀖
隉	阝臼工󰀝
隊	阝䒑󰀓󰁶
隋	阝工月
隌	阝立日󰀝
隍	阝白王󰀝
階	阝󰁴匕白
随	阝月辶
隐	阝⺈彐心
隑	阝山一䒑
隒	阝䒑󰁬八
隓	阝工工
隔	阝一口丨
隕	阝口貝󰁶
隖	阝󰁞灬󰁶
隗	阝白󰁜厶
隘	阝䒑八皿
隙	阝小曰小
隚	阝⺌冖土
際	阝󰁯二小
障	阝立早󰀢
隝	阝󰁟灬󰁶
隞	阝󰁡攵
隟	阝巛曰木
隠	阝爫彐心
隡	阝立丿
隢	阝土土儿
隣	阝米夕㐄
隤	阝口丨貝
隥	阝癶一䒑
隦	阝尸口辛
隧	阝䒑󰀓辶
隨	阝工辶
隩	阝丿ㄇ大
險	阝人一人
隫	阝十艹貝
隬	阝一八乂
隭	阝󰀙丆〢
隮	阝󰀴󰀳󰀝
隯	阝士乛寸
隰	阝曰幺灬
隱	阝爫工心
隲	阝小丿灬
隳	阝工⺗
隴	阝立月三
隵	阝虍一戈
隶	󰁬氺󰀦
隷	士二小氺
隸	木二小氺
隹	亻󰁷󰀝
隺	冖亻󰁷󰀌
隻	亻󰁷又󰁧
隼	亻󰁷十󰀬
隽	亻󰁷乃󰁣
难	又亻󰁷󰀝
隿	󰀁丶亻󰁷
雀	小亻󰁷󰀘
雁	厂亻亻󰁷
雂	人丶乛󰁷
雃	一廾亻󰁷
雄	厶亻󰁷
雅	󰀄亅丿󰁷
集	亻󰁷木󰁧
雇	丶尸亻󰁷
雈	丨一󰀥󰁷
雉	𠂉大亻󰁷
雊	勹口亻󰁷
雋	亻󰁷丨𠃌
雌	止󰁴亻󰁷
雍	亠󰁲丿󰁷
雎	󰀐󰀞亻󰁷
雏	⺈彐亻󰁷
雐	虍亻󰁷󰀌
雑	九朩亻󰁷
雒	夂口亻󰁷
雓	人一朩󰁷
雔	亻󰁷亻󰁷
雕	󰀼土口󰁷
雖	口虫亻󰁷
雗	十早人󰁷
雘	冂亠艹又
雙	亻󰁷亻又
雚	艹口口󰁷
雛	勹凵丿󰁷
雜	亠人人󰁷
雝	巛口巴󰁷
雞	爫幺大󰁷
雟	凵丿亻口
雠	亻󰁷讠󰁷
雡	羽人彡󰁷
離	亠乂凵󰁷
難	廿口夫󰁷
雤	󰀗乂乂󰁷
雥	亻󰁷亻󰁷
雦	亻󰁷亻󰁷
雧	亻󰁷亻木
雨	雨一丨丶
雩	󰀙二ㄅ󰀅
雪	󰀙彐󰀘
雫	󰀙一卜󰁧
雬	󰀙木󰁧
雭	󰀙乃󰂃󰁧
雮	󰀙毛󰀅
雯	󰀙文󰁧
雰	󰀙八刀󰁣
雱	󰀙方󰁣
雲	󰀙二厶󰁧
雳	󰀙厂力󰁣
雴	󰀙立󰀘
雵	󰀙ㄇ大󰁧
零	󰀙人丶󰁻
雷	󰀙田󰀘
雸	󰀙甘󰀘
雹	󰀙勹巳󰀅
雺	󰀙󰁻乛丿
電	󰀙曰乚󰀅
雼	󰀙石󰀘
雽	󰀙丿丷󰀛
雾	󰀙夂力󰁣
雿	󰀙儿󰀪󰁧
需	󰀙丆冂〢
霁	󰀙文󰀯󰀬
霂	󰀙氵木󰁧
霃	󰀙氵冖󰁜
霄	󰀙⺌月󰀘
霅	󰀙言󰀘
霆	󰀙丿士廴
震	󰀙厂二󰀖
霈	󰀙氵一丨
霉	󰀙𠂉母󰁧
霊	󰀙二业󰀘
霋	󰀙一󰁬女
霌	󰀙󰀼土口
霍	󰀙亻󰁷󰀘
霎	󰀙立女󰀘
霏	󰀙丨三三
霐	󰀙氵弓厶
霑	󰀙氵󰀥口
霒	󰀙二厶乛
霓	󰀙臼儿󰀅
霔	󰀙氵丶王
霕	󰀙二厶乚
霖	󰀙木木󰁧
霗	󰀙氵人󰁻
霘	󰀙氵冂口
霙	󰀙艹ㄇ大
霚	󰀙󰁻乛攵
霛	󰀙弓弓弓
霜	󰀙木目󰀘
霝	󰀙口口口
霞	󰀙󰁃丨又
霟	󰀙氵󰁺八
霠	󰀙立人乛
霡	󰀙月丶󰀩
霢	󰀙月⺁󰀕
霣	󰀙口貝󰁧
霤	󰀙󰁚丶田
霥	󰀙冖二󰀓
霦	󰀙木木彡
霧	󰀙󰁻乛力
霨	󰀙尸二寸
霩	󰀙󰁸孑阝
霪	󰀙氵爫士
霫	󰀙羽白󰀘
霬	󰀙田󰁺八
霭	󰀙讠曰󰄃
霮	󰀙氵󰀎󰄃
霯	󰀙癶一䒑
霰	󰀙󰁺月攵
霱	󰀙󰁻乛口
露	󰀙口止口
霳	󰀙阝夂一
霴	󰀙二厶氺
霵	󰀙口耳丶
霶	󰀙氵亠方
霷	󰀙日曰󰁤
霸	󰀙廿󰀜月
霹	󰀙尸口辛
霺	󰀙彳山攵
霻	󰀙ㄇ󰁺䒑
霼	󰀙二厶米
霽	󰀙󰀴󰀳󰀘
霾	󰀙豸曰土
霿	󰀙󰁻乛目
靀	󰀙艹冖󰀓
靁	󰀙田田田
靂	󰀙厂禾止
靃	󰀙亻󰁷󰁷
靄	󰀙言日󰄃
靅	󰀙二厶貝
靆	󰀙二厶辶
靇	󰀙立月三
靈	󰀙口口人
靉	󰀙二厶夂
靊	󰀙山三䒑
靋	󰀙氵厂止
靌	󰀙宀王貝
靍	󰀙亻󰁷灬
靎	󰀙釒󰁟灬
靏	󰀙冖亻灬
靐	󰀙田󰀙田
靑	冂丨一
青	月󰀘
靓	月ㄇ󰁜
靔	月气󰁀
靕	一止月
靖	立月󰀝
靗	月⺌儿
靘	月⺈巴
静	月⺈亅
靚	月目儿
靛	月宀󰁾
靜	月爫亅
靝	月气米
非	丨三丨三
靟	丨三丨毛
靠	丿土口三
靡	广木木三
面	丆囗〢二
靣	丆囗口󰀘
靤	丆囗〢巳
靥	厂犬丆二
靦	丆囗〢儿
靧	丆囗〢貝
靨	厂曰月二
革	廿󰀜󰀬
靪	廿󰀜丁󰀢
靫	廿󰀜又丶
靬	廿󰀜干󰀢
靭	廿󰀜刀丶
靮	廿󰀜勹丶
靯	廿󰀜土󰀝
靰	廿󰀜一儿
靱	廿󰀜刀󰂃
靲	廿󰀜人乛
靳	廿󰀜斤󰀢
靴	廿󰀜亻ヒ
靵	廿󰀜󰁈一
靶	廿󰀜巴󰁀
靷	廿󰀜弓丨
靸	廿󰀜乃󰂃
靹	廿󰀜冂人
靺	廿󰀜一木
靻	廿󰀜󰀐一
靼	廿󰀜曰一
靽	廿󰀜丷󰀟
靾	廿󰀜廿󰄃
靿	廿󰀜幺力
鞀	廿󰀜刀口
鞁	廿󰀜皮󰁶
鞂	廿󰀜禾󰁶
鞃	廿󰀜弓厶
鞄	廿󰀜勹巳
鞅	廿󰀜ㄇ大
鞆	廿󰀜一人
鞇	廿󰀜囗大
鞈	廿󰀜人口
鞉	廿󰀜儿󰀪
鞊	廿󰀜士口
鞋	廿󰀜土土
鞌	宀女廿󰀜
鞍	廿󰀜宀女
鞎	廿󰀜艮󰁶
鞏	工几丶󰀜
鞐	廿󰀜上卜
鞑	廿󰀜大辶
鞒	廿󰀜丿󰀯
鞓	廿󰀜口王
鞔	廿󰀜⺈󰁜
鞕	廿󰀜一乂
鞖	廿󰀜爫女
鞗	亻丨夂󰀜
鞘	廿󰀜⺌月
鞙	廿󰀜口月
鞚	廿󰀜宀工
鞛	廿󰀜立口
鞜	廿󰀜水日
鞝	廿󰀜⺌口
鞞	廿󰀜白十
鞟	廿󰀜󰁸子
鞠	廿󰀜勹米
鞡	廿󰀜扌立
鞢	廿󰀜廿木
鞣	廿󰀜󰁻木
鞤	土土寸󰀜
鞥	廿󰀜人廾
鞦	廿󰀜禾火
鞧	廿󰀜丷一
鞨	廿󰀜日󰄃
鞩	廿󰀜⺌刂
鞪	󰁻乛亅󰀜
鞫	廿󰀜勹言
鞬	廿󰀜󰁬廴
鞭	廿󰀜亻乂
鞮	廿󰀜日󰁾
鞯	廿󰀜艹子
鞰	廿󰀜曰皿
鞱	廿󰀜爫臼
鞲	廿󰀜󰀀土
鞳	廿󰀜艹口
鞴	廿󰀜󰁺用
鞵	廿󰀜爫大
鞶	丿󰁪几󰀜
鞷	一口冂󰀜
鞸	廿󰀜曰󰀟
鞹	廿󰀜亠阝
鞺	廿󰀜⺌土
鞻	廿󰀜󰀻女
鞼	廿󰀜口貝
鞽	廿󰀜丿口
鞾	廿󰀜艹一
鞿	廿󰀜幺人
韀	廿󰀜󰁙灬
韁	廿󰀜一一
韂	廿󰀜⺈言
韃	廿󰀜士辶
韄	廿󰀜艹又
韅	廿󰀜曰灬
韆	廿󰀜覀辶
韇	廿󰀜士貝
韈	廿󰀜艹人
韉	廿󰀜艹灬
韊	廿󰀜艹󰀹
韋	󰁆口㐄󰀬
韌	󰁆口㐄丶
韍	󰁆口㐄丶
韎	󰁆口㐄木
韏	丷夫󰁆㐄
韐	󰁆口㐄口
韑	⺌一儿㐄
韒	󰁆口㐄月
韓	十早󰁆㐄
韔	󰁆口㐄󰀖
韕	󰁆口㐄子
韖	󰁆口㐄木
韗	󰁆口㐄車
韘	󰁆口㐄木
韙	日一󰁾㐄
韚	󰁆口㐄󰀜
韛	󰁆口㐄用
韜	󰁆口㐄臼
韝	󰁆口㐄土
韞	󰁆口㐄皿
韟	󰁆口㐄十
韠	󰁆口㐄󰀟
韡	󰁆口㐄󰀟
韢	󰁆口㐄心
韣	󰁆口㐄虫
韤	󰁆口㐄人
韥	󰁆口㐄貝
韦	二𠃌丨󰀵
韧	二𠃌丨丶
韨	二𠃌丨丶
韩	十早二丨
韪	日一󰁾丨
韫	二𠃌丨皿
韬	二𠃌丨臼
韭	丨三丨一
韮	艹丨三一
韯	十戈丨󰀞
韰	󰀥夕又一
韱	人人戈󰀞
韲	󰀴丨三一
音	立日󰀘
韴	立日一丨
韵	立日勹冫
韶	立日刀口
韷	立日凵山
韸	立日夂丨
韹	立日白王
韺	立日艹大
韻	立日口貝
韼	立日夂辶
韽	人丶乛日
韾	士󰁅几日
響	󰁲丿丶日
頀	立日艹又
頁	丆貝󰁧
頂	丁丆貝󰁶
頃	󰁴丆貝󰁶
頄	九丆貝󰁶
項	工丆貝󰁶
順	川丆貝󰁶
頇	干丆貝󰁶
須	彡丆貝󰁶
頉	止丆貝󰁶
頊	王丆貝󰁶
頋	厂⺋丆貝
頌	八厶丆貝
頍	十又丆貝
頎	斤丆貝󰁶
頏	亠几丆貝
預	󰁻乛亅貝
頑	二儿丆貝
頒	八刀丆貝
頓	一凵󰁐貝
頔	由丆貝󰁶
頕	󰀥口丆貝
頖	丷󰀠丆貝
頗	皮丆貝󰁶
領	人丶󰁻貝
頙	一止丆貝
頚	又土丆貝
頛	二木丆貝
頜	人一口貝
頝	六乂丆貝
頞	宀女丆貝
頟	夂口丆貝
頠	⺈厂⺋貝
頡	士口丆貝
頢	丿古丆貝
頣	匚丨󰁃貝
頤	匚丨口貝
頥	丨匚丨貝
頦	亠ㄥ丿貝
頧	丿󰃧丆貝
頨	羽丆貝󰁶
頩	䒑廾丆貝
頪	米丆貝󰁶
頫	儿󰀪丆貝
頬	一丷大貝
頭	一口䒑貝
頮	水廾丆貝
頯	󰁝廾丆貝
頰	大人人貝
頱	爫寸丆貝
頲	丿士廴貝
頳	土󰁖丆貝
頴	匕二小貝
頵	󰁬丿口貝
頶	丿土口貝
頷	人丶乛貝
頸	一巛工貝
頹	禾儿丆貝
頺	禾乃丆貝
頻	止󰀤丆貝
頼	木口丆貝
頽	禾几丆貝
頾	彡丆貝匕
頿	彡止匕貝
顀	亻󰁷丆貝
顁	宀一󰁾貝
顂	木人人貝
顃	火火丆貝
顄	了󰀪凵貝
顅	丶尸月貝
顆	曰木丆貝
顇	亠人人貝
顈	匕幺小貝
顉	釒丆貝󰁶
顊	丿󰃧十貝
顋	田心丆貝
題	曰一󰁾貝
額	宀夂口貝
顎	口口二貝
顏	文厂彡貝
顐	冖車丆貝
顑	戊一口貝
顒	曰冂丨貝
顓	山丆冂貝
顔	立丿彡貝
顕	日业丆貝
顖	丿囗乂貝
顗	山一口貝
願	厂白小貝
顙	又又又貝
顚	匕目󰄃貝
顛	十󰀣八貝
顜	󰀀冂土貝
顝	󰀾月丆貝
類	米犬丆貝
顟	羽人彡貝
顠	覀二小貝
顡	立󰀓丆貝
顢	廿冂丨貝
顣	戊上小貝
顤	土土土貝
顥	曰󰁸小貝
顦	亻󰁷灬貝
顧	丶尸亻貝
顨	丆貝丆󰀯
顩	人一口貝
顪	止戊一貝
顫	亠囗口貝
顬	󰀙丆冂貝
顭	艹罒冖貝
顮	宀一󰀤貝
顯	曰幺幺貝
顰	止󰀤丆十
顱	虍田皿貝
顲	火火亠貝
顳	耳耳耳貝
顴	艹口口貝
页	丆贝󰁧
顶	丁丆贝󰁶
顷	󰁴丆贝󰁶
顸	干丆贝󰁶
项	工丆贝󰁶
顺	川丆贝󰁶
须	彡丆贝󰁶
顼	王丆贝󰁶
顽	二儿丆贝
顾	厂⺋丆贝
顿	一凵󰁐贝
颀	斤丆贝󰁶
颁	八刀丆贝
颂	八厶丆贝
颃	亠几丆贝
预	󰁻乛亅贝
颅	󰀥尸丆贝
领	人丶󰁻贝
颇	皮丆贝󰁶
颈	ス工丆贝
颉	士口丆贝
颊	一丷大贝
颋	丿士廴贝
颌	人一口贝
颍	匕水丆贝
颎	匕火丆贝
颏	亠ㄥ丿贝
颐	匚丨口贝
频	止󰀤丆贝
颒	水廾丆贝
颓	禾几丆贝
颔	人丶乛贝
颕	匕二小贝
颖	匕禾丆贝
颗	曰木丆贝
题	日一󰁾贝
颙	曰冂丨贝
颚	口口二贝
颛	山丆冂贝
颜	立丿彡贝
额	宀夂口贝
颞	耳又又贝
颟	艹一冂贝
颠	十󰀣八贝
颡	又又又贝
颢	曰󰁸小贝
颣	米幺小贝
颤	亠囗口贝
颥	󰀙丆冂贝
颦	止󰀤丆十
颧	艹口口贝
風	几丿虫󰀦
颩	几丿虫彡
颪	一卜几虫
颫	几丿虫夫
颬	几丿虫丿
颭	几丿虫口
颮	几丿虫巳
颯	立几丿虫
颰	几丿虫丶
颱	几丿虫口
颲	几丿虫刂
颳	几丿虫古
颴	几丿虫󰁾
颵	几丿虫月
颶	几丿虫八
颷	几丿虫火
颸	几丿虫心
颹	几丿虫㐄
颺	几丿虫󰁤
颻	爫𠂉十虫
颼	几丿虫又
颽	山一口虫
颾	几丿虫虫
颿	󰀋灬几虫
飀	几丿虫田
飁	羽白几虫
飂	几丿虫彡
飃	几丿虫小
飄	覀二小虫
飅	几丿虫田
飆	犬犬犬虫
飇	几丿虫犬
飈	几丿虫火
飉	几丿虫小
飊	火火火虫
飋	几丿虫丿
飌	艹口口虫
飍	几丿虫虫
风	几乂󰀦
飏	几乂ㄋ󰁤
飐	几乂󰀥口
飑	几乂勹巳
飒	立几乂󰁶
飓	几乂󰀣八
飔	几乂田心
飕	几乂臼又
飖	爫𠂉十乂
飗	几乂󰁚田
飘	覀二小乂
飙	犬犬犬乂
飚	几乂火火
飛	⺄〈丿丨
飜	丿米田丨
飝	⺄〈丿丨
飞	⺄〈󰀦
食	人丶艮󰁧
飠	人良丿丶
飡	冫人丶艮
飢	人良几󰁀
飣	人良丁󰀢
飤	人良人󰁶
飥	人良丿七
飦	人良干󰀢
飧	夕人丶艮
飨	󰁲丿人艮
飩	人良一乚
飪	人良丿士
飫	人良丿大
飬	丷夫丶艮
飭	人良𠂉力
飮	人丶彐人
飯	人良⺁又
飰	人良亠卜
飱	一夕人艮
飲	人良⺈人
飳	人良丶王
飴	人良厶口
飵	人良𠂉二
飶	人良心丿
飷	人良󰀐一
飸	口一ㄅ艮
飹	人良󰁚卩
飺	止匕人艮
飻	人良人彡
飼	人良𠃌口
飽	人良勹巳
飾	人良𠂉丨
飿	人良凵山
餀	人良艹乂
餁	人良亻士
餂	人良丿古
餃	人良六乂
餄	人良人口
餅	人良䒑廾
餆	人良儿󰀪
餇	人良冂口
餈	冫⺈人艮
餉	人良丿口
養	䒑夫丶艮
餋	丷夫人艮
餌	人良耳󰀝
餍	厂犬人艮
餎	人良夂口
餏	人良亠󰀔
餐	󰀥夕又艮
餑	人良十子
餒	人良爫女
餓	人良丿丶
餔	人良甫󰁶
餕	人良厶夂
餖	人良一䒑
餗	人良木口
餘	人良人朩
餙	人良乂丨
餚	人良乂月
餛	人良日匕
餜	人良曰木
餝	人良艹方
餞	人良戈戈
餟	人良又又
餠	人良丿干
餡	人良⺈臼
餢	人良立口
餣	人良大乚
餤	人良火火
餥	丨三丨艮
餦	人良󰀍󰀖
餧	人良禾女
館	人良宀󰃧
餩	人良人人
餪	人良丆大
餫	人良冖車
餬	人良古月
餭	人良白王
餮	一夕人艮
餯	人良彑󰀓
餰	人良彳丁
餱	人良亻大
餲	人良曰󰄃
餳	人良曰󰁤
餴	人良大廾
餵	人良田󰀖
餶	人良󰀾月
餷	人良木一
餸	人良䒑辶
餹	人良广口
餺	人良甫寸
餻	人良丷灬
餼	人良气米
餽	人良白厶
餾	人良󰁚田
餿	人良臼又
饀	人良爫臼
饁	人良土皿
饂	人良曰皿
饃	人良艹大
饄	人良⺌土
饅	人良曰又
饆	人良曰󰀟
饇	人良匚口
饈	人良⺶一
饉	人良廿
饊	人良󰁺攵
饋	人良口貝
饌	人良巳八
饍	人良羊口
饎	人良士口
饏	乛耳攵艮
饐	人良士䒑
饑	人良幺人
饒	人良土儿
饓	人良⺌木
饔	亠󰁲丿艮
饕	口一ㄅ艮
饖	人良止󰀤
饗	󰁲丿丶艮
饘	人良亠一
饙	人良十貝
饚	人良艹皿
饛	人良艹󰀓
饜	厂曰月艮
饝	人良广石
饞	人良⺈丶
饟	人良亠󰀔
饠	人良罒󰁷
饡	人良丿貝
饢	人良一󰀔
饣	⺈󰁐󰀅
饤	⺈󰁐丁󰀢
饥	⺈󰁐几󰁀
饦	⺈󰁐丿七
饧	⺈󰁐ㄋ󰁤
饨	⺈󰁐一乚
饩	⺈󰁐气󰁀
饪	⺈󰁐丿士
饫	⺈󰁐丿大
饬	⺈󰁐𠂉力
饭	⺈󰁐⺁又
饮	⺈󰁐⺈人
饯	⺈󰁐一戈
饰	⺈󰁐𠂉丨
饱	⺈󰁐勹巳
饲	⺈󰁐𠃌口
饳	⺈󰁐凵山
饴	⺈󰁐厶口
饵	⺈󰁐耳󰀝
饶	⺈󰁐󰀁儿
饷	⺈󰁐丿口
饸	⺈󰁐人口
饹	⺈󰁐夂口
饺	⺈󰁐六乂
饻	⺈󰁐亠󰀔
饼	⺈󰁐䒑廾
饽	⺈󰁐十子
饾	⺈󰁐一䒑
饿	⺈󰁐丿丶
馀	⺈󰁐人朩
馁	⺈󰁐爫女
馂	⺈󰁐厶夂
馃	⺈󰁐曰木
馄	⺈󰁐曰匕
馅	⺈󰁐⺈臼
馆	⺈󰁐宀󰃧
馇	⺈󰁐木一
馈	⺈󰁐口贝
馉	⺈󰁐󰀾月
馊	⺈󰁐臼又
馋	⺈󰁐⺈󰁦
馌	⺈󰁐土皿
馍	⺈󰁐艹大
馎	⺈󰁐甫寸
馏	⺈󰁐󰁚田
馐	⺈󰁐⺶一
馑	⺈󰁐廿
馒	⺈󰁐曰又
馓	⺈󰁐󰁺攵
馔	⺈󰁐巳八
馕	⺈󰁐一󰀔
首	䒑丿目󰀘
馗	九䒑丿目
馘	䒑丿目󰀞
香	禾曰󰀘
馚	禾日八刀
馛	禾日丶
馜	禾日尸匕
馝	禾日心丿
馞	禾日十子
馟	禾日爫子
馠	禾日人口
馡	禾日丨三
馢	禾日戈戈
馣	禾日大乚
馤	禾日曰󰄃
馥	禾日𠂉夂
馦	禾日䒑八
馧	禾日日皿
馨	士󰁅几日
馩	禾日十貝
馪	禾日宀貝
馫	禾日禾日
馬	󰀋灬󰀦
馭	󰀋灬又󰁶
馮	冫󰀋灬󰁶
馯	󰀋灬干󰀢
馰	󰀋灬勹丶
馱	󰀋灬大󰁶
馲	󰀋灬丿七
馳	󰀋灬也󰁀
馴	󰀋灬川󰀢
馵	󰀋灬廾󰀬
馶	󰀋灬十又
馷	󰀋灬一丨
馸	󰀋灬斤󰀢
馹	󰀋灬日󰀝
馺	󰀋灬乃󰂃
馻	󰀋灬厶儿
馼	󰀋灬文󰁶
馽	󰀋灬口丨
馾	󰀋灬冖󰁜
馿	󰀋灬丶尸
駀	󰀋灬丶
駁	󰀋灬乂乂
駂	匕十󰀋灬
駃	󰀋灬ユ人
駄	󰀋灬大丶
駅	󰀋灬尸󰂃
駆	󰀋灬匚乂
駇	󰀋灬攵󰁶
駈	󰀋灬丘󰀝
駉	󰀋灬冂口
駊	󰀋灬皮󰁶
駋	󰀋灬刀口
駌	夕⺋󰀋灬
駍	󰀋灬一十
駎	󰀋灬由󰀝
駏	󰀋灬匚󰁃
駐	󰀋灬丶王
駑	女又󰀋灬
駒	󰀋灬勹口
駓	󰀋灬丆一
駔	󰀋灬󰀐一
駕	力口󰀋灬
駖	󰀋灬人󰁻
駗	󰀋灬人彡
駘	󰀋灬厶口
駙	󰀋灬亻寸
駚	󰀋灬ㄇ大
駛	󰀋灬口乂
駜	󰀋灬心丿
駝	󰀋灬宀匕
駞	󰀋灬𠂉也
駟	󰀋灬四󰀝
駠	󰀋灬󰁚卩
駡	口口󰀋灬
駢	󰀋灬䒑廾
駣	󰀋灬儿󰀪
駤	󰀋灬一土
駥	󰀋灬戈
駦	丷夫󰀋灬
駧	󰀋灬冂口
駨	󰀋灬勹日
駩	󰀋灬人王
駪	󰀋灬丿儿
駫	󰀋灬⺌儿
駬	󰀋灬耳󰀝
駭	󰀋灬亠人
駮	󰀋灬六乂
駯	󰀋灬丿未
駰	󰀋灬囗大
駱	󰀋灬夂口
駲	󰀋灬丶丨
駳	󰀋灬丿廴
駴	󰀋灬戈廾
駵	󰀋灬一󰁃
駶	󰀋灬尸口
駷	󰀋灬木口
駸	󰀋灬彐又
駹	󰀋灬丶
駺	󰀋灬丶艮
駻	󰀋灬日干
駼	󰀋灬人朩
駽	󰀋灬口月
駾	󰀋灬丷儿
駿	󰀋灬厶夂
騀	󰀋灬丿丶
騁	󰀋灬由ㄅ
騂	󰀋灬辛󰀢
騃	󰀋灬厶大
騄	󰀋灬󰁭氺
騅	󰀋灬亻󰁷
騆	󰀋灬󰀼口
騇	󰀋灬人口
騈	󰀋灬丿干
騉	󰀋灬日匕
騊	󰀋灬勹凵
騋	󰀋灬木人
騌	󰀋灬宀小
騍	󰀋灬日木
騎	󰀋灬大口
騏	󰀋灬󰀎八
騐	󰀋灬人心
騑	󰀋灬丨三
騒	󰀋灬又虫
験	󰀋灬人人
騔	󰀋灬日󰄃
騕	󰀋灬覀女
騖	󰁻乛亅灬
騗	丶尸冂灬
騘	󰀋灬勹心
騙	󰀋灬丶艹
騚	󰀋灬䒑刂
騛	󰀋灬⺄丨
騜	󰀋灬白王
騝	󰀋灬󰁬廴
騞	󰀋灬三石
騟	󰀋灬人刂
騠	󰀋灬日󰁾
騡	󰀋灬白水
騢	󰀋灬󰁃又
騣	󰀋灬乂夂
騤	󰀋灬癶大
騥	󰀋灬󰁻木
騦	󰀋灬田心
騧	󰀋灬ㄇ口
騨	󰀋灬󰀧十
騩	󰀋灬白厶
騪	󰀋灬臼又
騫	宀󰀀八灬
騬	󰀋灬禾匕
騭	阝止󰀤灬
騮	󰀋灬󰁚田
騯	󰀋灬亠方
騰	月丷夫灬
騱	󰀋灬爫大
騲	󰀋灬艹早
騳	󰀋灬󰀋灬
騴	󰀋灬日女
騵	󰀋灬厂小
騶	󰀋灬勹丿
騷	󰀋灬又虫
騸	󰀋灬丶羽
騹	󰀋灬廿
騺	土䒑十灬
騻	󰀋灬大乂
騼	󰀋灬󰁙󰁴
騽	󰀋灬羽白
騾	󰀋灬田小
騿	󰀋灬立早
驀	艹曰大灬
驁	󰁡攵灬
驂	󰀋灬厶彡
驃	󰀋灬覀小
驄	󰀋灬丿心
驅	󰀋灬匚口
驆	󰀋灬曰󰀟
驇	土八土灬
驈	󰀋灬󰁻口
驉	󰀋灬虍业
驊	󰀋灬艹󰀟
驋	󰀋灬癶又
驌	󰀋灬󰁬󰀲
驍	󰀋灬土儿
驎	󰀋灬米㐄
驏	󰀋灬尸子
驐	󰀋灬󰁸攵
驑	󰀋灬一田
驒	󰀋灬口十
驓	󰀋灬丷日
驔	󰀋灬覀早
驕	󰀋灬丿口
驖	󰀋灬十王
驗	󰀋灬人人
驘	󰄹月󰀋丶
驙	󰀋灬亠一
驚	艹勹口灬
驛	󰀋灬罒十
驜	󰀋灬业未
驝	󰀋灬士木
驞	󰀋灬宀貝
驟	󰀋灬耳乑
驠	󰀋灬廿灬
驡	立月一灬
驢	󰀋灬虍皿
驣	󰀋灬丷灬
驤	󰀋灬亠󰀔
驥	󰀋灬丬八
驦	󰀋灬󰀙目
驧	󰀋灬廿米
驨	󰀋灬山口
驩	󰀋灬艹󰁷
驪	󰀋灬一匕
驫	󰀋灬󰀋灬
马	󰀊一󰀌
驭	󰀊󰀞又󰁶
驮	󰀊󰀞大󰁶
驯	󰀊󰀞川󰀢
驰	󰀊󰀞也󰁀
驱	󰀊󰀞匚乂
驲	󰀊󰀞日󰀝
驳	󰀊󰀞乂乂
驴	󰀊󰀞丶尸
驵	󰀊󰀞󰀐一
驶	󰀊󰀞口乂
驷	󰀊󰀞四󰀝
驸	󰀊󰀞亻寸
驹	󰀊󰀞勹口
驺	󰀊󰀞⺈彐
驻	󰀊󰀞丶王
驼	󰀊󰀞宀匕
驽	女又󰀊一
驾	力口󰀊一
驿	󰀊󰀞又󰀟
骀	󰀊󰀞厶口
骁	󰀊󰀞󰀁儿
骂	口口󰀊一
骃	󰀊󰀞囗大
骄	󰀊󰀞丿󰀯
骅	󰀊󰀞亻十
骆	󰀊󰀞夂口
骇	󰀊󰀞亠人
骈	󰀊󰀞䒑廾
骉	󰀊一󰀊󰀞
骊	󰀊󰀞一丶
骋	󰀊󰀞由ㄅ
验	󰀊󰀞人一
骍	󰀊󰀞辛󰀢
骎	󰀊󰀞彐又
骏	󰀊󰀞厶夂
骐	󰀊󰀞󰀎八
骑	󰀊󰀞大口
骒	󰀊󰀞曰木
骓	󰀊󰀞亻󰁷
骔	󰀊󰀞宀小
骕	󰀊󰀞󰁬八
骖	󰀊󰀞厶彡
骗	󰀊󰀞丶艹
骘	阝止󰀤一
骙	󰀊󰀞癶大
骚	󰀊󰀞又虫
骛	󰁻乛亅一
骜	󰁡攵一
骝	󰀊󰀞󰁚田
骞	宀󰀀八一
骟	󰀊󰀞丶羽
骠	󰀊󰀞覀小
骡	󰀊󰀞田小
骢	󰀊󰀞丿心
骣	󰀊󰀞尸子
骤	󰀊󰀞耳乑
骥	󰀊󰀞丬八
骦	󰀊󰀞󰀙目
骧	󰀊󰀞亠󰀔
骨	󰀾月󰀘
骩	󰀾月九󰁀
骪	󰀾月几丶
骫	󰀾月九丶
骬	󰀾月一󰀛
骭	󰀾月干󰀢
骮	󰀾月󰀁丶
骯	󰀾月亠几
骰	󰀾月几又
骱	󰀾月人󰀯
骲	󰀾月勹巳
骳	󰀾月皮󰁶
骴	󰀾月止匕
骵	󰀾月木一
骶	󰀾月󰁚丶
骷	󰀾月古󰀝
骸	󰀾月亠人
骹	󰀾月六乂
骺	󰀾月⺁口
骻	󰀾月大ㄅ
骼	󰀾月夂口
骽	󰀾月爫女
骾	󰀾月一乂
骿	󰀾月䒑廾
髀	󰀾月白十
髁	󰀾月曰木
髂	󰀾月宀口
髃	󰀾月曰丶
髄	󰀾月辶
髅	󰀾月米女
髆	󰀾月甫寸
髇	󰀾月󰁸口
髈	󰀾月亠方
髉	󰀾月冖󰁷
髊	󰀾月⺶工
髋	󰀾月宀󰁜
髌	󰀾月宀八
髍	󰀾月广木
髎	󰀾月羽彡
髏	󰀾月󰀻女
髐	󰀾月土儿
髑	󰀾月罒虫
髒	󰀾月艹廾
髓	󰀾月辶
體	󰀾月ㄇ䒑
髕	󰀾月宀貝
髖	󰀾月宀丶
髗	󰀾月虍田
高	󰁸冂口󰀘
髙	亠〢二口
髚	󰁸冂口几
髛	󰁸冂口九
髜	󰁸冂口廾
髝	󰁸冂口力
髞	󰁸冂口木
髟	󰂞彡󰁥
髠	󰂞彡几󰀅
髡	󰂞彡一儿
髢	󰂞彡也󰀅
髣	󰂞彡方󰁣
髤	󰂞彡木󰁧
髥	󰂞彡冂二
髦	󰂞彡毛󰀅
髧	󰂞彡冖󰁜
髨	󰂞彡二儿
髩	󰂞彡一𠃌
髪	󰂞彡又
髫	󰂞彡刀口
髬	󰂞彡丆一
髭	󰂞彡止匕
髮	󰂞彡丶
髯	󰂞彡冂土
髰	󰂞彡廿󰄃
髱	󰂞彡勹巳
髲	󰂞彡皮󰁧
髳	󰂞彡󰁻丿
髴	󰂞彡弓󰀯
髵	󰂞彡丆〢
髶	󰂞彡耳󰀘
髷	󰂞彡ㄇ󰁺
髸	󰂞彡󰁺八
髹	󰂞彡亻木
髺	󰂞彡丿古
髻	󰂞彡士口
髼	󰂞彡夂丨
髽	󰂞彡人土
髾	󰂞彡⺌月
髿	󰂞彡氵丿
鬀	󰂞彡丷丿
鬁	󰂞彡禾刂
鬂	󰂞彡丘八
鬃	󰂞彡宀小
鬄	󰂞彡日󰁤
鬅	󰂞彡月月
鬆	󰂞彡木厶
鬇	󰂞彡⺈亅
鬈	󰂞彡丷⺋
鬉	󰂞彡乂夂
鬊	󰂞彡三日
鬋	󰂞彡䒑刂
鬌	󰂞彡月
鬍	󰂞彡古月
鬎	󰂞彡木刂
鬏	󰂞彡禾火
鬐	󰂞彡土日
鬑	󰂞彡䒑八
鬒	󰂞彡十八
鬓	󰂞彡宀八
鬔	󰂞彡夂辶
鬕	󰂞彡艹大
鬖	󰂞彡厶彡
鬗	󰂞彡廿丶
鬘	󰂞彡曰又
鬙	󰂞彡丷日
鬚	󰂞彡彡貝
鬛	󰂞彡囗󰁒
鬜	󰂞彡門月
鬝	󰂞彡門日
鬞	󰂞彡ㄇ󰀖
鬟	󰂞彡罒󰀔
鬠	󰂞彡人日
鬡	󰂞彡宀丁
鬢	󰂞彡宀貝
鬣	󰂞彡巛󰁒
鬤	󰂞彡亠󰀔
鬥	丨王王亅
鬦	丨王王十
鬧	丨王王丨
鬨	丨王王八
鬩	丨王王儿
鬪	丨王王寸
鬫	丨王王攵
鬬	丨王王斤
鬭	丨王王斤
鬮	丨王王󰁵
鬯	󰁘凵匕󰀅
鬰	木乂乂彡
鬱	木𠂉十彡
鬲	一口冂丨
鬳	虍一口丨
鬴	一口冂甫
鬵	󰀄󰁜󰀄丨
鬶	夫冂󰁜丨
鬷	一口冂夂
鬸	一口冂田
鬹	夫目儿丨
鬺	一口冂󰁤
鬻	弓米弓丨
鬼	白󰁜厶󰀦
鬽	白󰁜厶彡
鬾	白󰁜厶又
鬿	白󰁜厶斤
魀	白󰁜厶󰀯
魁	白󰁜厶十
魂	二厶白厶
魃	白󰁜厶丶
魄	白白󰁜厶
魅	白󰁜厶未
魆	白󰁜厶󰁐
魇	厂犬白厶
魈	白󰁜厶月
魉	白󰁜厶人
魊	白󰁜厶󰀞
魋	白󰁜厶󰁷
魌	白󰁜厶八
魍	白󰁜厶󰄃
魎	白󰁜厶丶
魏	禾女白厶
魐	白󰁜厶八
魑	白󰁜厶厶
魒	白󰁜厶小
魓	白󰁜厶󰀟
魔	广木木厶
魕	白󰁜厶人
魖	白󰁜厶业
魗	士乛工厶
魘	厂曰月厶
魙	氵車斤厶
魚	󰁢灬󰁧
魛	󰁢灬刀󰁥
魜	󰁢灬人󰁶
魝	󰁢灬刂󰀢
魞	󰁢灬丿󰂃
魟	󰁢灬工󰀝
魠	󰁢灬丿七
魡	󰁢灬勹丶
魢	󰁢灬己󰁀
魣	󰁢灬󰁻亅
魤	󰁢灬亻ヒ
魥	󰁢灬乃󰂃
魦	󰁢灬小丿
魧	󰁢灬亠几
魨	󰁢灬一乚
魩	󰁢灬勹󰁤
魪	󰁢灬人󰀯
魫	󰁢灬冖󰁜
魬	󰁢灬⺁又
魭	󰁢灬二儿
魮	󰁢灬󰁴匕
魯	󰁢灬日󰀘
魰	󰁢灬文󰁶
魱	󰁢灬一彑
魲	󰁢灬丶尸
魳	󰁢灬一丨
魴	󰁢灬方󰁥
魵	󰁢灬八刀
魶	󰁢灬冂人
魷	󰁢灬丶
魸	󰁢灬丿󰁈
魹	󰁢灬毛󰁀
魺	󰁢灬丁口
魻	󰁢灬甲󰀢
魼	󰁢灬土厶
魽	󰁢灬甘󰀝
魾	󰁢灬丆一
魿	󰁢灬人󰁻
鮀	󰁢灬宀匕
鮁	󰁢灬丶
鮂	󰁢灬囗人
鮃	󰁢灬一十
鮄	󰁢灬弓󰀯
鮅	󰁢灬心丿
鮆	止匕󰁢灬
鮇	󰁢灬未󰁶
鮈	󰁢灬勹口
鮉	󰁢灬刀口
鮊	󰁢灬白󰀝
鮋	󰁢灬由󰀝
鮌	󰁢灬亠幺
鮍	󰁢灬皮󰁶
鮎	󰁢灬󰀥口
鮏	󰁢灬丿
鮐	󰁢灬厶口
鮑	󰁢灬勹巳
鮒	󰁢灬亻寸
鮓	󰁢灬𠂉二
鮔	󰁢灬匚󰁃
鮕	󰁢灬古󰀝
鮖	󰁢灬石󰀝
鮗	󰁢灬夂󰁦
鮘	󰁢灬亻丶
鮙	󰁢灬羽󰀝
鮚	󰁢灬士口
鮛	󰁢灬上小
鮜	󰁢灬⺁口
鮝	丷夫󰁢灬
鮞	󰁢灬丆〢
鮟	󰁢灬宀女
鮠	󰁢灬⺈⺋
鮡	󰁢灬儿󰀪
鮢	󰁢灬丿未
鮣	󰁢灬󰁚卩
鮤	一夕刂灬
鮥	󰁢灬夂口
鮦	󰁢灬冂口
鮧	󰁢灬一人
鮨	󰁢灬匕日
鮩	󰁢灬䒑廾
鮪	󰁢灬月
鮫	󰁢灬六乂
鮬	󰁢灬大ㄅ
鮭	󰁢灬土土
鮮	󰁢灬羊󰀢
鮯	󰁢灬人口
鮰	󰁢灬囗口
鮱	󰁢灬土匕
鮲	󰁢灬亻犬
鮳	󰁢灬土ㄅ
鮴	󰁢灬亻木
鮵	󰁢灬丷儿
鮶	󰁢灬󰁬口
鮷	󰁢灬丷丿
鮸	󰁢灬⺈󰁜
鮹	󰁢灬⺌月
鮺	⺶󰁢灬󰁧
鮻	󰁢灬厶夂
鮼	󰁢灬彐又
鮽	󰁢灬人朩
鮾	󰁢灬爫女
鮿	󰁢灬耳乚
鯀	󰁢灬丿小
鯁	󰁢灬一乂
鯂	󰁢灬西一
鯃	󰁢灬五口
鯄	󰁢灬一丶
鯅	󰁢灬丿廴
鯆	󰁢灬甫󰁶
鯇	󰁢灬宀儿
鯈	亻丨夂灬
鯉	󰁢灬曰土
鯊	氵小丿灬
鯋	󰁢灬氵丿
鯌	󰁢灬丿口
鯍	󰁢灬亠󰀸
鯎	󰁢灬戊𠃌
鯏	󰁢灬禾刂
鯐	󰁢灬土󰁾
鯑	󰁢灬乂丨
鯒	󰁢灬󰁻用
鯓	󰁢灬丿丿
鯔	󰁢灬巛田
鯕	󰁢灬󰀎八
鯖	󰁢灬月
鯗	䒑夫󰁢灬
鯘	󰁢灬禾女
鯙	󰁢灬󰁸子
鯚	󰁢灬禾子
鯛	󰁢灬󰀼口
鯜	󰁢灬立女
鯝	󰁢灬囗古
鯞	󰁢灬彐丨
鯟	󰁢灬木曰
鯠	󰁢灬木人
鯡	󰁢灬丨三
鯢	󰁢灬臼儿
鯣	󰁢灬日󰁤
鯤	󰁢灬日匕
鯥	󰁢灬土土
鯦	󰁢灬夂口
鯧	󰁢灬日曰
鯨	󰁢灬󰁸小
鯩	󰁢灬人艹
鯪	󰁢灬土夂
鯫	󰁢灬耳又
鯬	禾勹丿灬
鯭	󰁢灬子皿
鯮	󰁢灬宀小
鯯	󰁢灬𠂉刂
鯰	󰁢灬人心
鯱	󰁢灬虍几
鯲	󰁢灬方󰁦
鯳	󰁢灬广丶
鯴	󰁢灬⺄虫
鯵	󰁢灬厶彡
鯶	󰁢灬冖車
鯷	󰁢灬日󰁾
鯸	󰁢灬亻大
鯹	󰁢灬曰
鯺	󰁢灬土日
鯻	󰁢灬木刂
鯼	󰁢灬乂夂
鯽	󰁢灬󰁮卩
鯾	󰁢灬亻乂
鯿	󰁢灬丶艹
鰀	󰁢灬爫又
鰁	󰁢灬白水
鰂	󰁢灬貝刂
鰃	󰁢灬田󰀖
鰄	󰁢灬戊女
鰅	󰁢灬曰丶
鰆	󰁢灬三日
鰇	󰁢灬󰁻木
鰈	󰁢灬廿木
鰉	󰁢灬白王
鰊	󰁢灬木󰀹
鰋	󰁢灬匚女
鰌	󰁢灬丷一
鰍	󰁢灬禾火
鰎	󰁢灬󰁬廴
鰏	󰁢灬一田
鰐	󰁢灬口ㄅ
鰑	󰁢灬日󰁤
鰒	󰁢灬𠂉夂
鰓	󰁢灬田心
鰔	󰁢灬戊口
鰕	󰁢灬󰁃又
鰖	󰁢灬月
鰗	󰁢灬古月
鰘	󰁢灬宀土
鰙	󰁢灬艹口
鰚	󰁢灬宀一
鰛	󰁢灬日皿
鰜	󰁢灬䒑八
鰝	󰁢灬󰁸口
鰞	󰁢灬󰁞灬
鰟	󰁢灬亠方
鰠	󰁢灬又虫
鰡	󰁢灬󰁚田
鰢	󰁢灬󰀋灬
鰣	󰁢灬日寸
鰤	󰁢灬丿丨
鰥	󰁢灬罒󰀫
鰦	󰁢灬䒑幺
鰧	月丷夫灬
鰨	󰁢灬日羽
鰩	󰁢灬爫凵
鰪	󰁢灬土皿
鰫	󰁢灬宀口
鰬	󰁢灬虍文
鰭	󰁢灬土日
鰮	󰁢灬囗皿
鰯	󰁢灬弓冫
鰰	󰁢灬礻丨
鰱	󰁢灬車辶
鰲	󰁡攵灬
鰳	󰁢灬廿力
鰴	彳山一攵
鰵	𠂉母攵灬
鰶	󰁢灬󰁯小
鰷	󰁢灬亻朩
鰸	󰁢灬匚口
鰹	󰁢灬匚土
鰺	󰁢灬厶彡
鰻	󰁢灬日又
鰼	󰁢灬羽白
鰽	󰁢灬一日
鰾	󰁢灬覀小
鰿	󰁢灬貝
鱀	󰁮󰀄󰁜灬
鱁	󰁢灬一辶
鱂	󰁢灬爿寸
鱃	󰁢灬⺶一
鱄	󰁢灬一寸
鱅	󰁢灬广丨
鱆	󰁢灬立早
鱇	󰁢灬广氺
鱈	󰁢灬󰀙彐
鱉	㡀攵󰁢灬
鱊	󰁢灬󰁻口
鱋	󰁢灬虍业
鱌	󰁢灬⺈󰀓
鱍	󰁢灬癶又
鱎	󰁢灬丿口
鱏	󰁢灬覀早
鱐	󰁢灬󰁬󰀲
鱑	󰁢灬󰁺八
鱒	󰁢灬丷寸
鱓	󰁢灬口十
鱔	󰁢灬羊口
鱕	󰁢灬丿田
鱖	󰁢灬厂人
鱗	󰁢灬米㐄
鱘	󰁢灬彐寸
鱙	󰁢灬土儿
鱚	󰁢灬士口
鱛	󰁢灬丷日
鱜	󰁢灬󰁲阝
鱝	󰁢灬十貝
鱞	󰁢灬罒󰀔
鱟	󰀗乂乂灬
鱠	󰁢灬人日
鱡	󰁢灬貝
鱢	󰁢灬口木
鱣	󰁢灬亠一
鱤	󰁢灬戊心
鱥	󰁢灬止󰀤
鱦	󰁢灬黽󰀝
鱧	󰁢灬ㄇ䒑
鱨	󰁢灬⺌日
鱩	󰁢灬󰀙田
鱪	󰁢灬曰日
鱫	󰁢灬爫夂
鱬	󰁢灬󰀙〢
鱭	󰁢灬󰀴󰀳
鱮	󰁢灬󰀗八
鱯	󰁢灬艹又
鱰	󰁢灬罒日
鱱	󰁢灬厂丶
鱲	󰁢灬巛󰁒
鱳	󰁢灬白木
鱴	󰁢灬艹人
鱵	󰁢灬⺮口
鱶	󰁢灬䒑艮
鱷	󰁢灬王口
鱸	󰁢灬虍皿
鱹	󰁢灬艹󰁷
鱺	󰁢灬一匕
鱻	󰁢灬󰁢灬
鱼	󰁢一󰀘
鱽	󰁢󰀞刀󰁥
鱾	󰁢󰀞己󰁀
鱿	󰁢󰀞丶
鲀	󰁢󰀞一乚
鲁	󰁢一曰󰀘
鲂	󰁢󰀞方󰁥
鲃	󰁢󰀞巴󰁀
鲄	󰁢󰀞丁口
鲅	󰁢󰀞丶
鲆	󰁢󰀞一十
鲇	󰁢󰀞󰀥口
鲈	󰁢󰀞󰀥尸
鲉	󰁢󰀞由󰀝
鲊	󰁢󰀞𠂉二
鲋	󰁢󰀞亻寸
鲌	󰁢󰀞白󰀝
鲍	󰁢󰀞勹巳
鲎	󰀧冖󰁢一
鲏	󰁢󰀞皮󰁶
鲐	󰁢󰀞厶口
鲑	󰁢󰀞土土
鲒	󰁢󰀞士口
鲓	󰁢󰀞土ㄅ
鲔	󰁢󰀞月
鲕	󰁢󰀞丆〢
鲖	󰁢󰀞冂口
鲗	󰁢󰀞贝刂
鲘	󰁢󰀞⺁口
鲙	󰁢󰀞人厶
鲚	󰁢󰀞文󰀯
鲛	󰁢󰀞六乂
鲜	󰁢󰀞羊󰀢
鲝	⺶󰁢一󰀘
鲞	丷夫󰁢一
鲟	󰁢󰀞彐寸
鲠	󰁢󰀞一乂
鲡	󰁢󰀞一丶
鲢	󰁢󰀞车辶
鲣	󰁢󰀞〢土
鲤	󰁢󰀞曰土
鲥	󰁢󰀞日寸
鲦	󰁢󰀞夂朩
鲧	󰁢󰀞丿小
鲨	氵小丿一
鲩	󰁢󰀞宀儿
鲪	󰁢󰀞󰁬口
鲫	󰁢󰀞󰁮卩
鲬	󰁢󰀞󰁻用
鲭	󰁢󰀞月
鲮	󰁢󰀞土夂
鲯	󰁢󰀞󰀎八
鲰	󰁢󰀞耳又
鲱	󰁢󰀞丨三
鲲	󰁢󰀞曰匕
鲳	󰁢󰀞日曰
鲴	󰁢󰀞囗古
鲵	󰁢󰀞臼儿
鲶	󰁢󰀞人心
鲷	󰁢󰀞󰀼口
鲸	󰁢󰀞󰁸小
鲹	󰁢󰀞厶彡
鲺	󰁢󰀞⺄虫
鲻	󰁢󰀞巛田
鲼	󰁢󰀞十贝
鲽	󰁢󰀞廿木
鲾	󰁢󰀞一田
鲿	󰁢󰀞⺌厶
鳀	󰁢󰀞日󰁾
鳁	󰁢󰀞日皿
鳂	󰁢󰀞田󰀖
鳃	󰁢󰀞田心
鳄	󰁢󰀞口ㄅ
鳅	󰁢󰀞禾火
鳆	󰁢󰀞𠂉夂
鳇	󰁢󰀞白王
鳈	󰁢󰀞白水
鳉	󰁢󰀞丬寸
鳊	󰁢󰀞丶艹
鳋	󰁢󰀞又虫
鳌	󰁡攵一
鳍	󰁢󰀞土日
鳎	󰁢󰀞曰羽
鳏	󰁢󰀞罒󰀫
鳐	󰁢󰀞爫凵
鳑	󰁢󰀞亠方
鳒	󰁢󰀞䒑八
鳓	󰁢󰀞廿力
鳔	󰁢󰀞覀小
鳕	󰁢󰀞󰀙彐
鳖	㡀攵󰁢一
鳗	󰁢󰀞曰又
鳘	𠂉母攵一
鳙	󰁢󰀞广丨
鳚	󰁢󰀞尸二
鳛	󰁢󰀞羽白
鳜	󰁢󰀞厂人
鳝	󰁢󰀞羊口
鳞	󰁢󰀞米㐄
鳟	󰁢󰀞丷寸
鳠	󰁢󰀞艹又
鳡	󰁢󰀞戊心
鳢	󰁢󰀞ㄇ䒑
鳣	󰁢󰀞亠一
鳤	󰁢󰀞⺮󰃧
鳥	󰁟灬󰀦
鳦	󰁟灬乙󰁀
鳧	󰁟灬几󰀅
鳨	󰁟灬力󰁥
鳩	九󰁟灬󰁶
鳪	卜󰁟灬󰁶
鳫	厂󰁟灬󰀦
鳬	󰁟几󰀅
鳭	刀󰁟灬󰁶
鳮	又󰁟灬󰁶
鳯	几󰁟灬󰀦
鳰	丿丶󰁟灬
鳱	干󰁟灬󰁶
鳲	尸󰁟灬󰁶
鳳	几一󰁟灬
鳴	口󰁟灬󰁶
鳵	⺄十󰁟灬
鳶	󰀁丶󰁟灬
鳷	十又󰁟灬
鳸	丶尸󰁟灬
鳹	人丶乛灬
鳺	夫󰁟灬󰁶
鳻	八刀󰁟灬
鳼	文󰁟灬󰁶
鳽	一廾󰁟灬
鳾	一冂丨灬
鳿	王󰁟灬󰁶
鴀	丆卜󰁟灬
鴁	丿大󰁟灬
鴂	ユ人󰁟灬
鴃	󰁟灬ユ人
鴄	匚儿󰁟灬
鴅	󰀼亠󰁟灬
鴆	冖󰁜󰁟灬
鴇	匕十󰁟灬
鴈	厂亻󰁟灬
鴉	󰀄亅丿灬
鴊	一止󰁟灬
鴋	方󰁟灬󰁶
鴌	一大󰁟灬
鴍	文󰁟灬󰁧
鴎	匚乂󰁟灬
鴏	󰁟灬亻丶
鴐	力口󰁟灬
鴑	女又󰁟灬
鴒	人丶󰁻灬
鴓	心丿󰁟灬
鴔	丿之󰁟灬
鴕	󰁟灬宀匕
鴖	󰁂󰀁󰁟灬
鴗	立󰁟灬󰁶
鴘	厶廾󰁟灬
鴙	𠂉大󰁟灬
鴚	󰁟灬丁口
鴛	夕⺋󰁟灬
鴜	止匕󰁟灬
鴝	勹口󰁟灬
鴞	口一ㄅ灬
鴟	󰁚󰀁丶灬
鴠	日󰀞󰁟灬
鴡	󰀐󰀞󰁟灬
鴢	幺力󰁟灬
鴣	古󰁟灬󰁶
鴤	󰁟灬夂󰁦
鴥	󰁟灬宀八
鴦	ㄇ大󰁟灬
鴧	宀几󰁟灬
鴨	甲󰁟灬󰁶
鴩	丿夫󰁟灬
鴪	宀八󰁟灬
鴫	田󰁟灬󰁶
鴬	󰀧冖󰁟灬
鴭	丿󰃧󰁟灬
鴮	大二ㄅ灬
鴯	丆冂〢灬
鴰	丿古󰁟灬
鴱	艹乂󰁟灬
鴲	匕日󰁟灬
鴳	宀女󰁟灬
鴴	彳一丁灬
鴵	儿󰀪󰁟灬
鴶	士口󰁟灬
鴷	一夕刂灬
鴸	丿未󰁟灬
鴹	⺶󰁟灬󰁶
鴺	一弓人灬
鴻	氵工󰁟灬
鴼	󰁟灬夂口
鴽	女口󰁟灬
鴾	厶丿󰀟灬
鴿	人一口灬
鵀	亻丿士灬
鵁	六乂󰁟灬
鵂	亻木󰁟灬
鵃	丿󰁪󰁟灬
鵄	一厶土灬
鵅	夂口󰁟灬
鵆	彳󰁟灬丁
鵇	𠂉㐄󰁟灬
鵈	耳󰁟灬󰁶
鵉	亠󰁗󰁟灬
鵊	大人人灬
鵋	己心󰁟灬
鵌	󰁟灬人朩
鵍	宀二儿灬
鵎	爫女󰁟灬
鵏	甫󰁟灬󰁶
鵐	工人人灬
鵑	口月󰁟灬
鵒	八人口灬
鵓	十冖孑灬
鵔	󰁟灬厶夂
鵕	厶八夂灬
鵖	󰁮󰁟灬󰁶
鵗	乂冂灬
鵘	󰁬丿口灬
鵙	貝󰁟灬󰁶
鵚	禾几󰁟灬
鵛	一巛工灬
鵜	丷弓丨灬
鵝	丿扌󰁒灬
鵞	丿扌󰁒灬
鵟	犭󰁥王灬
鵠	丿土口灬
鵡	一󰀁止灬
鵢	丿󰀽三灬
鵣	木口󰁟灬
鵤	⺈用󰁟灬
鵥	丷󰀠刂灬
鵦	󰁟灬󰁭氺
鵧	䒑廾󰁟灬
鵨	人干口灬
鵩	月卩又灬
鵪	大曰󰄃灬
鵫	󰀥早󰁟灬
鵬	月月󰁟灬
鵭	釒󰁟灬󰁶
鵮	⺈臼󰁟灬
鵯	白丿十灬
鵰	󰀼土口灬
鵱	土八土灬
鵲	󰁺日󰁟灬
鵳	丶尸月灬
鵴	勹米󰁟灬
鵵	⺈口󰁜灬
鵶	一󰀚󰀞灬
鵷	宀夕⺋灬
鵸	大丁口灬
鵹	禾勹丿灬
鵺	亠亻夂灬
鵻	󰁟灬亻󰁷
鵼	宀八工灬
鵽	又又又灬
鵾	日󰁴󰁴灬
鵿	󰁟灬日廾
鶀	󰁟灬󰀎八
鶁	󰁸小󰁟灬
鶂	臼儿󰁟灬
鶃	󰁟灬臼儿
鶄	月󰁟灬
鶅	巛田󰁟灬
鶆	木人人灬
鶇	木曰󰁟灬
鶈	一󰁬丨灬
鶉	󰁸孑󰁟灬
鶊	广󰁬人灬
鶋	尸古󰁟灬
鶌	尸凵山灬
鶍	日勹󰁤灬
鶎	宀二小灬
鶏	爫夫󰁟灬
鶐	木丶辶灬
鶑	火火󰁟灬
鶒	木口力灬
鶓	艹田󰁟灬
鶔	󰁻乛亅灬
鶕	立日󰁟灬
鶖	禾火󰁟灬
鶗	日一󰁾灬
鶘	古月󰁟灬
鶙	亠丷冖灬
鶚	口口二灬
鶛	󰁴匕白灬
鶜	艹󰁻乛灬
鶝	一口田灬
鶞	⺁十目灬
鶟	宀八犬灬
鶠	匚日女灬
鶡	曰勹人灬
鶢	爫一灬
鶣	丶尸冂灬
鶤	冖車󰁟灬
鶥	󰁅目󰁟灬
鶦	古月󰁟灬
鶧	艹ㄇ大灬
鶨	彑󰀓󰁟灬
鶩	󰁻乛亅灬
鶪	目犬󰁟灬
鶫	木󰀹󰁟灬
鶬	人丶彐灬
鶭	糹方󰁟灬
鶮	󰁸冂口灬
鶯	火火冖灬
鶰	口貝󰁟灬
鶱	宀󰀀八灬
鶲	八厶羽灬
鶳	󰁟灬丿丨
鶴	冖亻󰁷灬
鶵	勹凵丿灬
鶶	广󰁬丨灬
鶷	宀三丨灬
鶸	弓冫弓灬
鶹	󰁚丶刀灬
鶺	󰀪人月灬
鶻	󰀾月󰁟灬
鶼	䒑󰁬〢灬
鶽	亻󰁷十灬
鶾	十早人灬
鶿	䒑幺幺灬
鷀	䒑幺幺灬
鷁	䒑八皿灬
鷂	爫𠂉十灬
鷃	曰宀女灬
鷄	爫幺大灬
鷅	覀木󰁟灬
鷆	匕目󰄃灬
鷇	士冖一又
鷈	󰁟灬⺁几
鷉	⺁虍几灬
鷊	一口冂灬
鷋	艹人一灬
鷌	󰁟灬󰀋灬
鷍	丿目木灬
鷎	白大十灬
鷏	十󰀣八灬
鷐	日厂二灬
鷑	⺮立󰁟灬
鷒	一曰丨灬
鷓	广廿灬灬
鷔	󰁡攵灬
鷕	口亻󰁷灬
鷖	匚𠂉大灬
鷗	匚口口灬
鷘	木口攵灬
鷙	土䒑十灬
鷚	羽人彡灬
鷛	广󰁬月灬
鷜	󰀻女󰁟灬
鷝	曰艹󰀟灬
鷞	大乂乂灬
鷟	方𠂉𠂉灬
鷠	󰁢灬󰁟灬
鷡	𠂉一󰀷灬
鷢	厂䒑凵灬
鷣	覀早󰁟灬
鷤	口口曰灬
鷥	糹幺小灬
鷦	亻󰁷灬灬
鷧	士冖一灬
鷨	艹一艹灬
鷩	㡀攵󰁟灬
鷪	目目冖灬
鷫	󰁬十󰀲灬
鷬	󰁺由八灬
鷭	丿米田灬
鷮	丿大口灬
鷯	大丷曰灬
鷰	廿口丬灬
鷱	丿目󰀪灬
鷲	󰁸小灬
鷳	門月󰁟灬
鷴	門木󰁟灬
鷵	尸土丿灬
鷶	罒貝󰁟灬
鷷	丷西一灬
鷸	󰁻乛亅灬
鷹	广亻亻灬
鷺	口止夂灬
鷻	󰁟灬󰁸攵
鷼	門日󰁟灬
鷽	󰀗乂乂灬
鷾	立日心灬
鷿	尸口辛灬
鸀	罒勹虫灬
鸁	󰄹月󰁟丶
鸂	氵爫幺灬
鸃	󰁟灬丷丶
鸄	白方攵灬
鸅	罒土䒑灬
鸆	虍口一灬
鸇	亠囗口灬
鸈	业䒑未灬
鸉	木曰一灬
鸊	尸口辛灬
鸋	宀心皿灬
鸌	󰁟灬艹又
鸍	一八冂灬
鸎	貝貝󰁟灬
鸏	艹冖二灬
鸐	羽亻󰁷灬
鸑	犭󰁥言灬
鸒	󰀗一󰁕灬
鸓	田田田灬
鸔	󰁟灬曰氺
鸕	虍田皿灬
鸖	󰀙亻󰁷灬
鸗	立月一灬
鸘	󰀙木目灬
鸙	人一口灬
鸚	貝貝女灬
鸛	艹口口灬
鸜	目目亻灬
鸝	一冂丶灬
鸞	言糹糹灬
鸟	󰁠一󰀌
鸠	九󰁠一󰀝
鸡	又󰁠一󰀝
鸢	󰀁丶󰁠一
鸣	口󰁠一󰀝
鸤	尸󰁠一󰀝
鸥	匚乂󰁠一
鸦	󰀄亅丿一
鸧	人⺋󰁠一
鸨	匕十󰁠一
鸩	冖󰁜󰁠一
鸪	古󰁠一󰀝
鸫	󰀂小󰁠一
鸬	󰀥尸󰁠一
鸭	甲󰁠一󰀝
鸮	口一ㄅ一
鸯	ㄇ大󰁠一
鸰	人丶󰁻一
鸱	󰁚󰀁丶一
鸲	勹口󰁠一
鸳	夕⺋󰁠一
鸴	󰀧冖󰁠一
鸵	󰁠󰀞宀匕
鸶	󰁲󰁲一一
鸷	扌九丶一
鸸	丆冂〢一
鸹	丿古󰁠一
鸺	亻木󰁠一
鸻	彳一丁一
鸼	丿󰁪󰁠一
鸽	人一口一
鸾	亠󰁗󰁠一
鸿	氵工󰁠一
鹀	工人人一
鹁	十冖孑一
鹂	一冂丶一
鹃	口月󰁠一
鹄	丿土口一
鹅	丿扌󰁒一
鹆	八人口一
鹇	门木󰁠一
鹈	丷弓丨一
鹉	一󰀁止一
鹊	󰁺日󰁠一
鹋	艹田󰁠一
鹌	大曰󰄃一
鹍	曰󰁴󰁴一
鹎	白丿十一
鹏	月月󰁠一
鹐	⺈臼󰁠一
鹑	󰁸孑󰁠一
鹒	广󰁬人一
鹓	宀夕⺋一
鹔	󰁬丨󰀯一
鹕	古月󰁠一
鹖	曰勹人一
鹗	口口二一
鹘	󰀾月󰁠一
鹙	禾火󰁠一
鹚	䒑幺幺一
鹛	󰁅目󰁠一
鹜	󰁻乛亅一
鹝	一口冂一
鹞	爫𠂉十一
鹟	八厶羽一
鹠	󰁚丶刀一
鹡	󰀪人月一
鹢	䒑八皿一
鹣	䒑󰁬〢一
鹤	冖亻󰁷一
鹥	匚𠂉大一
鹦	贝贝女一
鹧	广廿灬一
鹨	羽人彡一
鹩	大丷曰一
鹪	亻󰁷灬一
鹫	󰁸小一
鹬	󰁻乛亅一
鹭	口止夂一
鹮	罒一口一
鹯	亠囗口一
鹰	广亻亻一
鹱	󰁠󰀞艹又
鹲	艹冖二一
鹳	艹口口一
鹴	󰀙木目一
鹵	󰀥囗󰁘󰁧
鹶	󰀥囗󰁘乛
鹷	󰀥囗󰁘󰁻
鹸	󰀥囗󰁘人
鹹	󰀥囗󰁘口
鹺	󰀥囗󰁘工
鹻	󰀥囗󰁘八
鹼	󰀥囗󰁘人
鹽	匚丨󰁃皿
鹾	󰀥囗乂工
鹿	󰁙󰁴匕󰁫
麀	󰁙󰁴匕匕
麁	ク󰁙󰁴匕
麂	󰁙󰁴匕几
麃	󰁙󰁴匕灬
麄	八刀󰁙󰁴
麅	󰁙󰁴匕巳
麆	󰁙󰁴匕一
麇	󰁙󰁴匕禾
麈	󰁙󰁴匕王
麉	干干󰁙匕
麊	米󰁙󰁴匕
麋	󰁙󰁴匕米
麌	󰁙󰁴匕大
麍	󰁙󰁴匕󰀸
麎	󰁙󰁴匕󰀖
麏	󰁙󰁴匕口
麐	󰁙󰁴匕口
麑	󰁙󰁴匕儿
麒	󰁙󰁴󰁴八
麓	木木󰁙匕
麔	󰁙󰁴匕口
麕	󰁙󰁴匕禾
麖	󰁙󰁴匕小
麗	一冂丶匕
麘	󰁙󰁴匕日
麙	󰁙󰁴匕口
麚	󰁙󰁴匕又
麛	󰁙󰁴匕耳
麜	󰁙󰁴匕木
麝	󰁙󰁴匕寸
麞	󰁙󰁴匕早
麟	󰁙󰁴󰁴㐄
麠	󰁙󰁴匕一
麡	󰁙󰁴匕󰀳
麢	󰁙󰁴匕口
麣	󰁙󰁴匕攵
麤	󰁙󰁴匕匕
麥	木人人夕
麦	夂󰁧
麧	木人人乙
麨	木人人丿
麩	木人人夫
麪	木人人𠃌
麫	木人人ㄅ
麬	木人人皮
麭	木人人巳
麮	木人人厶
麯	木人人󰁺
麰	木人人󰀟
麱	木人人甫
麲	木人人夕
麳	木人人人
麴	木人人米
麵	木人人二
麶	木人人厶
麷	木人人䒑
麸	夕夫󰁶
麹	夕勹米
麺	夕丆二
麻	广木木󰀦
麼	广木木幺
麽	广木木厶
麾	广木木毛
麿	广木木口
黀	广木木又
黁	广木木日
黂	广木木貝
黃	廿一由八
黄	󰁺由八󰁧
黅	󰁺由八乛
黆	󰁺由八󰁜
黇	󰁺由八口
黈	󰁺由八王
黉	󰀧冖󰁺八
黊	󰁺由八土
黋	⺌一儿八
黌	󰀗乂乂八
黍	禾人氺󰁧
黎	禾勹丿氺
黏	禾人氺口
黐	禾人氺厶
黑	󰀹土灬󰁧
黒	曰土灬󰁧
黓	󰀹土灬丶
黔	󰀹土灬乛
黕	󰀹土灬󰁜
黖	󰀹土灬󰁜
黗	󰀹土灬乚
默	󰀹土灬犬
黙	曰土犬灬
黚	󰀹土灬甘
黛	亻󰀁丶灬
黜	󰀹土灬山
黝	󰀹土灬力
點	󰀹土灬口
黟	󰀹土灬夕
黠	󰀹土灬口
黡	厂犬󰀹灬
黢	󰀹土灬夂
黣	󰀹土灬母
黤	󰀹土灬乚
黥	󰀹土灬小
黦	󰀹土灬⺋
黧	禾勹丿灬
黨	⺌冖口灬
黩	󰀹土灬大
黪	󰀹土灬彡
黫	󰀹土灬土
黬	󰀹土灬口
黭	󰀹土灬廾
黮	󰀹土灬󰄃
黯	󰀹土灬日
黰	󰀹土灬八
黱	月丷夫灬
黲	󰀹土灬彡
黳	匚𠂉大灬
黴	彳山一攵
黵	󰀹土灬言
黶	厂曰月灬
黷	󰀹土灬貝
黸	󰀹土灬皿
黹	业㡀󰁧
黺	业㡀八刀
黻	业㡀丶
黼	业㡀甫󰁶
黽	黽󰄃󰁈一
黾	口曰乚󰀅
黿	二儿黽󰀘
鼀	土八黽󰀘
鼁	土厶黽󰀘
鼂	曰一黽󰀘
鼃	土土黽󰀘
鼄	丿未黽󰀘
鼅	𠂉大口黽
鼆	冖日六黽
鼇	󰁡攵黽
鼈	㡀攵黽󰀘
鼉	口口田黽
鼊	尸口辛黽
鼋	二儿口乚
鼌	曰一口乚
鼍	口口田乚
鼎	目󰁕丆󰁈
鼏	冖目󰁕󰁈
鼐	乃目󰁕󰁈
鼑	󰀥目󰁕󰁈
鼒	󰀛丿目󰁈
鼓	士口䒑又
鼔	士口䒑又
鼕	士口䒑󰁦
鼖	十艹士又
鼗	儿󰀪士又
鼘	士口䒑一
鼙	士口䒑十
鼚	士口䒑󰀖
鼛	士口䒑口
鼜	士口䒑虫
鼝	氵󰀲一又
鼞	士口䒑土
鼟	士口䒑䒑
鼠	臼󰁐󰁦󰁒
鼡	󰀧几󰀟󰀬
鼢	臼󰁐󰁦刀
鼣	臼󰁐󰁦犬
鼤	臼󰁐󰁦文
鼥	臼󰁐󰁦丶
鼦	臼󰁐󰁦口
鼧	臼󰁐󰁦匕
鼨	臼󰁐󰁦󰁦
鼩	臼󰁐󰁦口
鼪	臼󰁐󰁦
鼫	臼󰁐󰁦石
鼬	臼󰁐󰁦由
鼭	臼󰁐󰁦寸
鼮	臼󰁐󰁦廴
鼯	臼󰁐󰁦口
鼰	臼󰁐󰁦貝
鼱	臼󰁐󰁦月
鼲	臼󰁐󰁦車
鼳	臼󰁐󰁦犬
鼴	臼󰁐󰁦女
鼵	臼󰁐󰁦犬
鼶	臼󰁐󰁦几
鼷	臼󰁐󰁦大
鼸	臼󰁐󰁦八
鼹	臼󰁐󰁦女
鼺	臼󰁐󰁦田
鼻	丿目田󰀯
鼼	丿目田丨
鼽	丿目田九
鼾	丿目田干
鼿	丿目田儿
齀	丿目田丶
齁	丿目田口
齂	丿目田氺
齃	丿目田󰄃
齄	丿目田一
齅	丿目田犬
齆	丿目田巴
齇	丿目田一
齈	丿目田󰀖
齉	丿目田󰀔
齊	󰀴󰀳󰀘
齋	󰀴󰀳小󰁧
齌	󰀴󰀳火󰁧
齍	󰀴󰀳皿󰀘
齎	󰀴󰀳貝󰁧
齏	󰀴󰀳丨一
齐	文󰀯󰀬
齑	文󰀯丨一
齒	止󰀆󰀬
齓	止󰀆乚󰁀
齔	止󰀆匕󰁀
齕	止󰀆𠂉乙
齖	止󰀆󰀄丿
齗	止󰀆斤󰀢
齘	止󰀆人󰀯
齙	止󰀆勹巳
齚	止󰀆𠂉二
齛	止󰀆廿󰄃
齜	止󰀆止匕
齝	止󰀆厶口
齞	止󰀆口八
齟	止󰀆󰀐一
齠	止󰀆刀口
齡	止󰀆人󰁻
齢	止米凵󰁻
齣	止󰀆勹口
齤	丷夫止󰀆
齥	止󰀆曰丿
齦	止󰀆艮󰁶
齧	三丨刀󰀆
齨	止󰀆臼󰀝
齩	止󰀆六乂
齪	止󰀆口󰁾
齫	止󰀆囗木
齬	止󰀆五口
齭	止󰀆⺁斤
齮	止󰀆大口
齯	止󰀆臼儿
齰	止󰀆󰁺日
齱	止󰀆耳又
齲	止󰀆丿丶
齳	止󰀆冖車
齴	止󰀆立彡
齵	止󰀆日丶
齶	止󰀆口ㄅ
齷	止󰀆尸土
齸	止󰀆䒑皿
齹	⺶工止󰀆
齺	止󰀆勹丿
齻	止󰀆十八
齼	止󰀆木󰁾
齽	止󰀆木小
齾	虍一口󰀆
齿	止人凵󰀬
龀	止人凵ヒ
龁	止人凵乙
龂	止人凵斤
龃	止人凵一
龄	止人凵󰁻
龅	止人凵巳
龆	止人凵口
龇	止人凵匕
龈	止人凵艮
龉	止人凵口
龊	止人凵󰁾
龋	止人凵丶
龌	止人凵土
龍	立月一三
龎	厂立月三
龏	立月一廾
龐	广立月三
龑	立月一大
龒	立月一小
龓	月立三
龔	立月一八
龕	人一口三
龖	立月一三
龗	󰀙口口三
龘	立月一三
龙	ヒ丶󰀦
龚	ヒ丶八
龛	人一口丶
龜	丿󰁵󰀌
龝	禾丿󰁵󰀝
龞	㡀攵丿󰁵
龟	⺈曰乚󰀅
龠	人一口艹
龡	人一口人
龢	人一口禾
龣	人一口氺
龤	人一口白
龥	人一口貝
龰	󰁾丨一󰂃
龴	󰁻乛丶
龵	丿一丿
龶	一一一
龷	󰁺一丨一
龸	⺌冖󰀅
龹	丷夫󰀦
龺	十早󰀬
龻	言糹糹󰁶
郎	丶艮阝󰀢
凉	冫󰁸小󰁶
秊	禾丿十󰀬
裏	亠曰土󰀔
隣	阝米夕㐄
兀	一儿󰁫
嗀	士冖一又
﨎	文亻󰁷又
﨏	土八八口
﨑	山立口亅
﨓	木艹亻寸
﨔	木󰀧一手
礼	二小乚󰁀
﨟	艹月曰󰄃
蘒	艹禾丿󰁵
﨡	虫丿󰀝
﨣	土󰁾󰁦十
﨤	乃󰂃辶󰀦
﨧	釒土丿子
﨨	釒土䒑十
﨩	阝󰁟山󰀢
𠂇	一丿
𠂉	𠂉丿一
𠃌	𠃌𠃌〇〇
𡗗	三人󰀦
𢦏	十戈󰀦
𤇾	火火冖󰀅
〇  〇〇〇〇